PokerStars Game #47185661094:  Hold'em No Limit ($1/$2 USD) - 2010/07/23 23:52:13 ET
Table 'Orthosie II' 6-max Seat #4 is the button
Seat 1: neni85 ($504.45 in chips) 
Seat 3: WizardOfAhhs ($36 in chips) 
Seat 4: spiderfrank ($46.35 in chips) 
Seat 5: LeoFara ($42.40 in chips) 
Seat 6: onitsuaf ($71.25 in chips) 
LeoFara: posts small blind $1
onitsuaf: posts big blind $2
*** HOLE CARDS ***
hockeymike39 joins the table at seat #2 
neni85: folds 
hockeymike39 leaves the table
harujongil joins the table at seat #2 
WizardOfAhhs: folds 
spiderfrank: folds 
LeoFara: folds 
Uncalled bet ($1) returned to onitsuaf
onitsuaf collected $2 from pot
*** SUMMARY ***
Total pot $2 | Rake $0 
Seat 1: neni85 folded before Flop (didn't bet)
Seat 3: WizardOfAhhs folded before Flop (didn't bet)
Seat 4: spiderfrank (button) folded before Flop (didn't bet)
Seat 5: LeoFara (small blind) folded before Flop
Seat 6: onitsuaf (big blind) collected ($2)




PokerStars Game #47185638614:  Hold'em No Limit ($1/$2 USD) - 2010/07/23 23:51:22 ET
Table 'Phoenix V' 6-max Seat #6 is the button
Seat 1: MJJ & ADT ($37 in chips) 
Seat 2: tdiddy ($215.35 in chips) 
Seat 3: pike2229 ($72.30 in chips) 
Seat 4: jimjam1979 ($47.40 in chips) 
Seat 5: WizardOfAhhs ($34.30 in chips) 
Seat 6: neni85 ($451.50 in chips) 
MJJ & ADT: posts small blind $1
tdiddy: posts big blind $2
*** HOLE CARDS ***
pike2229: folds 
jimjam1979: folds 
WizardOfAhhs: folds 
neni85: folds 
MJJ & ADT: folds 
Uncalled bet ($1) returned to tdiddy
tdiddy collected $2 from pot
tdiddy: doesn't show hand 
*** SUMMARY ***
Total pot $2 | Rake $0 
Seat 1: MJJ & ADT (small blind) folded before Flop
Seat 2: tdiddy (big blind) collected ($2)
Seat 3: pike2229 folded before Flop (didn't bet)
Seat 4: jimjam1979 folded before Flop (didn't bet)
Seat 5: WizardOfAhhs folded before Flop (didn't bet)
Seat 6: neni85 (button) folded before Flop (didn't bet)




PokerStars Game #47185643153:  Hold'em No Limit ($1/$2 USD) - 2010/07/23 23:51:32 ET
Table 'Selene' 6-max Seat #3 is the button
Seat 1: beargood ($109.35 in chips) 
Seat 2: Rocco35 ($44.90 in chips) 
Seat 3: Mamoo ($171.25 in chips) 
Seat 4: HUMBLED1 ($276 in chips) 
Seat 5: DMACM ($86.35 in chips) 
Seat 6: BlindFlying ($100 in chips) 
HUMBLED1: posts small blind $1
DMACM: posts big blind $2
*** HOLE CARDS ***
BlindFlying: folds 
beargood: folds 
Rocco35: folds 
Mamoo: folds 
HUMBLED1: raises $4 to $6
DMACM: folds 
Uncalled bet ($4) returned to HUMBLED1
HUMBLED1 collected $4 from pot
HUMBLED1: doesn't show hand 
*** SUMMARY ***
Total pot $4 | Rake $0 
Seat 1: beargood folded before Flop (didn't bet)
Seat 2: Rocco35 folded before Flop (didn't bet)
Seat 3: Mamoo (button) folded before Flop (didn't bet)
Seat 4: HUMBLED1 (small blind) collected ($4)
Seat 5: DMACM (big blind) folded before Flop
Seat 6: BlindFlying folded before Flop (didn't bet)




PokerStars Game #47185616180:  Hold'em No Limit ($1/$2 USD) - 2010/07/23 23:50:31 ET
Table 'Lonnrot III' 6-max Seat #2 is the button
Seat 2: Duke_Moto ($210.40 in chips) 
Seat 3: DURKADURDUR ($215.45 in chips) 
Seat 4: imthesky ($205.15 in chips) 
Seat 5: dajatt13 ($343 in chips) 
Seat 6: FrAnWaN ($294.75 in chips) 
DURKADURDUR: posts small blind $1
imthesky: posts big blind $2
THEDUTCH4141: sits out 
*** HOLE CARDS ***
dajatt13: raises $4 to $6
FrAnWaN: folds 
Duke_Moto: folds 
DURKADURDUR: folds 
imthesky: folds 
Uncalled bet ($4) returned to dajatt13
dajatt13 collected $5 from pot
dajatt13: doesn't show hand 
*** SUMMARY ***
Total pot $5 | Rake $0 
Seat 2: Duke_Moto (button) folded before Flop (didn't bet)
Seat 3: DURKADURDUR (small blind) folded before Flop
Seat 4: imthesky (big blind) folded before Flop
Seat 5: dajatt13 collected ($5)
Seat 6: FrAnWaN folded before Flop (didn't bet)




PokerStars Game #47185612965:  Hold'em No Limit ($1/$2 USD) - 2010/07/23 23:50:24 ET
Table 'Phoenix V' 6-max Seat #4 is the button
Seat 1: MJJ & ADT ($33 in chips) 
Seat 2: tdiddy ($215.35 in chips) 
Seat 3: pike2229 ($72.30 in chips) 
Seat 4: jimjam1979 ($47.40 in chips) 
Seat 5: WizardOfAhhs ($35.30 in chips) 
Seat 6: neni85 ($454.50 in chips) 
WizardOfAhhs: posts small blind $1
neni85: posts big blind $2
*** HOLE CARDS ***
MJJ & ADT: raises $2 to $4
tdiddy: folds 
pike2229: folds 
jimjam1979: folds 
WizardOfAhhs: folds 
neni85: folds 
Uncalled bet ($2) returned to MJJ & ADT
MJJ & ADT collected $5 from pot
MJJ & ADT: doesn't show hand 
*** SUMMARY ***
Total pot $5 | Rake $0 
Seat 1: MJJ & ADT collected ($5)
Seat 2: tdiddy folded before Flop (didn't bet)
Seat 3: pike2229 folded before Flop (didn't bet)
Seat 4: jimjam1979 (button) folded before Flop (didn't bet)
Seat 5: WizardOfAhhs (small blind) folded before Flop
Seat 6: neni85 (big blind) folded before Flop




PokerStars Game #47185643723:  Hold'em No Limit ($1/$2 USD) - 2010/07/23 23:51:33 ET
Table 'Natalie' 6-max Seat #4 is the button
Seat 1: DURKADURDUR ($423.65 in chips) 
Seat 2: TODO ADENTR0 ($209.65 in chips) 
Seat 4: bluffinmyway ($196.80 in chips) 
Seat 6: leukehond ($212.45 in chips) 
leukehond: posts small blind $1
DURKADURDUR: posts big blind $2
THEDUTCH4141: sits out 
*** HOLE CARDS ***
TODO ADENTR0: folds 
bluffinmyway: folds 
leukehond: folds 
Uncalled bet ($1) returned to DURKADURDUR
DURKADURDUR collected $2 from pot
DURKADURDUR: doesn't show hand 
*** SUMMARY ***
Total pot $2 | Rake $0 
Seat 1: DURKADURDUR (big blind) collected ($2)
Seat 2: TODO ADENTR0 folded before Flop (didn't bet)
Seat 4: bluffinmyway (button) folded before Flop (didn't bet)
Seat 6: leukehond (small blind) folded before Flop




PokerStars Game #47185648913:  Hold'em No Limit ($1/$2 USD) - 2010/07/23 23:51:45 ET
Table 'Natalie' 6-max Seat #6 is the button
Seat 1: DURKADURDUR ($424.65 in chips) 
Seat 2: TODO ADENTR0 ($209.65 in chips) 
Seat 4: bluffinmyway ($196.80 in chips) 
Seat 6: leukehond ($211.45 in chips) 
DURKADURDUR: posts small blind $1
TODO ADENTR0: posts big blind $2
THEDUTCH4141: sits out 
*** HOLE CARDS ***
bluffinmyway: folds 
leukehond: raises $3 to $5
DURKADURDUR: folds 
TODO ADENTR0: folds 
Uncalled bet ($3) returned to leukehond
leukehond collected $5 from pot
leukehond: doesn't show hand 
*** SUMMARY ***
Total pot $5 | Rake $0 
Seat 1: DURKADURDUR (small blind) folded before Flop
Seat 2: TODO ADENTR0 (big blind) folded before Flop
Seat 4: bluffinmyway folded before Flop (didn't bet)
Seat 6: leukehond (button) collected ($5)




PokerStars Game #47185612948:  Hold'em No Limit ($1/$2 USD) - 2010/07/23 23:50:24 ET
Table 'Vitja' 6-max Seat #3 is the button
Seat 1: WizardOfAhhs ($72.15 in chips) 
Seat 3: rodrieliot ($42 in chips) 
Seat 4: emilpetten ($36.25 in chips) 
Seat 5: EKkL ($32.65 in chips) 
Seat 6: LeoFara ($40 in chips) 
emilpetten: posts small blind $1
EKkL: posts big blind $2
*** HOLE CARDS ***
LeoFara: folds 
WizardOfAhhs: folds 
rodrieliot: folds 
emilpetten: folds 
Uncalled bet ($1) returned to EKkL
EKkL collected $2 from pot
*** SUMMARY ***
Total pot $2 | Rake $0 
Seat 1: WizardOfAhhs folded before Flop (didn't bet)
Seat 3: rodrieliot (button) folded before Flop (didn't bet)
Seat 4: emilpetten (small blind) folded before Flop
Seat 5: EKkL (big blind) collected ($2)
Seat 6: LeoFara folded before Flop (didn't bet)




PokerStars Game #47185685315:  Hold'em No Limit ($1/$2 USD) - 2010/07/23 23:53:08 ET
Table 'Phereclos II' 6-max Seat #3 is the button
Seat 3: ILS16L ($49.90 in chips) 
Seat 4: mpm135 ($479.45 in chips) 
Seat 5: TexasSooner2 ($80 in chips) 
mpm135: posts small blind $1
TexasSooner2: posts big blind $2
*** HOLE CARDS ***
ILS16L: raises $2 to $4
mpm135: folds 
TexasSooner2: calls $2
*** FLOP *** [8d 7d 2d]
TexasSooner2: bets $6
ILS16L: folds 
Uncalled bet ($6) returned to TexasSooner2
mpolice2010 joins the table at seat #1 
TexasSooner2 collected $8.55 from pot
TexasSooner2: doesn't show hand 
*** SUMMARY ***
Total pot $9 | Rake $0.45 
Board [8d 7d 2d]
Seat 3: ILS16L (button) folded on the Flop
Seat 4: mpm135 (small blind) folded before Flop
Seat 5: TexasSooner2 (big blind) collected ($8.55)




PokerStars Game #47185630673:  Hold'em No Limit ($1/$2 USD) - 2010/07/23 23:51:04 ET
Table 'Ottegebe' 6-max Seat #6 is the button
Seat 1: RdrLuv ($142.90 in chips) 
Seat 2: picasso264 ($25.70 in chips) 
Seat 3: AironVega ($39 in chips) 
Seat 4: DMACM ($102.90 in chips) 
Seat 5: WizardOfAhhs ($118.05 in chips) 
Seat 6: jimjam1979 ($37 in chips) 
RdrLuv: posts small blind $1
picasso264: posts big blind $2
*** HOLE CARDS ***
AironVega: folds 
DMACM: folds 
WizardOfAhhs: folds 
jimjam1979: raises $2 to $4
RdrLuv: raises $14 to $18
picasso264: raises $7.70 to $25.70 and is all-in
jimjam1979: folds 
RdrLuv: calls $7.70
*** FLOP *** [Ts 3d 8c]
*** TURN *** [Ts 3d 8c] [9d]
*** RIVER *** [Ts 3d 8c 9d] [2h]
*** SHOW DOWN ***
RdrLuv: shows [Jc Js] (a pair of Jacks)
picasso264: shows [Qd Qs] (a pair of Queens)
picasso264 collected $52.65 from pot
*** SUMMARY ***
Total pot $55.40 | Rake $2.75 
Board [Ts 3d 8c 9d 2h]
Seat 1: RdrLuv (small blind) showed [Jc Js] and lost with a pair of Jacks
Seat 2: picasso264 (big blind) showed [Qd Qs] and won ($52.65) with a pair of Queens
Seat 3: AironVega folded before Flop (didn't bet)
Seat 4: DMACM folded before Flop (didn't bet)
Seat 5: WizardOfAhhs folded before Flop (didn't bet)
Seat 6: jimjam1979 (button) folded before Flop




PokerStars Game #47185621293:  Hold'em No Limit ($1/$2 USD) - 2010/07/23 23:50:43 ET
Table 'Laocoon III' 6-max Seat #6 is the button
Seat 1: 1tormentor ($293.20 in chips) 
Seat 2: angryjamman ($162.55 in chips) 
Seat 3: TODO ADENTR0 ($215.90 in chips) 
Seat 5: DURKADURDUR ($210.05 in chips) 
Seat 6: FrAnWaN ($293.70 in chips) 
1tormentor: posts small blind $1
angryjamman: posts big blind $2
Fierytycoon: sits out 
*** HOLE CARDS ***
TODO ADENTR0: folds 
DURKADURDUR: raises $4 to $6
FrAnWaN: folds 
1tormentor: folds 
angryjamman: calls $4
*** FLOP *** [Ah 9s 2c]
angryjamman: checks 
DURKADURDUR: bets $7
angryjamman: calls $7
*** TURN *** [Ah 9s 2c] [9h]
angryjamman: checks 
DURKADURDUR: checks 
*** RIVER *** [Ah 9s 2c 9h] [4d]
angryjamman: bets $10
DURKADURDUR: calls $10
*** SHOW DOWN ***
angryjamman: shows [9d 9c] (four of a kind, Nines)
DURKADURDUR: mucks hand 
angryjamman collected $45 from pot
*** SUMMARY ***
Total pot $47 | Rake $2 
Board [Ah 9s 2c 9h 4d]
Seat 1: 1tormentor (small blind) folded before Flop
Seat 2: angryjamman (big blind) showed [9d 9c] and won ($45) with four of a kind, Nines
Seat 3: TODO ADENTR0 folded before Flop (didn't bet)
Seat 5: DURKADURDUR mucked
Seat 6: FrAnWaN (button) folded before Flop (didn't bet)




PokerStars Game #47185619167:  Hold'em No Limit ($1/$2 USD) - 2010/07/23 23:50:38 ET
Table 'Regulus' 6-max Seat #3 is the button
Seat 1: FrAnWaN ($253.05 in chips) 
Seat 2: Fierytycoon ($202.95 in chips) 
Seat 3: TODO ADENTR0 ($384.95 in chips) 
Seat 4: thomaswkm ($269.40 in chips) 
Seat 5: DURKADURDUR ($429.40 in chips) 
Seat 6: Rush51 ($68 in chips) 
thomaswkm: posts small blind $1
DURKADURDUR: posts big blind $2
*** HOLE CARDS ***
Rush51: calls $2
FrAnWaN: folds 
Fierytycoon: folds 
TODO ADENTR0: folds 
thomaswkm: folds 
DURKADURDUR: checks 
*** FLOP *** [7c Kc 8d]
DURKADURDUR: checks 
Rush51: checks 
*** TURN *** [7c Kc 8d] [Ac]
DURKADURDUR: checks 
Rush51: checks 
*** RIVER *** [7c Kc 8d Ac] [2s]
DURKADURDUR: checks 
Rush51: bets $66 and is all-in
DURKADURDUR: folds 
Uncalled bet ($66) returned to Rush51
Rush51 collected $4.75 from pot
Rush51: doesn't show hand 
*** SUMMARY ***
Total pot $5 | Rake $0.25 
Board [7c Kc 8d Ac 2s]
Seat 1: FrAnWaN folded before Flop (didn't bet)
Seat 2: Fierytycoon folded before Flop (didn't bet)
Seat 3: TODO ADENTR0 (button) folded before Flop (didn't bet)
Seat 4: thomaswkm (small blind) folded before Flop
Seat 5: DURKADURDUR (big blind) folded on the River
Seat 6: Rush51 collected ($4.75)




PokerStars Game #47185633244:  Hold'em No Limit ($1/$2 USD) - 2010/07/23 23:51:10 ET
Table 'Neckar VII' 6-max Seat #2 is the button
Seat 1: Marker275 ($217.10 in chips) 
Seat 2: DURKADURDUR ($281.10 in chips) 
Seat 4: THEDUTCH4141 ($200 in chips) 
Seat 5: imthesky ($204.80 in chips) 
dmyj will be allowed to play after the button
THEDUTCH4141: posts small blind $1
imthesky: posts big blind $2
*** HOLE CARDS ***
Marker275: folds 
DURKADURDUR: raises $4 to $6
THEDUTCH4141: folds 
imthesky: folds 
Uncalled bet ($4) returned to DURKADURDUR
DURKADURDUR collected $5 from pot
DURKADURDUR: doesn't show hand 
*** SUMMARY ***
Total pot $5 | Rake $0 
Seat 1: Marker275 folded before Flop (didn't bet)
Seat 2: DURKADURDUR (button) collected ($5)
Seat 4: THEDUTCH4141 (small blind) folded before Flop
Seat 5: imthesky (big blind) folded before Flop




PokerStars Game #47185629828:  Hold'em No Limit ($1/$2 USD) - 2010/07/23 23:51:02 ET
Table 'Pala II' 6-max Seat #1 is the button
Seat 1: Fierytycoon ($200 in chips) 
Seat 2: thomaswkm ($112.95 in chips) 
Seat 3: TheAwfulDin ($268.95 in chips) 
Seat 4: serj14 ($300.05 in chips) 
Seat 5: asseral ($200 in chips) 
thomaswkm: posts small blind $1
TheAwfulDin: posts big blind $2
*** HOLE CARDS ***
serj14: raises $2 to $4
asseral: folds 
Fierytycoon: raises $8 to $12
thomaswkm: folds 
TheAwfulDin: folds 
serj14: calls $8
*** FLOP *** [6s 5c 4d]
serj14: checks 
Fierytycoon: checks 
*** TURN *** [6s 5c 4d] [3d]
serj14: bets $18
Fierytycoon: folds 
Uncalled bet ($18) returned to serj14
serj14 collected $25.65 from pot
serj14: doesn't show hand 
*** SUMMARY ***
Total pot $27 | Rake $1.35 
Board [6s 5c 4d 3d]
Seat 1: Fierytycoon (button) folded on the Turn
Seat 2: thomaswkm (small blind) folded before Flop
Seat 3: TheAwfulDin (big blind) folded before Flop
Seat 4: serj14 collected ($25.65)
Seat 5: asseral folded before Flop (didn't bet)




PokerStars Game #47185675554:  Hold'em No Limit ($1/$2 USD) - 2010/07/23 23:52:46 ET
Table 'Strenua' 6-max Seat #1 is the button
Seat 1: neni85 ($207.60 in chips) 
Seat 2: blackduck11 ($135.05 in chips) 
Seat 3: jenny12346 ($131.45 in chips) 
Seat 4: tdiddy ($109.65 in chips) 
Seat 5: AillemKall ($39 in chips) 
Seat 6: C6Z06 2GO ($126.90 in chips) 
blackduck11: posts small blind $1
jenny12346: posts big blind $2
*** HOLE CARDS ***
tdiddy: folds 
AillemKall: folds 
C6Z06 2GO: calls $2
neni85: folds 
blackduck11: folds 
jenny12346: checks 
*** FLOP *** [3s Kc Jh]
jenny12346: checks 
C6Z06 2GO: bets $4
jenny12346: folds 
Uncalled bet ($4) returned to C6Z06 2GO
C6Z06 2GO collected $4.75 from pot
*** SUMMARY ***
Total pot $5 | Rake $0.25 
Board [3s Kc Jh]
Seat 1: neni85 (button) folded before Flop (didn't bet)
Seat 2: blackduck11 (small blind) folded before Flop
Seat 3: jenny12346 (big blind) folded on the Flop
Seat 4: tdiddy folded before Flop (didn't bet)
Seat 5: AillemKall folded before Flop (didn't bet)
Seat 6: C6Z06 2GO collected ($4.75)




PokerStars Game #47185660434:  Hold'em No Limit ($1/$2 USD) - 2010/07/23 23:52:11 ET
Table 'Thoas' 6-max Seat #3 is the button
Seat 1: mdeckND ($287.20 in chips) 
Seat 2: DURKADURDUR ($705.25 in chips) 
Seat 3: Jetize ($235.40 in chips) 
Seat 4: mojox ($42.55 in chips) 
Seat 5: FrAnWaN ($325.50 in chips) 
Seat 6: asseral ($240.85 in chips) 
mojox: posts small blind $1
FrAnWaN: posts big blind $2
*** HOLE CARDS ***
asseral: raises $5 to $7
mdeckND: folds 
DURKADURDUR: folds 
Jetize: folds 
mojox: calls $6
FrAnWaN: folds 
*** FLOP *** [Th Jh 7c]
mojox: checks 
asseral: checks 
*** TURN *** [Th Jh 7c] [6s]
mojox: bets $6
asseral: folds 
Uncalled bet ($6) returned to mojox
mojox collected $15.20 from pot
mojox: doesn't show hand 
*** SUMMARY ***
Total pot $16 | Rake $0.80 
Board [Th Jh 7c 6s]
Seat 1: mdeckND folded before Flop (didn't bet)
Seat 2: DURKADURDUR folded before Flop (didn't bet)
Seat 3: Jetize (button) folded before Flop (didn't bet)
Seat 4: mojox (small blind) collected ($15.20)
Seat 5: FrAnWaN (big blind) folded before Flop
Seat 6: asseral folded on the Turn




PokerStars Game #47185650918:  Hold'em No Limit ($1/$2 USD) - 2010/07/23 23:51:49 ET
Table 'Selene' 6-max Seat #4 is the button
Seat 1: beargood ($109.35 in chips) 
Seat 2: Rocco35 ($44.90 in chips) 
Seat 3: Mamoo ($171.25 in chips) 
Seat 4: HUMBLED1 ($278 in chips) 
Seat 5: DMACM ($84.35 in chips) 
Seat 6: BlindFlying ($100 in chips) 
DMACM: posts small blind $1
BlindFlying: posts big blind $2
*** HOLE CARDS ***
beargood: folds 
Rocco35: folds 
Mamoo: folds 
HUMBLED1: folds 
DMACM: raises $2 to $4
BlindFlying: folds 
Uncalled bet ($2) returned to DMACM
DMACM collected $4 from pot
*** SUMMARY ***
Total pot $4 | Rake $0 
Seat 1: beargood folded before Flop (didn't bet)
Seat 2: Rocco35 folded before Flop (didn't bet)
Seat 3: Mamoo folded before Flop (didn't bet)
Seat 4: HUMBLED1 (button) folded before Flop (didn't bet)
Seat 5: DMACM (small blind) collected ($4)
Seat 6: BlindFlying (big blind) folded before Flop




PokerStars Game #47185643881:  Hold'em No Limit ($1/$2 USD) - 2010/07/23 23:51:34 ET
Table 'Pavo' 6-max Seat #4 is the button
Seat 1: dajatt13 ($208.65 in chips) 
Seat 2: FrAnWaN ($407.90 in chips) 
Seat 3: botano ($101.40 in chips) 
Seat 4: thomaswkm ($201.25 in chips) 
Seat 6: TheAwfulDin ($216.50 in chips) 
THEDUTCH4141 will be allowed to play after the button
TheAwfulDin: posts small blind $1
dajatt13: posts big blind $2
*** HOLE CARDS ***
FrAnWaN: folds 
botano: folds 
thomaswkm: folds 
TheAwfulDin: folds 
Uncalled bet ($1) returned to dajatt13
dajatt13 collected $2 from pot
dajatt13: doesn't show hand 
*** SUMMARY ***
Total pot $2 | Rake $0 
Seat 1: dajatt13 (big blind) collected ($2)
Seat 2: FrAnWaN folded before Flop (didn't bet)
Seat 3: botano folded before Flop (didn't bet)
Seat 4: thomaswkm (button) folded before Flop (didn't bet)
Seat 6: TheAwfulDin (small blind) folded before Flop




PokerStars Game #47185678662:  Hold'em No Limit ($1/$2 USD) - 2010/07/23 23:52:53 ET
Table 'Wilhelmina' 6-max Seat #2 is the button
Seat 2: DMACM ($91 in chips) 
Seat 4: richard175 ($50.40 in chips) 
Seat 5: TODO ADENTR0 ($312.30 in chips) 
Seat 6: hellokittery ($219.95 in chips) 
richard175: posts small blind $1
TODO ADENTR0: posts big blind $2
jaeh00d: sits out 
*** HOLE CARDS ***
hellokittery: folds 
DMACM: folds 
richard175: calls $1
THEDUTCH4141 joins the table at seat #3 
TODO ADENTR0: checks 
*** FLOP *** [3h As Th]
richard175: checks 
TODO ADENTR0: checks 
*** TURN *** [3h As Th] [Ks]
richard175: checks 
TODO ADENTR0: checks 
*** RIVER *** [3h As Th Ks] [Ad]
richard175: bets $2
TODO ADENTR0: folds 
Uncalled bet ($2) returned to richard175
richard175 collected $3.80 from pot
*** SUMMARY ***
Total pot $4 | Rake $0.20 
Board [3h As Th Ks Ad]
Seat 2: DMACM (button) folded before Flop (didn't bet)
Seat 4: richard175 (small blind) collected ($3.80)
Seat 5: TODO ADENTR0 (big blind) folded on the River
Seat 6: hellokittery folded before Flop (didn't bet)




PokerStars Game #47185650138:  Hold'em No Limit ($1/$2 USD) - 2010/07/23 23:51:48 ET
Table 'Orthosie II' 6-max Seat #3 is the button
Seat 1: neni85 ($501.45 in chips) 
Seat 3: WizardOfAhhs ($36 in chips) 
Seat 4: spiderfrank ($47.35 in chips) 
Seat 5: LeoFara ($44.40 in chips) 
Seat 6: onitsuaf ($71.25 in chips) 
spiderfrank: posts small blind $1
LeoFara: posts big blind $2
*** HOLE CARDS ***
onitsuaf: folds 
neni85: raises $3 to $5
WizardOfAhhs: folds 
spiderfrank: folds 
LeoFara: folds 
Uncalled bet ($3) returned to neni85
neni85 collected $5 from pot
neni85: doesn't show hand 
*** SUMMARY ***
Total pot $5 | Rake $0 
Seat 1: neni85 collected ($5)
Seat 3: WizardOfAhhs (button) folded before Flop (didn't bet)
Seat 4: spiderfrank (small blind) folded before Flop
Seat 5: LeoFara (big blind) folded before Flop
Seat 6: onitsuaf folded before Flop (didn't bet)




PokerStars Game #47185668610:  Hold'em No Limit ($1/$2 USD) - 2010/07/23 23:52:30 ET
Table 'Ottegebe' 6-max Seat #2 is the button
Seat 1: RdrLuv ($117.20 in chips) 
Seat 2: picasso264 ($54.65 in chips) 
Seat 3: AironVega ($37 in chips) 
Seat 4: DMACM ($102.90 in chips) 
Seat 5: WizardOfAhhs ($118.05 in chips) 
Seat 6: jimjam1979 ($33 in chips) 
AironVega: posts small blind $1
DMACM: posts big blind $2
*** HOLE CARDS ***
WizardOfAhhs: folds 
jimjam1979: folds 
RdrLuv: raises $6 to $8
picasso264: folds 
AironVega: folds 
DMACM: raises $16 to $24
RdrLuv: calls $16
*** FLOP *** [Tc 8d Ts]
DMACM: bets $32
RdrLuv: folds 
Uncalled bet ($32) returned to DMACM
DMACM collected $46.55 from pot
*** SUMMARY ***
Total pot $49 | Rake $2.45 
Board [Tc 8d Ts]
Seat 1: RdrLuv folded on the Flop
Seat 2: picasso264 (button) folded before Flop (didn't bet)
Seat 3: AironVega (small blind) folded before Flop
Seat 4: DMACM (big blind) collected ($46.55)
Seat 5: WizardOfAhhs folded before Flop (didn't bet)
Seat 6: jimjam1979 folded before Flop (didn't bet)




PokerStars Game #47185670188:  Hold'em No Limit ($1/$2 USD) - 2010/07/23 23:52:33 ET
Table 'Phereclos II' 6-max Seat #3 is the button
Seat 3: ILS16L ($52.10 in chips) 
Seat 4: mpm135 ($477.45 in chips) 
ILS16L: posts small blind $1
mpm135: posts big blind $2
*** HOLE CARDS ***
ILS16L: calls $1
mpm135: checks 
*** FLOP *** [Kd Kc 8h]
mpm135: checks 
ILS16L: bets $4
mpm135: folds 
Uncalled bet ($4) returned to ILS16L
ILS16L collected $3.80 from pot
ILS16L: doesn't show hand 
*** SUMMARY ***
Total pot $4 | Rake $0.20 
Board [Kd Kc 8h]
Seat 3: ILS16L (button) (small blind) collected ($3.80)
Seat 4: mpm135 (big blind) folded on the Flop




PokerStars Game #47185638147:  Hold'em No Limit ($1/$2 USD) - 2010/07/23 23:51:21 ET
Table 'Phereclos II' 6-max Seat #3 is the button
Seat 3: ILS16L ($52.50 in chips) 
Seat 4: mpm135 ($477.45 in chips) 
ILS16L: posts small blind $1
mpm135: posts big blind $2
*** HOLE CARDS ***
ILS16L: calls $1
mpm135: checks 
*** FLOP *** [Ts 6c Jd]
mpm135: checks 
ILS16L: bets $4
mpm135: folds 
Uncalled bet ($4) returned to ILS16L
ILS16L collected $3.80 from pot
ILS16L: doesn't show hand 
*** SUMMARY ***
Total pot $4 | Rake $0.20 
Board [Ts 6c Jd]
Seat 3: ILS16L (button) (small blind) collected ($3.80)
Seat 4: mpm135 (big blind) folded on the Flop




PokerStars Game #47185624776:  Hold'em No Limit ($1/$2 USD) - 2010/07/23 23:50:51 ET
Table 'Vitja' 6-max Seat #4 is the button
Seat 1: WizardOfAhhs ($72.15 in chips) 
Seat 3: rodrieliot ($42 in chips) 
Seat 4: emilpetten ($35.25 in chips) 
Seat 5: EKkL ($33.65 in chips) 
Seat 6: LeoFara ($40 in chips) 
EKkL: posts small blind $1
LeoFara: posts big blind $2
*** HOLE CARDS ***
WizardOfAhhs: folds 
rodrieliot: folds 
emilpetten: folds 
EKkL: calls $1
LeoFara: checks 
*** FLOP *** [Ah 7h 6d]
EKkL: checks 
LeoFara: checks 
*** TURN *** [Ah 7h 6d] [Qh]
EKkL: checks 
LeoFara: checks 
*** RIVER *** [Ah 7h 6d Qh] [2c]
EKkL: bets $4
LeoFara: folds 
Uncalled bet ($4) returned to EKkL
EKkL collected $3.80 from pot
*** SUMMARY ***
Total pot $4 | Rake $0.20 
Board [Ah 7h 6d Qh 2c]
Seat 1: WizardOfAhhs folded before Flop (didn't bet)
Seat 3: rodrieliot folded before Flop (didn't bet)
Seat 4: emilpetten (button) folded before Flop (didn't bet)
Seat 5: EKkL (small blind) collected ($3.80)
Seat 6: LeoFara (big blind) folded on the River




PokerStars Game #47185615209:  Hold'em No Limit ($1/$2 USD) - 2010/07/23 23:50:29 ET
Table 'Margo II' 6-max Seat #5 is the button
Seat 1: wheels6990 ($46 in chips) 
Seat 2: AillemKall ($31 in chips) 
Seat 3: crock41 ($63.35 in chips) 
Seat 4: WizardOfAhhs ($84.35 in chips) 
Seat 5: AironVega ($36.60 in chips) 
Seat 6: JLS1956 ($53.65 in chips) 
JLS1956: posts small blind $1
wheels6990: posts big blind $2
*** HOLE CARDS ***
AillemKall: folds 
crock41: calls $2
WizardOfAhhs: folds 
AironVega: folds 
JLS1956: folds 
wheels6990: checks 
*** FLOP *** [Qc Jh As]
wheels6990: checks 
crock41: bets $4
wheels6990: folds 
Uncalled bet ($4) returned to crock41
crock41 collected $4.75 from pot
crock41: doesn't show hand 
*** SUMMARY ***
Total pot $5 | Rake $0.25 
Board [Qc Jh As]
Seat 1: wheels6990 (big blind) folded on the Flop
Seat 2: AillemKall folded before Flop (didn't bet)
Seat 3: crock41 collected ($4.75)
Seat 4: WizardOfAhhs folded before Flop (didn't bet)
Seat 5: AironVega (button) folded before Flop (didn't bet)
Seat 6: JLS1956 (small blind) folded before Flop




PokerStars Game #47185660612:  Hold'em No Limit ($1/$2 USD) - 2010/07/23 23:52:11 ET
Table 'Selene' 6-max Seat #5 is the button
Seat 1: beargood ($109.35 in chips) 
Seat 2: Rocco35 ($44.90 in chips) 
Seat 3: Mamoo ($171.25 in chips) 
Seat 4: HUMBLED1 ($278 in chips) 
Seat 5: DMACM ($86.35 in chips) 
Seat 6: BlindFlying ($98 in chips) 
BlindFlying: posts small blind $1
beargood: posts big blind $2
*** HOLE CARDS ***
Rocco35: calls $2
Mamoo: folds 
HUMBLED1: folds 
DMACM: folds 
BlindFlying: folds 
beargood: checks 
*** FLOP *** [Qd 7s Kh]
beargood: checks 
Rocco35: checks 
*** TURN *** [Qd 7s Kh] [2d]
beargood: checks 
Rocco35: bets $2
beargood: folds 
Uncalled bet ($2) returned to Rocco35
Rocco35 collected $4.75 from pot
*** SUMMARY ***
Total pot $5 | Rake $0.25 
Board [Qd 7s Kh 2d]
Seat 1: beargood (big blind) folded on the Turn
Seat 2: Rocco35 collected ($4.75)
Seat 3: Mamoo folded before Flop (didn't bet)
Seat 4: HUMBLED1 folded before Flop (didn't bet)
Seat 5: DMACM (button) folded before Flop (didn't bet)
Seat 6: BlindFlying (small blind) folded before Flop




PokerStars Game #47185634588:  Hold'em No Limit ($1/$2 USD) - 2010/07/23 23:51:13 ET
Table 'Rafita IV' 6-max Seat #2 is the button
Seat 1: neni85 ($157.10 in chips) 
Seat 2: NewEra760 ($69.85 in chips) 
Seat 3: AillemKall ($50.90 in chips) 
Seat 4: WizardOfAhhs ($112.35 in chips) 
Seat 5: jimjam1979 ($46.15 in chips) 
Seat 6: Ricko7456 ($154 in chips) 
AillemKall: posts small blind $1
WizardOfAhhs: posts big blind $2
*** HOLE CARDS ***
jimjam1979: folds 
Ricko7456: folds 
neni85: folds 
NewEra760: calls $2
AillemKall: raises $5.60 to $7.60
WizardOfAhhs: folds 
NewEra760: folds 
Uncalled bet ($5.60) returned to AillemKall
AillemKall collected $6 from pot
AillemKall: doesn't show hand 
*** SUMMARY ***
Total pot $6 | Rake $0 
Seat 1: neni85 folded before Flop (didn't bet)
Seat 2: NewEra760 (button) folded before Flop
Seat 3: AillemKall (small blind) collected ($6)
Seat 4: WizardOfAhhs (big blind) folded before Flop
Seat 5: jimjam1979 folded before Flop (didn't bet)
Seat 6: Ricko7456 folded before Flop (didn't bet)




PokerStars Game #47185612344:  Hold'em No Limit ($1/$2 USD) - 2010/07/23 23:50:22 ET
Table 'Ottegebe' 6-max Seat #5 is the button
Seat 1: RdrLuv ($144.90 in chips) 
Seat 2: picasso264 ($22.95 in chips) 
Seat 3: AironVega ($39 in chips) 
Seat 4: DMACM ($102.90 in chips) 
Seat 5: WizardOfAhhs ($118.05 in chips) 
Seat 6: jimjam1979 ($38 in chips) 
jimjam1979: posts small blind $1
RdrLuv: posts big blind $2
*** HOLE CARDS ***
picasso264: calls $2
AironVega: folds 
DMACM: folds 
WizardOfAhhs: folds 
jimjam1979: folds 
RdrLuv: checks 
*** FLOP *** [Ac 3s 2d]
RdrLuv: checks 
picasso264: bets $2
RdrLuv: folds 
Uncalled bet ($2) returned to picasso264
picasso264 collected $4.75 from pot
picasso264: doesn't show hand 
*** SUMMARY ***
Total pot $5 | Rake $0.25 
Board [Ac 3s 2d]
Seat 1: RdrLuv (big blind) folded on the Flop
Seat 2: picasso264 collected ($4.75)
Seat 3: AironVega folded before Flop (didn't bet)
Seat 4: DMACM folded before Flop (didn't bet)
Seat 5: WizardOfAhhs (button) folded before Flop (didn't bet)
Seat 6: jimjam1979 (small blind) folded before Flop




PokerStars Game #47185620644:  Hold'em No Limit ($1/$2 USD) - 2010/07/23 23:50:41 ET
Table 'Shajna' 6-max Seat #1 is the button
Seat 1: neni85 ($100 in chips) 
Seat 2: wheels6990 ($79.50 in chips) 
Seat 3: robsolo ($63.30 in chips) 
Seat 4: latebrake ($69.10 in chips) 
Seat 5: jimjam1979 ($34 in chips) 
Seat 6: AillemKall ($46.70 in chips) 
wheels6990: posts small blind $1
robsolo: posts big blind $2
*** HOLE CARDS ***
latebrake: calls $2
jimjam1979: folds 
AillemKall: folds 
neni85: folds 
wheels6990: folds 
robsolo: checks 
*** FLOP *** [7h 5s Tc]
robsolo: bets $4
latebrake: folds 
Uncalled bet ($4) returned to robsolo
robsolo collected $4.75 from pot
robsolo: doesn't show hand 
*** SUMMARY ***
Total pot $5 | Rake $0.25 
Board [7h 5s Tc]
Seat 1: neni85 (button) folded before Flop (didn't bet)
Seat 2: wheels6990 (small blind) folded before Flop
Seat 3: robsolo (big blind) collected ($4.75)
Seat 4: latebrake folded on the Flop
Seat 5: jimjam1979 folded before Flop (didn't bet)
Seat 6: AillemKall folded before Flop (didn't bet)




PokerStars Game #47185630757:  Hold'em No Limit ($1/$2 USD) - 2010/07/23 23:51:04 ET
Table 'Lonnrot III' 6-max Seat #3 is the button
Seat 2: Duke_Moto ($210.40 in chips) 
Seat 3: DURKADURDUR ($214.45 in chips) 
Seat 4: imthesky ($203.15 in chips) 
Seat 5: dajatt13 ($346 in chips) 
Seat 6: FrAnWaN ($294.75 in chips) 
imthesky: posts small blind $1
dajatt13: posts big blind $2
THEDUTCH4141: sits out 
*** HOLE CARDS ***
FrAnWaN: folds 
Duke_Moto: raises $4 to $6
DURKADURDUR: folds 
imthesky: calls $5
dajatt13: folds 
*** FLOP *** [7s Js Ad]
imthesky: bets $12
Duke_Moto: calls $12
*** TURN *** [7s Js Ad] [4h]
imthesky: bets $38
Duke_Moto: folds 
Uncalled bet ($38) returned to imthesky
imthesky collected $36.15 from pot
imthesky: doesn't show hand 
*** SUMMARY ***
Total pot $38 | Rake $1.85 
Board [7s Js Ad 4h]
Seat 2: Duke_Moto folded on the Turn
Seat 3: DURKADURDUR (button) folded before Flop (didn't bet)
Seat 4: imthesky (small blind) collected ($36.15)
Seat 5: dajatt13 (big blind) folded before Flop
Seat 6: FrAnWaN folded before Flop (didn't bet)




PokerStars Game #47185611772:  Hold'em No Limit ($1/$2 USD) - 2010/07/23 23:50:21 ET
Table 'Menelaus II' 6-max Seat #2 is the button
Seat 2: Berg58 ($77 in chips) 
Seat 3: topstich ($66.35 in chips) 
Seat 4: mzosh ($186.95 in chips) 
Seat 5: tdiddy ($158.35 in chips) 
Seat 6: sp4taxes ($39.15 in chips) 
topstich: posts small blind $1
mzosh: posts big blind $2
*** HOLE CARDS ***
tdiddy: folds 
sp4taxes: calls $2
Berg58: folds 
topstich: calls $1
mzosh: checks 
*** FLOP *** [Qs 9h 7c]
topstich: checks 
mzosh: bets $4
sp4taxes: folds 
topstich: calls $4
*** TURN *** [Qs 9h 7c] [Qd]
topstich: checks 
mzosh: bets $8
topstich: folds 
Uncalled bet ($8) returned to mzosh
LeoFara joins the table at seat #1 
mzosh collected $13.35 from pot
mzosh: doesn't show hand 
*** SUMMARY ***
Total pot $14 | Rake $0.65 
Board [Qs 9h 7c Qd]
Seat 2: Berg58 (button) folded before Flop (didn't bet)
Seat 3: topstich (small blind) folded on the Turn
Seat 4: mzosh (big blind) collected ($13.35)
Seat 5: tdiddy folded before Flop (didn't bet)
Seat 6: sp4taxes folded on the Flop




PokerStars Game #47185666901:  Hold'em No Limit ($1/$2 USD) - 2010/07/23 23:52:26 ET
Table 'Luscinia' 6-max Seat #4 is the button
Seat 1: AillemKall ($38.30 in chips) 
Seat 2: JDVC ($68.25 in chips) 
Seat 3: rodrieliot ($42 in chips) 
Seat 4: ILS16L ($75.65 in chips) 
Seat 5: Clabby01 ($98.70 in chips) 
Seat 6: sebass911 ($100 in chips) 
Clabby01: posts small blind $1
sebass911: posts big blind $2
*** HOLE CARDS ***
AillemKall: folds 
JDVC: calls $2
rodrieliot: folds 
ILS16L: folds 
Clabby01: calls $1
sebass911: checks 
*** FLOP *** [Ts Td Kc]
Clabby01: checks 
sebass911: checks 
JDVC: bets $4
Clabby01: folds 
sebass911: folds 
Uncalled bet ($4) returned to JDVC
JDVC collected $5.70 from pot
JDVC: doesn't show hand 
*** SUMMARY ***
Total pot $6 | Rake $0.30 
Board [Ts Td Kc]
Seat 1: AillemKall folded before Flop (didn't bet)
Seat 2: JDVC collected ($5.70)
Seat 3: rodrieliot folded before Flop (didn't bet)
Seat 4: ILS16L (button) folded before Flop (didn't bet)
Seat 5: Clabby01 (small blind) folded on the Flop
Seat 6: sebass911 (big blind) folded on the Flop




PokerStars Game #47185639951:  Hold'em No Limit ($1/$2 USD) - 2010/07/23 23:51:25 ET
Table 'Menelaus II' 6-max Seat #4 is the button
Seat 2: Berg58 ($65 in chips) 
Seat 3: topstich ($60.35 in chips) 
Seat 4: mzosh ($193.30 in chips) 
Seat 5: tdiddy ($156.35 in chips) 
Seat 6: sp4taxes ($50.85 in chips) 
tdiddy: posts small blind $1
sp4taxes: posts big blind $2
LeoFara: sits out 
*** HOLE CARDS ***
Berg58: folds 
topstich: calls $2
mzosh: folds 
tdiddy: calls $1
sp4taxes: checks 
*** FLOP *** [9d Ah 2d]
tdiddy: bets $3.50
sp4taxes: folds 
topstich: calls $3.50
*** TURN *** [9d Ah 2d] [5s]
tdiddy: bets $10
topstich: folds 
Uncalled bet ($10) returned to tdiddy
tdiddy collected $12.40 from pot
tdiddy: doesn't show hand 
*** SUMMARY ***
Total pot $13 | Rake $0.60 
Board [9d Ah 2d 5s]
Seat 2: Berg58 folded before Flop (didn't bet)
Seat 3: topstich folded on the Turn
Seat 4: mzosh (button) folded before Flop (didn't bet)
Seat 5: tdiddy (small blind) collected ($12.40)
Seat 6: sp4taxes (big blind) folded on the Flop




PokerStars Game #47185639658:  Hold'em No Limit ($1/$2 USD) - 2010/07/23 23:51:24 ET
Table 'Margo II' 6-max Seat #1 is the button
Seat 1: wheels6990 ($43 in chips) 
Seat 2: AillemKall ($32 in chips) 
Seat 3: crock41 ($66.10 in chips) 
Seat 4: WizardOfAhhs ($84.35 in chips) 
Seat 5: AironVega ($36.60 in chips) 
Seat 6: JLS1956 ($52.65 in chips) 
AillemKall: posts small blind $1
crock41: posts big blind $2
*** HOLE CARDS ***
WizardOfAhhs: folds 
AironVega: folds 
JLS1956: folds 
wheels6990: folds 
AillemKall: folds 
Uncalled bet ($1) returned to crock41
crock41 collected $2 from pot
*** SUMMARY ***
Total pot $2 | Rake $0 
Seat 1: wheels6990 (button) folded before Flop (didn't bet)
Seat 2: AillemKall (small blind) folded before Flop
Seat 3: crock41 (big blind) collected ($2)
Seat 4: WizardOfAhhs folded before Flop (didn't bet)
Seat 5: AironVega folded before Flop (didn't bet)
Seat 6: JLS1956 folded before Flop (didn't bet)




PokerStars Game #47185653108:  Hold'em No Limit ($1/$2 USD) - 2010/07/23 23:51:54 ET
Table 'Phereclos II' 6-max Seat #4 is the button
Seat 3: ILS16L ($54.30 in chips) 
Seat 4: mpm135 ($475.45 in chips) 
mpm135: posts small blind $1
ILS16L: posts big blind $2
*** HOLE CARDS ***
mpm135: raises $4 to $6
ILS16L: folds 
Uncalled bet ($4) returned to mpm135
mpm135 collected $4 from pot
mpm135: doesn't show hand 
*** SUMMARY ***
Total pot $4 | Rake $0 
Seat 3: ILS16L (big blind) folded before Flop
Seat 4: mpm135 (button) (small blind) collected ($4)




PokerStars Game #47185684829:  Hold'em No Limit ($1/$2 USD) - 2010/07/23 23:53:07 ET
Table 'Laodica' 6-max Seat #3 is the button
Seat 1: WizardOfAhhs ($81.50 in chips) 
Seat 2: LeoFara ($50.85 in chips) 
Seat 3: jimjam1979 ($41 in chips) 
Seat 4: BlindFlying ($100 in chips) 
Seat 5: rodrieliot ($60.60 in chips) 
Seat 6: JuStBLaZe908 ($223.85 in chips) 
BlindFlying: posts small blind $1
rodrieliot: posts big blind $2
*** HOLE CARDS ***
JuStBLaZe908: raises $4 to $6
WizardOfAhhs: folds 
LeoFara: folds 
jimjam1979: folds 
BlindFlying: folds 
rodrieliot: folds 
Uncalled bet ($4) returned to JuStBLaZe908
JuStBLaZe908 collected $5 from pot
*** SUMMARY ***
Total pot $5 | Rake $0 
Seat 1: WizardOfAhhs folded before Flop (didn't bet)
Seat 2: LeoFara folded before Flop (didn't bet)
Seat 3: jimjam1979 (button) folded before Flop (didn't bet)
Seat 4: BlindFlying (small blind) folded before Flop
Seat 5: rodrieliot (big blind) folded before Flop
Seat 6: JuStBLaZe908 collected ($5)




PokerStars Game #47185611384:  Hold'em No Limit ($1/$2 USD) - 2010/07/23 23:50:20 ET
Table 'Maia III' 6-max Seat #2 is the button
Seat 1: thomaswkm ($195.35 in chips) 
Seat 2: FrAnWaN ($371.65 in chips) 
Seat 3: dertaylor ($218.25 in chips) 
Seat 4: TODO ADENTR0 ($221 in chips) 
Seat 5: DURKADURDUR ($200.65 in chips) 
Seat 6: hellokittery ($212.10 in chips) 
dertaylor: posts small blind $1
TODO ADENTR0: posts big blind $2
*** HOLE CARDS ***
DURKADURDUR: folds 
hellokittery: raises $4 to $6
thomaswkm: folds 
FrAnWaN: folds 
dertaylor: calls $5
TODO ADENTR0: folds 
*** FLOP *** [Jc 5h 7c]
dertaylor: checks 
hellokittery: bets $11
dertaylor: folds 
Uncalled bet ($11) returned to hellokittery
hellokittery collected $13.30 from pot
hellokittery: doesn't show hand 
*** SUMMARY ***
Total pot $14 | Rake $0.70 
Board [Jc 5h 7c]
Seat 1: thomaswkm folded before Flop (didn't bet)
Seat 2: FrAnWaN (button) folded before Flop (didn't bet)
Seat 3: dertaylor (small blind) folded on the Flop
Seat 4: TODO ADENTR0 (big blind) folded before Flop
Seat 5: DURKADURDUR folded before Flop (didn't bet)
Seat 6: hellokittery collected ($13.30)




PokerStars Game #47185655897:  Hold'em No Limit ($1/$2 USD) - 2010/07/23 23:52:01 ET
Table 'Katanga II' 6-max Seat #3 is the button
Seat 1: beargood ($143.70 in chips) 
Seat 2: generaaltrab ($103.70 in chips) 
Seat 3: BounceSower ($42.20 in chips) 
Seat 4: kaomaaje ($60 in chips) 
Seat 5: Revolucion51 ($199.50 in chips) 
Seat 6: neni85 ($100 in chips) 
kaomaaje: posts small blind $1
Revolucion51: posts big blind $2
*** HOLE CARDS ***
neni85: folds 
beargood: folds 
generaaltrab: calls $2
BounceSower: raises $3.50 to $5.50
kaomaaje: raises $6.50 to $12
Revolucion51: folds 
generaaltrab: calls $10
BounceSower: folds 
*** FLOP *** [Kh 6c Kc]
kaomaaje: bets $2
generaaltrab: calls $2
*** TURN *** [Kh 6c Kc] [3c]
kaomaaje: bets $4
generaaltrab: calls $4
*** RIVER *** [Kh 6c Kc 3c] [Jh]
kaomaaje: bets $6
generaaltrab: calls $6
*** SHOW DOWN ***
kaomaaje: shows [7d 7h] (two pair, Kings and Sevens)
generaaltrab: shows [9h 9d] (two pair, Kings and Nines)
generaaltrab collected $52.85 from pot
*** SUMMARY ***
Total pot $55.50 | Rake $2.65 
Board [Kh 6c Kc 3c Jh]
Seat 1: beargood folded before Flop (didn't bet)
Seat 2: generaaltrab showed [9h 9d] and won ($52.85) with two pair, Kings and Nines
Seat 3: BounceSower (button) folded before Flop
Seat 4: kaomaaje (small blind) showed [7d 7h] and lost with two pair, Kings and Sevens
Seat 5: Revolucion51 (big blind) folded before Flop
Seat 6: neni85 folded before Flop (didn't bet)




PokerStars Game #47185604144:  Hold'em No Limit ($1/$2 USD) - 2010/07/23 23:50:04 ET
Table 'Rigilkent VIII' 6-max Seat #6 is the button
Seat 1: TODO ADENTR0 ($200 in chips) 
Seat 2: DURKADURDUR ($236.30 in chips) 
Seat 3: -MinhNa- ($200.80 in chips) 
Seat 4: toto54321 ($101.35 in chips) 
Seat 5: FrAnWaN ($200.75 in chips) 
Seat 6: thomaswkm ($127.75 in chips) 
TODO ADENTR0: posts small blind $1
DURKADURDUR: posts big blind $2
*** HOLE CARDS ***
-MinhNa-: calls $2
toto54321: folds 
toto54321 leaves the table
FrAnWaN: raises $8 to $10
jaeh00d joins the table at seat #4 
thomaswkm: folds 
TODO ADENTR0: folds 
DURKADURDUR: folds 
-MinhNa-: calls $8
*** FLOP *** [8h 8c Ts]
-MinhNa-: checks 
FrAnWaN: bets $16
-MinhNa-: calls $16
*** TURN *** [8h 8c Ts] [Jh]
-MinhNa-: checks 
FrAnWaN: checks 
*** RIVER *** [8h 8c Ts Jh] [3h]
-MinhNa-: bets $8
FrAnWaN: calls $8
*** SHOW DOWN ***
-MinhNa-: shows [2c 2h] (two pair, Eights and Deuces)
FrAnWaN: shows [Td Ad] (two pair, Tens and Eights)
FrAnWaN collected $68 from pot
*** SUMMARY ***
Total pot $71 | Rake $3 
Board [8h 8c Ts Jh 3h]
Seat 1: TODO ADENTR0 (small blind) folded before Flop
Seat 2: DURKADURDUR (big blind) folded before Flop
Seat 3: -MinhNa- showed [2c 2h] and lost with two pair, Eights and Deuces
Seat 4: toto54321 folded before Flop (didn't bet)
Seat 5: FrAnWaN showed [Td Ad] and won ($68) with two pair, Tens and Eights
Seat 6: thomaswkm (button) folded before Flop (didn't bet)




PokerStars Game #47185659109:  Hold'em No Limit ($1/$2 USD) - 2010/07/23 23:52:08 ET
Table 'Pavo' 6-max Seat #6 is the button
Seat 1: dajatt13 ($209.65 in chips) 
Seat 2: FrAnWaN ($407.90 in chips) 
Seat 3: botano ($101.40 in chips) 
Seat 4: thomaswkm ($201.25 in chips) 
Seat 6: TheAwfulDin ($215.50 in chips) 
dajatt13: posts small blind $1
FrAnWaN: posts big blind $2
THEDUTCH4141: sits out 
*** HOLE CARDS ***
botano: folds 
thomaswkm: folds 
TheAwfulDin: raises $3 to $5
dajatt13: folds 
FrAnWaN: raises $13 to $18
TheAwfulDin: raises $30 to $48
FrAnWaN: folds 
Uncalled bet ($30) returned to TheAwfulDin
TheAwfulDin collected $37 from pot
TheAwfulDin: doesn't show hand 
*** SUMMARY ***
Total pot $37 | Rake $0 
Seat 1: dajatt13 (small blind) folded before Flop
Seat 2: FrAnWaN (big blind) folded before Flop
Seat 3: botano folded before Flop (didn't bet)
Seat 4: thomaswkm folded before Flop (didn't bet)
Seat 6: TheAwfulDin (button) collected ($37)




PokerStars Game #47185637368:  Hold'em No Limit ($1/$2 USD) - 2010/07/23 23:51:19 ET
Table 'Sibylla II' 6-max Seat #3 is the button
Seat 1: LeoFara ($51.35 in chips) 
Seat 2: AironVega ($32.90 in chips) 
Seat 3: jimjam1979 ($39.85 in chips) 
Seat 4: sp4taxes ($72.85 in chips) 
Seat 5: BlindFlying ($189.90 in chips) 
Seat 6: tradan ($56.15 in chips) 
sp4taxes: posts small blind $1
BlindFlying: posts big blind $2
*** HOLE CARDS ***
tradan: folds 
LeoFara: raises $2.40 to $4.40
AironVega: folds 
jimjam1979: folds 
sp4taxes: folds 
BlindFlying: folds 
Uncalled bet ($2.40) returned to LeoFara
LeoFara collected $5 from pot
*** SUMMARY ***
Total pot $5 | Rake $0 
Seat 1: LeoFara collected ($5)
Seat 2: AironVega folded before Flop (didn't bet)
Seat 3: jimjam1979 (button) folded before Flop (didn't bet)
Seat 4: sp4taxes (small blind) folded before Flop
Seat 5: BlindFlying (big blind) folded before Flop
Seat 6: tradan folded before Flop (didn't bet)




PokerStars Game #47185624421:  Hold'em No Limit ($1/$2 USD) - 2010/07/23 23:50:50 ET
Table 'Phoenix V' 6-max Seat #5 is the button
Seat 1: MJJ & ADT ($36 in chips) 
Seat 2: tdiddy ($215.35 in chips) 
Seat 3: pike2229 ($72.30 in chips) 
Seat 4: jimjam1979 ($47.40 in chips) 
Seat 5: WizardOfAhhs ($34.30 in chips) 
Seat 6: neni85 ($452.50 in chips) 
neni85: posts small blind $1
MJJ & ADT: posts big blind $2
*** HOLE CARDS ***
tdiddy: folds 
pike2229: folds 
jimjam1979: folds 
WizardOfAhhs: folds 
neni85: folds 
Uncalled bet ($1) returned to MJJ & ADT
MJJ & ADT collected $2 from pot
MJJ & ADT: doesn't show hand 
*** SUMMARY ***
Total pot $2 | Rake $0 
Seat 1: MJJ & ADT (big blind) collected ($2)
Seat 2: tdiddy folded before Flop (didn't bet)
Seat 3: pike2229 folded before Flop (didn't bet)
Seat 4: jimjam1979 folded before Flop (didn't bet)
Seat 5: WizardOfAhhs (button) folded before Flop (didn't bet)
Seat 6: neni85 (small blind) folded before Flop




PokerStars Game #47185685084:  Hold'em No Limit ($1/$2 USD) - 2010/07/23 23:53:07 ET
Table 'Luscinia' 6-max Seat #5 is the button
Seat 1: AillemKall ($38.30 in chips) 
Seat 2: JDVC ($71.95 in chips) 
Seat 3: rodrieliot ($42 in chips) 
Seat 4: ILS16L ($75.65 in chips) 
Seat 5: Clabby01 ($96.70 in chips) 
Seat 6: sebass911 ($98 in chips) 
sebass911: posts small blind $1
AillemKall: posts big blind $2
*** HOLE CARDS ***
JDVC: folds 
rodrieliot: folds 
ILS16L: raises $4 to $6
Clabby01: folds 
sebass911: folds 
AillemKall: folds 
Uncalled bet ($4) returned to ILS16L
ILS16L collected $5 from pot
ILS16L: doesn't show hand 
*** SUMMARY ***
Total pot $5 | Rake $0 
Seat 1: AillemKall (big blind) folded before Flop
Seat 2: JDVC folded before Flop (didn't bet)
Seat 3: rodrieliot folded before Flop (didn't bet)
Seat 4: ILS16L collected ($5)
Seat 5: Clabby01 (button) folded before Flop (didn't bet)
Seat 6: sebass911 (small blind) folded before Flop




PokerStars Game #47185634961:  Hold'em No Limit ($1/$2 USD) - 2010/07/23 23:51:13 ET
Table 'Orthosie II' 6-max Seat #1 is the button
Seat 1: neni85 ($501.45 in chips) 
Seat 3: WizardOfAhhs ($37 in chips) 
Seat 4: spiderfrank ($51.75 in chips) 
Seat 5: LeoFara ($39.45 in chips) 
Seat 6: onitsuaf ($71.25 in chips) 
WizardOfAhhs: posts small blind $1
spiderfrank: posts big blind $2
*** HOLE CARDS ***
LeoFara: raises $2.40 to $4.40
onitsuaf: folds 
neni85: folds 
WizardOfAhhs: folds 
spiderfrank: calls $2.40
*** FLOP *** [Jd Qc 7c]
spiderfrank: checks 
LeoFara: bets $9.35
spiderfrank: folds 
Uncalled bet ($9.35) returned to LeoFara
LeoFara collected $9.35 from pot
*** SUMMARY ***
Total pot $9.80 | Rake $0.45 
Board [Jd Qc 7c]
Seat 1: neni85 (button) folded before Flop (didn't bet)
Seat 3: WizardOfAhhs (small blind) folded before Flop
Seat 4: spiderfrank (big blind) folded on the Flop
Seat 5: LeoFara collected ($9.35)
Seat 6: onitsuaf folded before Flop (didn't bet)




PokerStars Game #47185647840:  Hold'em No Limit ($1/$2 USD) - 2010/07/23 23:51:42 ET
Table 'Phoenix V' 6-max Seat #1 is the button
Seat 1: MJJ & ADT ($36 in chips) 
Seat 2: tdiddy ($216.35 in chips) 
Seat 3: pike2229 ($72.30 in chips) 
Seat 4: jimjam1979 ($47.40 in chips) 
Seat 5: WizardOfAhhs ($34.30 in chips) 
Seat 6: neni85 ($451.50 in chips) 
tdiddy: posts small blind $1
pike2229: posts big blind $2
*** HOLE CARDS ***
jimjam1979: folds 
WizardOfAhhs: folds 
neni85: folds 
MJJ & ADT: folds 
tdiddy: raises $3 to $5
pike2229: calls $3
*** FLOP *** [9c 4h 8c]
tdiddy: bets $8
pike2229: raises $8 to $16
tdiddy: raises $195.35 to $211.35 and is all-in
pike2229: calls $51.30 and is all-in
Uncalled bet ($144.05) returned to tdiddy
*** TURN *** [9c 4h 8c] [Kh]
*** RIVER *** [9c 4h 8c Kh] [Js]
*** SHOW DOWN ***
tdiddy: shows [6c 7c] (high card King)
pike2229: shows [9d 3d] (a pair of Nines)
pike2229 collected $141.60 from pot
*** SUMMARY ***
Total pot $144.60 | Rake $3 
Board [9c 4h 8c Kh Js]
Seat 1: MJJ & ADT (button) folded before Flop (didn't bet)
Seat 2: tdiddy (small blind) showed [6c 7c] and lost with high card King
Seat 3: pike2229 (big blind) showed [9d 3d] and won ($141.60) with a pair of Nines
Seat 4: jimjam1979 folded before Flop (didn't bet)
Seat 5: WizardOfAhhs folded before Flop (didn't bet)
Seat 6: neni85 folded before Flop (didn't bet)




PokerStars Game #47185663708:  Hold'em No Limit ($1/$2 USD) - 2010/07/23 23:52:18 ET
Table 'Laodica' 6-max Seat #2 is the button
Seat 1: WizardOfAhhs ($81.50 in chips) 
Seat 2: LeoFara ($40.80 in chips) 
Seat 3: jimjam1979 ($42 in chips) 
Seat 4: BlindFlying ($98.45 in chips) 
Seat 5: rodrieliot ($60.60 in chips) 
Seat 6: JuStBLaZe908 ($231.85 in chips) 
jimjam1979: posts small blind $1
BlindFlying: posts big blind $2
*** HOLE CARDS ***
rodrieliot: folds 
JuStBLaZe908: calls $2
WizardOfAhhs has timed out
WizardOfAhhs: folds 
LeoFara: raises $6 to $8
jimjam1979: folds 
BlindFlying: folds 
JuStBLaZe908: calls $6
*** FLOP *** [Jc 6s 3s]
JuStBLaZe908: checks 
LeoFara: bets $14
JuStBLaZe908: folds 
Uncalled bet ($14) returned to LeoFara
LeoFara collected $18.05 from pot
*** SUMMARY ***
Total pot $19 | Rake $0.95 
Board [Jc 6s 3s]
Seat 1: WizardOfAhhs folded before Flop (didn't bet)
Seat 2: LeoFara (button) collected ($18.05)
Seat 3: jimjam1979 (small blind) folded before Flop
Seat 4: BlindFlying (big blind) folded before Flop
Seat 5: rodrieliot folded before Flop (didn't bet)
Seat 6: JuStBLaZe908 folded on the Flop




PokerStars Game #47185670022:  Hold'em No Limit ($1/$2 USD) - 2010/07/23 23:52:33 ET
Table 'Phoenix V' 6-max Seat #2 is the button
Seat 1: MJJ & ADT ($36 in chips) 
Seat 2: tdiddy ($144.05 in chips) 
Seat 3: pike2229 ($141.60 in chips) 
Seat 4: jimjam1979 ($47.40 in chips) 
Seat 5: WizardOfAhhs ($34.30 in chips) 
Seat 6: neni85 ($451.50 in chips) 
pike2229: posts small blind $1
jimjam1979: posts big blind $2
*** HOLE CARDS ***
WizardOfAhhs: folds 
neni85: folds 
MJJ & ADT: folds 
tdiddy: folds 
pike2229: calls $1
jimjam1979: checks 
*** FLOP *** [Ac 2d Ah]
pike2229: checks 
jimjam1979: bets $3
pike2229: folds 
Uncalled bet ($3) returned to jimjam1979
jimjam1979 collected $3.80 from pot
jimjam1979: doesn't show hand 
*** SUMMARY ***
Total pot $4 | Rake $0.20 
Board [Ac 2d Ah]
Seat 1: MJJ & ADT folded before Flop (didn't bet)
Seat 2: tdiddy (button) folded before Flop (didn't bet)
Seat 3: pike2229 (small blind) folded on the Flop
Seat 4: jimjam1979 (big blind) collected ($3.80)
Seat 5: WizardOfAhhs folded before Flop (didn't bet)
Seat 6: neni85 folded before Flop (didn't bet)




PokerStars Game #47185666480:  Hold'em No Limit ($1/$2 USD) - 2010/07/23 23:52:25 ET
Table 'Vitja' 6-max Seat #6 is the button
Seat 1: WizardOfAhhs ($70.15 in chips) 
Seat 2: Don brujo ($40 in chips) 
Seat 3: rodrieliot ($42 in chips) 
Seat 4: emilpetten ($35.25 in chips) 
Seat 5: EKkL ($38.45 in chips) 
Seat 6: LeoFara ($37 in chips) 
WizardOfAhhs: posts small blind $1
Don brujo: posts big blind $2
*** HOLE CARDS ***
rodrieliot: folds 
emilpetten: folds 
EKkL: folds 
LeoFara: folds 
WizardOfAhhs: raises $2.10 to $4.10
Don brujo: calls $2.10
*** FLOP *** [Qh 2h 2c]
WizardOfAhhs: bets $3.30
Don brujo: folds 
Uncalled bet ($3.30) returned to WizardOfAhhs
WizardOfAhhs collected $7.80 from pot
WizardOfAhhs: doesn't show hand 
*** SUMMARY ***
Total pot $8.20 | Rake $0.40 
Board [Qh 2h 2c]
Seat 1: WizardOfAhhs (small blind) collected ($7.80)
Seat 2: Don brujo (big blind) folded on the Flop
Seat 3: rodrieliot folded before Flop (didn't bet)
Seat 4: emilpetten folded before Flop (didn't bet)
Seat 5: EKkL folded before Flop (didn't bet)
Seat 6: LeoFara (button) folded before Flop (didn't bet)




PokerStars Game #47185638428:  Hold'em No Limit ($1/$2 USD) - 2010/07/23 23:51:21 ET
Table 'Maia III' 6-max Seat #3 is the button
Seat 1: thomaswkm ($195.35 in chips) 
Seat 2: FrAnWaN ($371.65 in chips) 
Seat 3: dertaylor ($212.25 in chips) 
Seat 4: TODO ADENTR0 ($219 in chips) 
Seat 5: DURKADURDUR ($200.65 in chips) 
Seat 6: hellokittery ($219.40 in chips) 
TODO ADENTR0: posts small blind $1
DURKADURDUR: posts big blind $2
*** HOLE CARDS ***
hellokittery: folds 
thomaswkm: folds 
FrAnWaN: folds 
dertaylor: raises $2 to $4
TODO ADENTR0: folds 
DURKADURDUR: calls $2
*** FLOP *** [3s 8c 7h]
DURKADURDUR: bets $6
dertaylor: folds 
Uncalled bet ($6) returned to DURKADURDUR
DURKADURDUR collected $8.55 from pot
DURKADURDUR: doesn't show hand 
*** SUMMARY ***
Total pot $9 | Rake $0.45 
Board [3s 8c 7h]
Seat 1: thomaswkm folded before Flop (didn't bet)
Seat 2: FrAnWaN folded before Flop (didn't bet)
Seat 3: dertaylor (button) folded on the Flop
Seat 4: TODO ADENTR0 (small blind) folded before Flop
Seat 5: DURKADURDUR (big blind) collected ($8.55)
Seat 6: hellokittery folded before Flop (didn't bet)




PokerStars Game #47185677835:  Hold'em No Limit ($1/$2 USD) - 2010/07/23 23:52:51 ET
Table 'Thoas' 6-max Seat #4 is the button
Seat 1: mdeckND ($287.20 in chips) 
Seat 2: DURKADURDUR ($705.25 in chips) 
Seat 3: Jetize ($235.40 in chips) 
Seat 4: mojox ($50.75 in chips) 
Seat 5: FrAnWaN ($323.50 in chips) 
Seat 6: asseral ($233.85 in chips) 
FrAnWaN: posts small blind $1
asseral: posts big blind $2
*** HOLE CARDS ***
mdeckND: folds 
DURKADURDUR: folds 
Jetize: folds 
mojox: calls $2
FrAnWaN: folds 
asseral: checks 
*** FLOP *** [4s 9h Kd]
asseral: checks 
mojox: checks 
*** TURN *** [4s 9h Kd] [2s]
asseral: checks 
mojox: checks 
*** RIVER *** [4s 9h Kd 2s] [Jd]
asseral: checks 
mojox: checks 
*** SHOW DOWN ***
asseral: shows [2h Th] (a pair of Deuces)
mojox: mucks hand 
asseral collected $4.75 from pot
*** SUMMARY ***
Total pot $5 | Rake $0.25 
Board [4s 9h Kd 2s Jd]
Seat 1: mdeckND folded before Flop (didn't bet)
Seat 2: DURKADURDUR folded before Flop (didn't bet)
Seat 3: Jetize folded before Flop (didn't bet)
Seat 4: mojox (button) mucked
Seat 5: FrAnWaN (small blind) folded before Flop
Seat 6: asseral (big blind) showed [2h Th] and won ($4.75) with a pair of Deuces




PokerStars Game #47185660424:  Hold'em No Limit ($1/$2 USD) - 2010/07/23 23:52:11 ET
Table 'Neckar VII' 6-max Seat #5 is the button
Seat 1: Marker275 ($215.10 in chips) 
Seat 2: DURKADURDUR ($284.10 in chips) 
Seat 4: THEDUTCH4141 ($200 in chips) 
Seat 5: imthesky ($204.60 in chips) 
Marker275: posts small blind $1
DURKADURDUR: posts big blind $2
dmyj: sits out 
*** HOLE CARDS ***
THEDUTCH4141: raises $4 to $6
imthesky: folds 
Marker275: calls $5
DURKADURDUR: folds 
*** FLOP *** [Tc 4s 3d]
Marker275: checks 
THEDUTCH4141: checks 
*** TURN *** [Tc 4s 3d] [Th]
Marker275: bets $8
THEDUTCH4141: calls $8
*** RIVER *** [Tc 4s 3d Th] [4h]
Marker275: checks 
THEDUTCH4141: checks 
*** SHOW DOWN ***
Marker275: shows [Ah Qc] (two pair, Tens and Fours)
THEDUTCH4141: shows [7h 7c] (two pair, Tens and Sevens)
THEDUTCH4141 collected $28.55 from pot
*** SUMMARY ***
Total pot $30 | Rake $1.45 
Board [Tc 4s 3d Th 4h]
Seat 1: Marker275 (small blind) showed [Ah Qc] and lost with two pair, Tens and Fours
Seat 2: DURKADURDUR (big blind) folded before Flop
Seat 4: THEDUTCH4141 showed [7h 7c] and won ($28.55) with two pair, Tens and Sevens
Seat 5: imthesky (button) folded before Flop (didn't bet)




PokerStars Game #47185616078:  Hold'em No Limit ($1/$2 USD) - 2010/07/23 23:50:31 ET
Table 'Wilhelmina' 6-max Seat #3 is the button
Seat 1: Fierytycoon ($260.30 in chips) 
Seat 2: DMACM ($94 in chips) 
Seat 3: Bookie1978 ($488.85 in chips) 
Seat 4: richard175 ($28.95 in chips) 
Seat 5: TODO ADENTR0 ($341 in chips) 
Seat 6: hellokittery ($212.85 in chips) 
richard175: posts small blind $1
TODO ADENTR0: posts big blind $2
*** HOLE CARDS ***
hellokittery: folds 
Fierytycoon has timed out
Fierytycoon: folds 
DMACM: folds 
Bookie1978: folds 
richard175: raises $4 to $6
TODO ADENTR0: folds 
Uncalled bet ($4) returned to richard175
richard175 collected $4 from pot
richard175: doesn't show hand 
*** SUMMARY ***
Total pot $4 | Rake $0 
Seat 1: Fierytycoon folded before Flop (didn't bet)
Seat 2: DMACM folded before Flop (didn't bet)
Seat 3: Bookie1978 (button) folded before Flop (didn't bet)
Seat 4: richard175 (small blind) collected ($4)
Seat 5: TODO ADENTR0 (big blind) folded before Flop
Seat 6: hellokittery folded before Flop (didn't bet)




PokerStars Game #47185624332:  Hold'em No Limit ($1/$2 USD) - 2010/07/23 23:50:50 ET
Table 'Luscinia' 6-max Seat #1 is the button
Seat 1: AillemKall ($42.40 in chips) 
Seat 2: JDVC ($56.30 in chips) 
Seat 3: rodrieliot ($45 in chips) 
Seat 4: ILS16L ($83.65 in chips) 
Seat 5: Clabby01 ($96.70 in chips) 
JDVC: posts small blind $1
rodrieliot: posts big blind $2
*** HOLE CARDS ***
ILS16L: folds 
Clabby01: folds 
AillemKall: raises $2.10 to $4.10
JDVC: calls $3.10
rodrieliot: folds 
*** FLOP *** [Th 3s 5h]
sebass911 joins the table at seat #6 
JDVC: checks 
AillemKall: checks 
*** TURN *** [Th 3s 5h] [Ac]
JDVC: bets $6
AillemKall: folds 
Uncalled bet ($6) returned to JDVC
JDVC collected $9.70 from pot
JDVC: doesn't show hand 
*** SUMMARY ***
Total pot $10.20 | Rake $0.50 
Board [Th 3s 5h Ac]
Seat 1: AillemKall (button) folded on the Turn
Seat 2: JDVC (small blind) collected ($9.70)
Seat 3: rodrieliot (big blind) folded before Flop
Seat 4: ILS16L folded before Flop (didn't bet)
Seat 5: Clabby01 folded before Flop (didn't bet)




PokerStars Game #47185659847:  Hold'em No Limit ($1/$2 USD) - 2010/07/23 23:52:10 ET
Table 'Natalie' 6-max Seat #1 is the button
Seat 1: DURKADURDUR ($423.65 in chips) 
Seat 2: TODO ADENTR0 ($207.65 in chips) 
Seat 3: THEDUTCH4141 ($200 in chips) 
Seat 4: bluffinmyway ($196.80 in chips) 
Seat 6: leukehond ($214.45 in chips) 
TODO ADENTR0: posts small blind $1
THEDUTCH4141: posts big blind $2
*** HOLE CARDS ***
bluffinmyway: folds 
bluffinmyway leaves the table
leukehond: raises $3 to $5
DURKADURDUR: folds 
TODO ADENTR0: folds 
THEDUTCH4141: calls $3
*** FLOP *** [5h 2h 9s]
THEDUTCH4141: checks 
leukehond: checks 
*** TURN *** [5h 2h 9s] [5d]
THEDUTCH4141: checks 
leukehond: checks 
*** RIVER *** [5h 2h 9s 5d] [4c]
THEDUTCH4141: checks 
leukehond: checks 
*** SHOW DOWN ***
THEDUTCH4141: shows [Td Ad] (a pair of Fives)
leukehond: shows [As Kh] (a pair of Fives - Ace+King kicker)
leukehond collected $10.45 from pot
*** SUMMARY ***
Total pot $11 | Rake $0.55 
Board [5h 2h 9s 5d 4c]
Seat 1: DURKADURDUR (button) folded before Flop (didn't bet)
Seat 2: TODO ADENTR0 (small blind) folded before Flop
Seat 3: THEDUTCH4141 (big blind) showed [Td Ad] and lost with a pair of Fives
Seat 4: bluffinmyway folded before Flop (didn't bet)
Seat 6: leukehond showed [As Kh] and won ($10.45) with a pair of Fives




PokerStars Game #47185649619:  Hold'em No Limit ($1/$2 USD) - 2010/07/23 23:51:46 ET
Table 'Triton III' 6-max Seat #3 is the button
Seat 1: Cardsdevil27 ($72.80 in chips) 
Seat 2: Fierytycoon ($200 in chips) 
Seat 3: Jetize ($207 in chips) 
Seat 4: thomaswkm ($453.65 in chips) 
Seat 5: DURKADURDUR ($246.30 in chips) 
Seat 6: FrAnWaN ($429.25 in chips) 
thomaswkm: posts small blind $1
DURKADURDUR: posts big blind $2
*** HOLE CARDS ***
FrAnWaN: folds 
Cardsdevil27: folds 
Fierytycoon: folds 
Jetize: raises $4 to $6
thomaswkm: folds 
DURKADURDUR: folds 
Uncalled bet ($4) returned to Jetize
Jetize collected $5 from pot
Jetize: doesn't show hand 
*** SUMMARY ***
Total pot $5 | Rake $0 
Seat 1: Cardsdevil27 folded before Flop (didn't bet)
Seat 2: Fierytycoon folded before Flop (didn't bet)
Seat 3: Jetize (button) collected ($5)
Seat 4: thomaswkm (small blind) folded before Flop
Seat 5: DURKADURDUR (big blind) folded before Flop
Seat 6: FrAnWaN folded before Flop (didn't bet)




PokerStars Game #47185683609:  Hold'em No Limit ($1/$2 USD) - 2010/07/23 23:53:04 ET
Table 'Lonnrot III' 6-max Seat #6 is the button
Seat 1: THEDUTCH4141 ($201 in chips) 
Seat 2: Duke_Moto ($195.40 in chips) 
Seat 3: DURKADURDUR ($214.45 in chips) 
Seat 4: imthesky ($221.30 in chips) 
Seat 5: dajatt13 ($343 in chips) 
Seat 6: FrAnWaN ($291.75 in chips) 
THEDUTCH4141: posts small blind $1
Duke_Moto: posts big blind $2
*** HOLE CARDS ***
DURKADURDUR: folds 
imthesky: raises $6 to $8
dajatt13: folds 
FrAnWaN: folds 
THEDUTCH4141: folds 
Duke_Moto: folds 
Uncalled bet ($6) returned to imthesky
imthesky collected $5 from pot
imthesky: doesn't show hand 
*** SUMMARY ***
Total pot $5 | Rake $0 
Seat 1: THEDUTCH4141 (small blind) folded before Flop
Seat 2: Duke_Moto (big blind) folded before Flop
Seat 3: DURKADURDUR folded before Flop (didn't bet)
Seat 4: imthesky collected ($5)
Seat 5: dajatt13 folded before Flop (didn't bet)
Seat 6: FrAnWaN (button) folded before Flop (didn't bet)




PokerStars Game #47185670158:  Hold'em No Limit ($1/$2 USD) - 2010/07/23 23:52:33 ET
Table 'Lonnrot III' 6-max Seat #5 is the button
Seat 1: THEDUTCH4141 ($200 in chips) 
Seat 2: Duke_Moto ($195.40 in chips) 
Seat 3: DURKADURDUR ($214.45 in chips) 
Seat 4: imthesky ($221.30 in chips) 
Seat 5: dajatt13 ($343 in chips) 
Seat 6: FrAnWaN ($292.75 in chips) 
FrAnWaN: posts small blind $1
THEDUTCH4141: posts big blind $2
*** HOLE CARDS ***
Duke_Moto: folds 
DURKADURDUR: folds 
imthesky: folds 
dajatt13: folds 
FrAnWaN: folds 
Uncalled bet ($1) returned to THEDUTCH4141
THEDUTCH4141 collected $2 from pot
THEDUTCH4141: doesn't show hand 
*** SUMMARY ***
Total pot $2 | Rake $0 
Seat 1: THEDUTCH4141 (big blind) collected ($2)
Seat 2: Duke_Moto folded before Flop (didn't bet)
Seat 3: DURKADURDUR folded before Flop (didn't bet)
Seat 4: imthesky folded before Flop (didn't bet)
Seat 5: dajatt13 (button) folded before Flop (didn't bet)
Seat 6: FrAnWaN (small blind) folded before Flop




PokerStars Game #47185636831:  Hold'em No Limit ($1/$2 USD) - 2010/07/23 23:51:18 ET
Table 'Scutum X' 6-max Seat #1 is the button
Seat 1: jamieunlv017 ($115.90 in chips) 
Seat 2: AillemKall ($40 in chips) 
Seat 3: AironVega ($37.30 in chips) 
Seat 4: Mamoo ($31.80 in chips) 
Seat 5: Bruno_F88 ($117.10 in chips) 
Seat 6: mpm135 ($132.05 in chips) 
AillemKall: posts small blind $1
AironVega: posts big blind $2
*** HOLE CARDS ***
Mamoo: folds 
Bruno_F88: folds 
mpm135: folds 
jamieunlv017: folds 
AillemKall: folds 
Uncalled bet ($1) returned to AironVega
AironVega collected $2 from pot
AironVega: doesn't show hand 
*** SUMMARY ***
Total pot $2 | Rake $0 
Seat 1: jamieunlv017 (button) folded before Flop (didn't bet)
Seat 2: AillemKall (small blind) folded before Flop
Seat 3: AironVega (big blind) collected ($2)
Seat 4: Mamoo folded before Flop (didn't bet)
Seat 5: Bruno_F88 folded before Flop (didn't bet)
Seat 6: mpm135 folded before Flop (didn't bet)




PokerStars Game #47185627103:  Hold'em No Limit ($1/$2 USD) - 2010/07/23 23:50:56 ET
Table 'Pavo' 6-max Seat #3 is the button
Seat 1: dajatt13 ($208.65 in chips) 
Seat 2: FrAnWaN ($407.90 in chips) 
Seat 3: botano ($101.40 in chips) 
Seat 4: thomaswkm ($199.25 in chips) 
Seat 6: TheAwfulDin ($218.50 in chips) 
thomaswkm: posts small blind $1
Jigsaw630: is sitting out 
TheAwfulDin: posts big blind $2
*** HOLE CARDS ***
Jigsaw630 leaves the table
dajatt13: folds 
THEDUTCH4141 joins the table at seat #5 
FrAnWaN: folds 
botano: folds 
thomaswkm: raises $4 to $6
TheAwfulDin: folds 
Uncalled bet ($4) returned to thomaswkm
thomaswkm collected $4 from pot
thomaswkm: doesn't show hand 
*** SUMMARY ***
Total pot $4 | Rake $0 
Seat 1: dajatt13 folded before Flop (didn't bet)
Seat 2: FrAnWaN folded before Flop (didn't bet)
Seat 3: botano (button) folded before Flop (didn't bet)
Seat 4: thomaswkm (small blind) collected ($4)
Seat 6: TheAwfulDin (big blind) folded before Flop




PokerStars Game #47185624288:  Hold'em No Limit ($1/$2 USD) - 2010/07/23 23:50:49 ET
Table 'Orthosie II' 6-max Seat #6 is the button
Seat 1: neni85 ($502.45 in chips) 
Seat 3: WizardOfAhhs ($39 in chips) 
Seat 4: spiderfrank ($51.75 in chips) 
Seat 5: LeoFara ($39.45 in chips) 
Seat 6: onitsuaf ($68.50 in chips) 
neni85: posts small blind $1
WizardOfAhhs: posts big blind $2
*** HOLE CARDS ***
spiderfrank: folds 
LeoFara: folds 
onitsuaf: calls $2
neni85: folds 
WizardOfAhhs: checks 
*** FLOP *** [Kh 2h Ad]
WizardOfAhhs: checks 
onitsuaf: bets $6
WizardOfAhhs: folds 
Uncalled bet ($6) returned to onitsuaf
HuffyK leaves the table
onitsuaf collected $4.75 from pot
*** SUMMARY ***
Total pot $5 | Rake $0.25 
Board [Kh 2h Ad]
Seat 1: neni85 (small blind) folded before Flop
Seat 3: WizardOfAhhs (big blind) folded on the Flop
Seat 4: spiderfrank folded before Flop (didn't bet)
Seat 5: LeoFara folded before Flop (didn't bet)
Seat 6: onitsuaf (button) collected ($4.75)




PokerStars Game #47185629694:  Hold'em No Limit ($1/$2 USD) - 2010/07/23 23:51:01 ET
Table 'Margo II' 6-max Seat #6 is the button
Seat 1: wheels6990 ($44 in chips) 
Seat 2: AillemKall ($31 in chips) 
Seat 3: crock41 ($66.10 in chips) 
Seat 4: WizardOfAhhs ($84.35 in chips) 
Seat 5: AironVega ($36.60 in chips) 
Seat 6: JLS1956 ($52.65 in chips) 
wheels6990: posts small blind $1
AillemKall: posts big blind $2
*** HOLE CARDS ***
crock41: folds 
WizardOfAhhs: folds 
AironVega: folds 
JLS1956: folds 
wheels6990: folds 
Uncalled bet ($1) returned to AillemKall
AillemKall collected $2 from pot
AillemKall: doesn't show hand 
*** SUMMARY ***
Total pot $2 | Rake $0 
Seat 1: wheels6990 (small blind) folded before Flop
Seat 2: AillemKall (big blind) collected ($2)
Seat 3: crock41 folded before Flop (didn't bet)
Seat 4: WizardOfAhhs folded before Flop (didn't bet)
Seat 5: AironVega folded before Flop (didn't bet)
Seat 6: JLS1956 (button) folded before Flop (didn't bet)




PokerStars Game #47185652772:  Hold'em No Limit ($1/$2 USD) - 2010/07/23 23:51:53 ET
Table 'Regulus' 6-max Seat #4 is the button
Seat 1: FrAnWaN ($253.05 in chips) 
Seat 2: Fierytycoon ($202.95 in chips) 
Seat 3: TODO ADENTR0 ($384.95 in chips) 
Seat 4: thomaswkm ($268.40 in chips) 
Seat 5: DURKADURDUR ($427.40 in chips) 
Seat 6: Rush51 ($70.75 in chips) 
DURKADURDUR: posts small blind $1
Rush51: posts big blind $2
*** HOLE CARDS ***
FrAnWaN: folds 
Fierytycoon: folds 
TODO ADENTR0: folds 
thomaswkm: folds 
DURKADURDUR: folds 
Uncalled bet ($1) returned to Rush51
Rush51 collected $2 from pot
Rush51: doesn't show hand 
*** SUMMARY ***
Total pot $2 | Rake $0 
Seat 1: FrAnWaN folded before Flop (didn't bet)
Seat 2: Fierytycoon folded before Flop (didn't bet)
Seat 3: TODO ADENTR0 folded before Flop (didn't bet)
Seat 4: thomaswkm (button) folded before Flop (didn't bet)
Seat 5: DURKADURDUR (small blind) folded before Flop
Seat 6: Rush51 (big blind) collected ($2)




PokerStars Game #47185693930:  Hold'em No Limit ($1/$2 USD) - 2010/07/23 23:53:27 ET
Table 'Phereclos II' 6-max Seat #4 is the button
Seat 1: mpolice2010 ($60.25 in chips) 
Seat 3: ILS16L ($45.90 in chips) 
Seat 4: mpm135 ($478.45 in chips) 
Seat 5: TexasSooner2 ($84.55 in chips) 
TexasSooner2: posts small blind $1
mpolice2010: posts big blind $2
*** HOLE CARDS ***
rafa1985 joins the table at seat #2 
ILS16L: raises $4 to $6
mpm135: folds 
TexasSooner2: folds 
mpolice2010: calls $4
*** FLOP *** [9s Td Th]
mpolice2010: checks 
ILS16L: checks 
*** TURN *** [9s Td Th] [8h]
mpolice2010: checks 
ILS16L: bets $8
mpolice2010: folds 
Uncalled bet ($8) returned to ILS16L
ILS16L collected $12.35 from pot
ILS16L: doesn't show hand 
*** SUMMARY ***
Total pot $13 | Rake $0.65 
Board [9s Td Th 8h]
Seat 1: mpolice2010 (big blind) folded on the Turn
Seat 3: ILS16L collected ($12.35)
Seat 4: mpm135 (button) folded before Flop (didn't bet)
Seat 5: TexasSooner2 (small blind) folded before Flop




PokerStars Game #47185649929:  Hold'em No Limit ($1/$2 USD) - 2010/07/23 23:51:47 ET
Table 'Laodica' 6-max Seat #1 is the button
Seat 1: WizardOfAhhs ($81.50 in chips) 
Seat 2: LeoFara ($41.80 in chips) 
Seat 3: jimjam1979 ($44 in chips) 
Seat 4: BlindFlying ($98.45 in chips) 
Seat 5: rodrieliot ($57.60 in chips) 
Seat 6: JuStBLaZe908 ($231.85 in chips) 
LeoFara: posts small blind $1
jimjam1979: posts big blind $2
*** HOLE CARDS ***
BlindFlying: folds 
rodrieliot: raises $4 to $6
JuStBLaZe908: folds 
WizardOfAhhs: folds 
LeoFara: folds 
jimjam1979: folds 
Uncalled bet ($4) returned to rodrieliot
rodrieliot collected $5 from pot
*** SUMMARY ***
Total pot $5 | Rake $0 
Seat 1: WizardOfAhhs (button) folded before Flop (didn't bet)
Seat 2: LeoFara (small blind) folded before Flop
Seat 3: jimjam1979 (big blind) folded before Flop
Seat 4: BlindFlying folded before Flop (didn't bet)
Seat 5: rodrieliot collected ($5)
Seat 6: JuStBLaZe908 folded before Flop (didn't bet)




PokerStars Game #47185643975:  Hold'em No Limit ($1/$2 USD) - 2010/07/23 23:51:34 ET
Table 'Kentaurus IV' 6-max Seat #4 is the button
Seat 1: neni85 ($265.45 in chips) 
Seat 2: DMACM ($96.25 in chips) 
Seat 3: abbry24 ($108.55 in chips) 
Seat 4: AillemKall ($35.90 in chips) 
Seat 5: LeoFara ($52.80 in chips) 
Seat 6: FlushVirus ($87.30 in chips) 
LeoFara: posts small blind $1
FlushVirus: posts big blind $2
*** HOLE CARDS ***
neni85: folds 
DMACM: folds 
abbry24: raises $4 to $6
AillemKall: folds 
LeoFara: raises $46.80 to $52.80 and is all-in
FlushVirus: folds 
abbry24: folds 
Uncalled bet ($46.80) returned to LeoFara
LeoFara collected $14 from pot
*** SUMMARY ***
Total pot $14 | Rake $0 
Seat 1: neni85 folded before Flop (didn't bet)
Seat 2: DMACM folded before Flop (didn't bet)
Seat 3: abbry24 folded before Flop
Seat 4: AillemKall (button) folded before Flop (didn't bet)
Seat 5: LeoFara (small blind) collected ($14)
Seat 6: FlushVirus (big blind) folded before Flop




PokerStars Game #47185661725:  Hold'em No Limit ($1/$2 USD) - 2010/07/23 23:52:14 ET
Table 'Maia III' 6-max Seat #4 is the button
Seat 1: thomaswkm ($195.35 in chips) 
Seat 2: FrAnWaN ($371.65 in chips) 
Seat 3: dertaylor ($208.25 in chips) 
Seat 4: TODO ADENTR0 ($218 in chips) 
Seat 5: DURKADURDUR ($205.20 in chips) 
Seat 6: hellokittery ($219.40 in chips) 
DURKADURDUR: posts small blind $1
hellokittery: posts big blind $2
*** HOLE CARDS ***
thomaswkm: folds 
FrAnWaN: folds 
dertaylor: folds 
TODO ADENTR0: folds 
DURKADURDUR: folds 
Uncalled bet ($1) returned to hellokittery
hellokittery collected $2 from pot
hellokittery: doesn't show hand 
*** SUMMARY ***
Total pot $2 | Rake $0 
Seat 1: thomaswkm folded before Flop (didn't bet)
Seat 2: FrAnWaN folded before Flop (didn't bet)
Seat 3: dertaylor folded before Flop (didn't bet)
Seat 4: TODO ADENTR0 (button) folded before Flop (didn't bet)
Seat 5: DURKADURDUR (small blind) folded before Flop
Seat 6: hellokittery (big blind) collected ($2)




PokerStars Game #47185656772:  Hold'em No Limit ($1/$2 USD) - 2010/07/23 23:52:03 ET
Table 'Laocoon III' 6-max Seat #1 is the button
Seat 1: 1tormentor ($292.20 in chips) 
Seat 2: angryjamman ($184.55 in chips) 
Seat 3: TODO ADENTR0 ($215.90 in chips) 
Seat 5: DURKADURDUR ($200 in chips) 
Seat 6: FrAnWaN ($293.70 in chips) 
angryjamman: posts small blind $1
TODO ADENTR0: posts big blind $2
Fierytycoon: sits out 
*** HOLE CARDS ***
DURKADURDUR: raises $4 to $6
FrAnWaN: folds 
1tormentor: folds 
angryjamman: calls $5
TODO ADENTR0: folds 
*** FLOP *** [6d Qs 2d]
angryjamman: bets $10
DURKADURDUR: folds 
Uncalled bet ($10) returned to angryjamman
angryjamman collected $13.30 from pot
*** SUMMARY ***
Total pot $14 | Rake $0.70 
Board [6d Qs 2d]
Seat 1: 1tormentor (button) folded before Flop (didn't bet)
Seat 2: angryjamman (small blind) collected ($13.30)
Seat 3: TODO ADENTR0 (big blind) folded before Flop
Seat 5: DURKADURDUR folded on the Flop
Seat 6: FrAnWaN folded before Flop (didn't bet)




PokerStars Game #47185674925:  Hold'em No Limit ($1/$2 USD) - 2010/07/23 23:52:44 ET
Table 'Malabar III' 6-max Seat #2 is the button
Seat 1: imthesky ($376 in chips) 
Seat 2: TODO ADENTR0 ($233 in chips) 
Seat 3: leukehond ($200 in chips) 
Seat 4: hellokittery ($200 in chips) 
Seat 5: MooMooTin ($104.30 in chips) 
Seat 6: DURKADURDUR ($385.20 in chips) 
leukehond: posts small blind $1
hellokittery: posts big blind $2
*** HOLE CARDS ***
MooMooTin: folds 
DURKADURDUR: folds 
imthesky: folds 
TODO ADENTR0: raises $3 to $5
leukehond: folds 
hellokittery: folds 
Uncalled bet ($3) returned to TODO ADENTR0
TODO ADENTR0 collected $5 from pot
TODO ADENTR0: doesn't show hand 
*** SUMMARY ***
Total pot $5 | Rake $0 
Seat 1: imthesky folded before Flop (didn't bet)
Seat 2: TODO ADENTR0 (button) collected ($5)
Seat 3: leukehond (small blind) folded before Flop
Seat 4: hellokittery (big blind) folded before Flop
Seat 5: MooMooTin folded before Flop (didn't bet)
Seat 6: DURKADURDUR folded before Flop (didn't bet)




PokerStars Game #47185649696:  Hold'em No Limit ($1/$2 USD) - 2010/07/23 23:51:47 ET
Table 'Margo II' 6-max Seat #2 is the button
Seat 1: wheels6990 ($43 in chips) 
Seat 2: AillemKall ($31 in chips) 
Seat 3: crock41 ($67.10 in chips) 
Seat 4: WizardOfAhhs ($84.35 in chips) 
Seat 5: AironVega ($36.60 in chips) 
Seat 6: JLS1956 ($52.65 in chips) 
crock41: posts small blind $1
WizardOfAhhs: posts big blind $2
*** HOLE CARDS ***
AironVega: folds 
JLS1956: folds 
wheels6990: folds 
AillemKall: raises $2.10 to $4.10
crock41: folds 
WizardOfAhhs: folds 
Uncalled bet ($2.10) returned to AillemKall
AillemKall collected $5 from pot
AillemKall: doesn't show hand 
*** SUMMARY ***
Total pot $5 | Rake $0 
Seat 1: wheels6990 folded before Flop (didn't bet)
Seat 2: AillemKall (button) collected ($5)
Seat 3: crock41 (small blind) folded before Flop
Seat 4: WizardOfAhhs (big blind) folded before Flop
Seat 5: AironVega folded before Flop (didn't bet)
Seat 6: JLS1956 folded before Flop (didn't bet)




PokerStars Game #47185677860:  Hold'em No Limit ($1/$2 USD) - 2010/07/23 23:52:51 ET
Table 'Scutum X' 6-max Seat #4 is the button
Seat 1: jamieunlv017 ($115.90 in chips) 
Seat 2: AillemKall ($34.90 in chips) 
Seat 3: AironVega ($50 in chips) 
Seat 4: Mamoo ($25.70 in chips) 
Seat 5: Bruno_F88 ($115.10 in chips) 
Seat 6: mpm135 ($132.05 in chips) 
Bruno_F88: posts small blind $1
mpm135: posts big blind $2
*** HOLE CARDS ***
jamieunlv017: folds 
AillemKall: folds 
AironVega: raises $2.10 to $4.10
Mamoo: folds 
Bruno_F88: folds 
mpm135: raises $63.90 to $68
AironVega: folds 
Uncalled bet ($63.90) returned to mpm135
mpm135 collected $9.20 from pot
mpm135: doesn't show hand 
*** SUMMARY ***
Total pot $9.20 | Rake $0 
Seat 1: jamieunlv017 folded before Flop (didn't bet)
Seat 2: AillemKall folded before Flop (didn't bet)
Seat 3: AironVega folded before Flop
Seat 4: Mamoo (button) folded before Flop (didn't bet)
Seat 5: Bruno_F88 (small blind) folded before Flop
Seat 6: mpm135 (big blind) collected ($9.20)




PokerStars Game #47185626780:  Hold'em No Limit ($1/$2 USD) - 2010/07/23 23:50:55 ET
Table 'Selene' 6-max Seat #2 is the button
Seat 1: beargood ($109.35 in chips) 
Seat 2: Rocco35 ($24.35 in chips) 
Seat 3: Mamoo ($172.25 in chips) 
Seat 4: HUMBLED1 ($278 in chips) 
Seat 5: DMACM ($19.65 in chips) 
Seat 6: BlindFlying ($100 in chips) 
Mamoo: posts small blind $1
HUMBLED1: posts big blind $2
*** HOLE CARDS ***
DMACM: raises $4 to $6
BlindFlying: folds 
beargood: folds 
Rocco35: raises $18.35 to $24.35 and is all-in
Mamoo: folds 
HUMBLED1: folds 
DMACM: calls $13.65 and is all-in
Uncalled bet ($4.70) returned to Rocco35
*** FLOP *** [3c 2h 5c]
*** TURN *** [3c 2h 5c] [2c]
*** RIVER *** [3c 2h 5c 2c] [7c]
*** SHOW DOWN ***
DMACM: shows [Td Jh] (a pair of Deuces)
Rocco35: shows [3s 3h] (a full house, Threes full of Deuces)
Rocco35 collected $40.20 from pot
*** SUMMARY ***
Total pot $42.30 | Rake $2.10 
Board [3c 2h 5c 2c 7c]
Seat 1: beargood folded before Flop (didn't bet)
Seat 2: Rocco35 (button) showed [3s 3h] and won ($40.20) with a full house, Threes full of Deuces
Seat 3: Mamoo (small blind) folded before Flop
Seat 4: HUMBLED1 (big blind) folded before Flop
Seat 5: DMACM showed [Td Jh] and lost with a pair of Deuces
Seat 6: BlindFlying folded before Flop (didn't bet)




PokerStars Game #47185617919:  Hold'em No Limit ($1/$2 USD) - 2010/07/23 23:50:35 ET
Table 'Thoas' 6-max Seat #1 is the button
Seat 1: mdeckND ($277.15 in chips) 
Seat 2: DURKADURDUR ($706.25 in chips) 
Seat 3: Jetize ($238.40 in chips) 
Seat 4: mojox ($68.55 in chips) 
Seat 5: FrAnWaN ($325.50 in chips) 
Seat 6: asseral ($223.65 in chips) 
DURKADURDUR: posts small blind $1
Jetize: posts big blind $2
*** HOLE CARDS ***
mojox: calls $2
FrAnWaN: folds 
asseral: folds 
mdeckND: raises $6 to $8
DURKADURDUR: folds 
Jetize: folds 
mojox: calls $6
*** FLOP *** [6h Jc Jd]
mojox: checks 
mdeckND: checks 
*** TURN *** [6h Jc Jd] [9d]
mojox: checks 
mdeckND: checks 
*** RIVER *** [6h Jc Jd 9d] [8d]
mojox: checks 
mdeckND: checks 
*** SHOW DOWN ***
mojox: shows [Kc Tc] (a pair of Jacks)
mdeckND: shows [Qd Kh] (a pair of Jacks - King+Queen kicker)
mdeckND collected $18.05 from pot
*** SUMMARY ***
Total pot $19 | Rake $0.95 
Board [6h Jc Jd 9d 8d]
Seat 1: mdeckND (button) showed [Qd Kh] and won ($18.05) with a pair of Jacks
Seat 2: DURKADURDUR (small blind) folded before Flop
Seat 3: Jetize (big blind) folded before Flop
Seat 4: mojox showed [Kc Tc] and lost with a pair of Jacks
Seat 5: FrAnWaN folded before Flop (didn't bet)
Seat 6: asseral folded before Flop (didn't bet)




PokerStars Game #47185646725:  Hold'em No Limit ($1/$2 USD) - 2010/07/23 23:51:40 ET
Table 'Sibylla II' 6-max Seat #4 is the button
Seat 1: LeoFara ($54.35 in chips) 
Seat 2: AironVega ($32.90 in chips) 
Seat 3: jimjam1979 ($39.85 in chips) 
Seat 4: sp4taxes ($71.85 in chips) 
Seat 5: BlindFlying ($187.90 in chips) 
Seat 6: tradan ($56.15 in chips) 
BlindFlying: posts small blind $1
tradan: posts big blind $2
*** HOLE CARDS ***
LeoFara: folds 
AironVega: raises $2.10 to $4.10
jimjam1979: folds 
sp4taxes: calls $4.10
BlindFlying: raises $9.90 to $14
tradan: folds 
AironVega: folds 
sp4taxes: calls $9.90
*** FLOP *** [4s 9d 6c]
BlindFlying: checks 
sp4taxes: checks 
*** TURN *** [4s 9d 6c] [7h]
BlindFlying: checks 
sp4taxes: checks 
*** RIVER *** [4s 9d 6c 7h] [2d]
BlindFlying: checks 
sp4taxes: checks 
*** SHOW DOWN ***
BlindFlying: shows [Qc Ah] (high card Ace)
sp4taxes: mucks hand 
BlindFlying collected $32.40 from pot
*** SUMMARY ***
Total pot $34.10 | Rake $1.70 
Board [4s 9d 6c 7h 2d]
Seat 1: LeoFara folded before Flop (didn't bet)
Seat 2: AironVega folded before Flop
Seat 3: jimjam1979 folded before Flop (didn't bet)
Seat 4: sp4taxes (button) mucked
Seat 5: BlindFlying (small blind) showed [Qc Ah] and won ($32.40) with high card Ace
Seat 6: tradan (big blind) folded before Flop




PokerStars Game #47185670618:  Hold'em No Limit ($1/$2 USD) - 2010/07/23 23:52:34 ET
Table 'Selene' 6-max Seat #6 is the button
Seat 1: beargood ($107.35 in chips) 
Seat 2: Rocco35 ($47.65 in chips) 
Seat 3: Mamoo ($171.25 in chips) 
Seat 4: HUMBLED1 ($278 in chips) 
Seat 5: DMACM ($86.35 in chips) 
Seat 6: BlindFlying ($97 in chips) 
beargood: posts small blind $1
Rocco35: posts big blind $2
*** HOLE CARDS ***
Mamoo: raises $4 to $6
HUMBLED1: folds 
DMACM: folds 
BlindFlying: calls $6
beargood: folds 
Rocco35: folds 
*** FLOP *** [Ad 4c 5s]
Mamoo: bets $8
BlindFlying: calls $8
*** TURN *** [Ad 4c 5s] [7h]
Mamoo: bets $16
BlindFlying: calls $16
*** RIVER *** [Ad 4c 5s 7h] [6s]
Mamoo: checks 
BlindFlying: bets $38
Mamoo: calls $38
*** SHOW DOWN ***
BlindFlying: shows [7s 6c] (two pair, Sevens and Sixes)
Mamoo: mucks hand 
BlindFlying collected $136 from pot
*** SUMMARY ***
Total pot $139 | Rake $3 
Board [Ad 4c 5s 7h 6s]
Seat 1: beargood (small blind) folded before Flop
Seat 2: Rocco35 (big blind) folded before Flop
Seat 3: Mamoo mucked
Seat 4: HUMBLED1 folded before Flop (didn't bet)
Seat 5: DMACM folded before Flop (didn't bet)
Seat 6: BlindFlying (button) showed [7s 6c] and won ($136) with two pair, Sevens and Sixes




PokerStars Game #47185649810:  Hold'em No Limit ($1/$2 USD) - 2010/07/23 23:51:47 ET
Table 'Wilhelmina' 6-max Seat #5 is the button
Seat 2: DMACM ($94 in chips) 
Seat 3: Bookie1978 ($488.85 in chips) 
Seat 4: richard175 ($33.70 in chips) 
Seat 5: TODO ADENTR0 ($338 in chips) 
Seat 6: hellokittery ($210.85 in chips) 
hellokittery: posts small blind $1
DMACM: posts big blind $2
*** HOLE CARDS ***
Bookie1978: folds 
richard175: calls $2
TODO ADENTR0: folds 
hellokittery: raises $6 to $8
DMACM: folds 
richard175: calls $6
*** FLOP *** [Qs 3c 6s]
hellokittery: checks 
richard175: checks 
*** TURN *** [Qs 3c 6s] [Jh]
hellokittery: checks 
richard175: checks 
*** RIVER *** [Qs 3c 6s Jh] [9c]
jaeh00d joins the table at seat #1 
hellokittery: checks 
richard175: checks 
*** SHOW DOWN ***
hellokittery: shows [Jc Kd] (a pair of Jacks)
richard175: mucks hand 
hellokittery collected $17.10 from pot
*** SUMMARY ***
Total pot $18 | Rake $0.90 
Board [Qs 3c 6s Jh 9c]
Seat 2: DMACM (big blind) folded before Flop
Seat 3: Bookie1978 folded before Flop (didn't bet)
Seat 4: richard175 mucked
Seat 5: TODO ADENTR0 (button) folded before Flop (didn't bet)
Seat 6: hellokittery (small blind) showed [Jc Kd] and won ($17.10) with a pair of Jacks




PokerStars Game #47185660442:  Hold'em No Limit ($1/$2 USD) - 2010/07/23 23:52:11 ET
Table 'Menelaus II' 6-max Seat #5 is the button
Seat 1: LeoFara ($40 in chips) 
Seat 2: Berg58 ($65 in chips) 
Seat 3: topstich ($54.85 in chips) 
Seat 4: mzosh ($193.30 in chips) 
Seat 5: tdiddy ($163.25 in chips) 
Seat 6: sp4taxes ($48.85 in chips) 
sp4taxes: posts small blind $1
LeoFara: posts big blind $2
*** HOLE CARDS ***
Berg58: folds 
topstich: calls $2
mzosh: folds 
tdiddy: folds 
sp4taxes: raises $2 to $4
LeoFara: folds 
topstich: calls $2
*** FLOP *** [Ts 5h 8s]
sp4taxes: bets $10
topstich: calls $10
*** TURN *** [Ts 5h 8s] [2s]
sp4taxes: checks 
topstich: bets $6
sp4taxes: calls $6
*** RIVER *** [Ts 5h 8s 2s] [Kh]
sp4taxes: bets $28.85 and is all-in
topstich: folds 
Uncalled bet ($28.85) returned to sp4taxes
sp4taxes collected $40 from pot
sp4taxes: doesn't show hand 
*** SUMMARY ***
Total pot $42 | Rake $2 
Board [Ts 5h 8s 2s Kh]
Seat 1: LeoFara (big blind) folded before Flop
Seat 2: Berg58 folded before Flop (didn't bet)
Seat 3: topstich folded on the River
Seat 4: mzosh folded before Flop (didn't bet)
Seat 5: tdiddy (button) folded before Flop (didn't bet)
Seat 6: sp4taxes (small blind) collected ($40)




PokerStars Game #47185621680:  Hold'em No Limit ($1/$2 USD) - 2010/07/23 23:50:44 ET
Table 'Scutum X' 6-max Seat #6 is the button
Seat 1: jamieunlv017 ($119.90 in chips) 
Seat 2: AillemKall ($23.65 in chips) 
Seat 3: AironVega ($37.30 in chips) 
Seat 4: Mamoo ($31.80 in chips) 
Seat 5: Bruno_F88 ($117.10 in chips) 
Seat 6: mpm135 ($106.95 in chips) 
jamieunlv017: posts small blind $1
AillemKall: posts big blind $2
*** HOLE CARDS ***
AironVega: folds 
Mamoo: folds 
Bruno_F88: folds 
mpm135: raises $2 to $4
jamieunlv017: calls $3
AillemKall: raises $19.65 to $23.65 and is all-in
mpm135: calls $19.65
jamieunlv017: folds 
*** FLOP *** [3s Ah 2c]
*** TURN *** [3s Ah 2c] [2h]
*** RIVER *** [3s Ah 2c 2h] [8h]
*** SHOW DOWN ***
AillemKall: shows [Td Ks] (a pair of Deuces)
mpm135: shows [7d Ad] (two pair, Aces and Deuces)
mpm135 collected $48.75 from pot
*** SUMMARY ***
Total pot $51.30 | Rake $2.55 
Board [3s Ah 2c 2h 8h]
Seat 1: jamieunlv017 (small blind) folded before Flop
Seat 2: AillemKall (big blind) showed [Td Ks] and lost with a pair of Deuces
Seat 3: AironVega folded before Flop (didn't bet)
Seat 4: Mamoo folded before Flop (didn't bet)
Seat 5: Bruno_F88 folded before Flop (didn't bet)
Seat 6: mpm135 (button) showed [7d Ad] and won ($48.75) with two pair, Aces and Deuces




PokerStars Game #47185689037:  Hold'em No Limit ($1/$2 USD) - 2010/07/23 23:53:16 ET
Table 'Neckar VII' 6-max Seat #1 is the button
Seat 1: Marker275 ($201.10 in chips) 
Seat 2: DURKADURDUR ($282.10 in chips) 
Seat 3: dmyj ($200 in chips) 
Seat 4: THEDUTCH4141 ($214.55 in chips) 
Seat 5: imthesky ($204.60 in chips) 
DURKADURDUR: posts small blind $1
dmyj: posts big blind $2
botano: sits out 
*** HOLE CARDS ***
THEDUTCH4141: folds 
imthesky: folds 
Marker275: raises $4 to $6
DURKADURDUR: folds 
dmyj: folds 
Uncalled bet ($4) returned to Marker275
Marker275 collected $5 from pot
Marker275: doesn't show hand 
*** SUMMARY ***
Total pot $5 | Rake $0 
Seat 1: Marker275 (button) collected ($5)
Seat 2: DURKADURDUR (small blind) folded before Flop
Seat 3: dmyj (big blind) folded before Flop
Seat 4: THEDUTCH4141 folded before Flop (didn't bet)
Seat 5: imthesky folded before Flop (didn't bet)




PokerStars Game #47185655745:  Hold'em No Limit ($1/$2 USD) - 2010/07/23 23:52:00 ET
Table 'Luscinia' 6-max Seat #3 is the button
Seat 1: AillemKall ($38.30 in chips) 
Seat 2: JDVC ($68.25 in chips) 
Seat 3: rodrieliot ($42 in chips) 
Seat 4: ILS16L ($77.65 in chips) 
Seat 5: Clabby01 ($96.70 in chips) 
ILS16L: posts small blind $1
Clabby01: posts big blind $2
sebass911: sits out 
*** HOLE CARDS ***
AillemKall: folds 
JDVC: folds 
rodrieliot: folds 
ILS16L: calls $1
Clabby01: raises $6 to $8
ILS16L: folds 
Uncalled bet ($6) returned to Clabby01
Clabby01 collected $4 from pot
*** SUMMARY ***
Total pot $4 | Rake $0 
Seat 1: AillemKall folded before Flop (didn't bet)
Seat 2: JDVC folded before Flop (didn't bet)
Seat 3: rodrieliot (button) folded before Flop (didn't bet)
Seat 4: ILS16L (small blind) folded before Flop
Seat 5: Clabby01 (big blind) collected ($4)




PokerStars Game #47185694929:  Hold'em No Limit ($1/$2 USD) - 2010/07/23 23:53:29 ET
Table 'Pavo' 6-max Seat #1 is the button
Seat 1: dajatt13 ($208.65 in chips) 
Seat 2: FrAnWaN ($389.90 in chips) 
Seat 4: thomaswkm ($201.25 in chips) 
Seat 6: TheAwfulDin ($234.50 in chips) 
FrAnWaN: posts small blind $1
botano: is sitting out 
botano leaves the table
thomaswkm: posts big blind $2
THEDUTCH4141: sits out 
*** HOLE CARDS ***
FastEddie267 joins the table at seat #3 
TheAwfulDin: folds 
dajatt13: folds 
FrAnWaN: raises $4 to $6
thomaswkm: folds 
Uncalled bet ($4) returned to FrAnWaN
FrAnWaN collected $4 from pot
FrAnWaN: doesn't show hand 
*** SUMMARY ***
Total pot $4 | Rake $0 
Seat 1: dajatt13 (button) folded before Flop (didn't bet)
Seat 2: FrAnWaN (small blind) collected ($4)
Seat 4: thomaswkm (big blind) folded before Flop
Seat 6: TheAwfulDin folded before Flop (didn't bet)




PokerStars Game #47185726138:  Hold'em No Limit ($1/$2 USD) - 2010/07/23 23:54:40 ET
Table 'Scutum X' 6-max Seat #1 is the button
Seat 1: jamieunlv017 ($111.90 in chips) 
Seat 2: AillemKall ($36.70 in chips) 
Seat 3: AironVega ($48.90 in chips) 
Seat 4: Mamoo ($25.70 in chips) 
Seat 5: Bruno_F88 ($114.10 in chips) 
Seat 6: mpm135 ($136.15 in chips) 
AillemKall: posts small blind $1
AironVega: posts big blind $2
*** HOLE CARDS ***
Mamoo: raises $4 to $6
Bruno_F88: folds 
mpm135: folds 
jamieunlv017: folds 
AillemKall: folds 
AironVega: folds 
Uncalled bet ($4) returned to Mamoo
Mamoo collected $5 from pot
*** SUMMARY ***
Total pot $5 | Rake $0 
Seat 1: jamieunlv017 (button) folded before Flop (didn't bet)
Seat 2: AillemKall (small blind) folded before Flop
Seat 3: AironVega (big blind) folded before Flop
Seat 4: Mamoo collected ($5)
Seat 5: Bruno_F88 folded before Flop (didn't bet)
Seat 6: mpm135 folded before Flop (didn't bet)




PokerStars Game #47185694149:  Hold'em No Limit ($1/$2 USD) - 2010/07/23 23:53:28 ET
Table 'Shajna' 6-max Seat #3 is the button
Seat 1: neni85 ($100 in chips) 
Seat 2: wheels6990 ($86.85 in chips) 
Seat 3: robsolo ($65.05 in chips) 
Seat 4: latebrake ($63.10 in chips) 
Seat 5: jimjam1979 ($30 in chips) 
Seat 6: AillemKall ($46.70 in chips) 
latebrake: posts small blind $1
jimjam1979: posts big blind $2
*** HOLE CARDS ***
AillemKall: folds 
neni85: folds 
wheels6990: raises $2 to $4
robsolo: folds 
latebrake: folds 
jimjam1979: folds 
Uncalled bet ($2) returned to wheels6990
wheels6990 collected $5 from pot
*** SUMMARY ***
Total pot $5 | Rake $0 
Seat 1: neni85 folded before Flop (didn't bet)
Seat 2: wheels6990 collected ($5)
Seat 3: robsolo (button) folded before Flop (didn't bet)
Seat 4: latebrake (small blind) folded before Flop
Seat 5: jimjam1979 (big blind) folded before Flop
Seat 6: AillemKall folded before Flop (didn't bet)




PokerStars Game #47185707579:  Hold'em No Limit ($1/$2 USD) - 2010/07/23 23:53:58 ET
Table 'Kentaurus IV' 6-max Seat #1 is the button
Seat 1: neni85 ($262.45 in chips) 
Seat 2: DMACM ($94.25 in chips) 
Seat 3: THEDUTCH4141 ($100 in chips) 
Seat 4: AillemKall ($63.45 in chips) 
Seat 5: LeoFara ($60.80 in chips) 
Seat 6: FlushVirus ($94.70 in chips) 
DMACM: posts small blind $1
THEDUTCH4141: posts big blind $2
*** HOLE CARDS ***
AillemKall: folds 
LeoFara: calls $2
FlushVirus: calls $2
neni85: folds 
DMACM: calls $1
THEDUTCH4141: checks 
*** FLOP *** [Ah Ad Jh]
DMACM: checks 
THEDUTCH4141: bets $6
LeoFara: folds 
FlushVirus: folds 
DMACM: calls $6
*** TURN *** [Ah Ad Jh] [Kc]
DMACM: checks 
THEDUTCH4141: bets $12
DMACM: calls $12
*** RIVER *** [Ah Ad Jh Kc] [4s]
DMACM: checks 
THEDUTCH4141: bets $80 and is all-in
DMACM: calls $74.25 and is all-in
Uncalled bet ($5.75) returned to THEDUTCH4141
*** SHOW DOWN ***
THEDUTCH4141: shows [Td As] (three of a kind, Aces)
DMACM: shows [Ac 3h] (three of a kind, Aces)
DMACM collected $94.75 from pot
THEDUTCH4141 collected $94.75 from pot
*** SUMMARY ***
Total pot $192.50 | Rake $3 
Board [Ah Ad Jh Kc 4s]
Seat 1: neni85 (button) folded before Flop (didn't bet)
Seat 2: DMACM (small blind) showed [Ac 3h] and won ($94.75) with three of a kind, Aces
Seat 3: THEDUTCH4141 (big blind) showed [Td As] and won ($94.75) with three of a kind, Aces
Seat 4: AillemKall folded before Flop (didn't bet)
Seat 5: LeoFara folded on the Flop
Seat 6: FlushVirus folded on the Flop




PokerStars Game #47185700281:  Hold'em No Limit ($1/$2 USD) - 2010/07/23 23:53:42 ET
Table 'Orthosie II' 6-max Seat #6 is the button
Seat 1: neni85 ($502.45 in chips) 
Seat 2: harujongil ($100 in chips) 
Seat 3: WizardOfAhhs ($36 in chips) 
Seat 4: spiderfrank ($46.35 in chips) 
Seat 5: LeoFara ($41.40 in chips) 
Seat 6: onitsuaf ($74.05 in chips) 
neni85: posts small blind $1
harujongil: posts big blind $2
*** HOLE CARDS ***
WizardOfAhhs: folds 
spiderfrank: raises $2 to $4
LeoFara: folds 
onitsuaf: folds 
neni85: folds 
harujongil: raises $6 to $10
spiderfrank: calls $6
*** FLOP *** [7s 5s Js]
harujongil: bets $13
spiderfrank: calls $13
*** TURN *** [7s 5s Js] [Qs]
harujongil: checks 
spiderfrank: bets $12
harujongil: calls $12
*** RIVER *** [7s 5s Js Qs] [3s]
harujongil: checks 
spiderfrank: bets $11.35 and is all-in
harujongil: calls $11.35
*** SHOW DOWN ***
spiderfrank: shows [Ts Ad] (a flush, Queen high)
harujongil: shows [Jc Ac] (a flush, Queen high - lower cards)
spiderfrank collected $90.70 from pot
*** SUMMARY ***
Total pot $93.70 | Rake $3 
Board [7s 5s Js Qs 3s]
Seat 1: neni85 (small blind) folded before Flop
Seat 2: harujongil (big blind) showed [Jc Ac] and lost with a flush, Queen high
Seat 3: WizardOfAhhs folded before Flop (didn't bet)
Seat 4: spiderfrank showed [Ts Ad] and won ($90.70) with a flush, Queen high
Seat 5: LeoFara folded before Flop (didn't bet)
Seat 6: onitsuaf (button) folded before Flop (didn't bet)




PokerStars Game #47185722932:  Hold'em No Limit ($1/$2 USD) - 2010/07/23 23:54:33 ET
Table 'Thoas' 6-max Seat #1 is the button
Seat 1: mdeckND ($284.20 in chips) 
Seat 2: DURKADURDUR ($703.25 in chips) 
Seat 4: mojox ($60 in chips) 
Seat 5: FrAnWaN ($322.50 in chips) 
Seat 6: asseral ($235.60 in chips) 
DURKADURDUR: posts small blind $1
Jetize: is sitting out 
mojox: posts big blind $2
*** HOLE CARDS ***
FrAnWaN: folds 
asseral: folds 
mdeckND: folds 
DURKADURDUR: folds 
Uncalled bet ($1) returned to mojox
mojox collected $2 from pot
mojox: doesn't show hand 
*** SUMMARY ***
Total pot $2 | Rake $0 
Seat 1: mdeckND (button) folded before Flop (didn't bet)
Seat 2: DURKADURDUR (small blind) folded before Flop
Seat 4: mojox (big blind) collected ($2)
Seat 5: FrAnWaN folded before Flop (didn't bet)
Seat 6: asseral folded before Flop (didn't bet)




PokerStars Game #47185732994:  Hold'em No Limit ($1/$2 USD) - 2010/07/23 23:54:56 ET
Table 'Regulus' 6-max Seat #1 is the button
Seat 1: FrAnWaN ($242.05 in chips) 
Seat 2: Fierytycoon ($205.70 in chips) 
Seat 3: TODO ADENTR0 ($384.95 in chips) 
Seat 4: thomaswkm ($268.40 in chips) 
Seat 5: DURKADURDUR ($426.40 in chips) 
Seat 6: Rush51 ($78.80 in chips) 
Fierytycoon: posts small blind $1
TODO ADENTR0: posts big blind $2
*** HOLE CARDS ***
thomaswkm: folds 
DURKADURDUR: folds 
Rush51: folds 
FrAnWaN: raises $4 to $6
Fierytycoon: folds 
TODO ADENTR0: folds 
Uncalled bet ($4) returned to FrAnWaN
FrAnWaN collected $5 from pot
FrAnWaN: doesn't show hand 
*** SUMMARY ***
Total pot $5 | Rake $0 
Seat 1: FrAnWaN (button) collected ($5)
Seat 2: Fierytycoon (small blind) folded before Flop
Seat 3: TODO ADENTR0 (big blind) folded before Flop
Seat 4: thomaswkm folded before Flop (didn't bet)
Seat 5: DURKADURDUR folded before Flop (didn't bet)
Seat 6: Rush51 folded before Flop (didn't bet)




PokerStars Game #47185733996:  Hold'em No Limit ($1/$2 USD) - 2010/07/23 23:54:58 ET
Table 'Malabar III' 6-max Seat #4 is the button
Seat 1: imthesky ($376 in chips) 
Seat 2: TODO ADENTR0 ($236 in chips) 
Seat 3: leukehond ($200 in chips) 
Seat 4: hellokittery ($200 in chips) 
Seat 5: MooMooTin ($114.30 in chips) 
Seat 6: DURKADURDUR ($385.20 in chips) 
MooMooTin: posts small blind $1
DURKADURDUR: posts big blind $2
*** HOLE CARDS ***
imthesky: folds 
TODO ADENTR0: folds 
leukehond: raises $3 to $5
hellokittery: folds 
MooMooTin: folds 
DURKADURDUR: folds 
Uncalled bet ($3) returned to leukehond
leukehond collected $5 from pot
leukehond: doesn't show hand 
*** SUMMARY ***
Total pot $5 | Rake $0 
Seat 1: imthesky folded before Flop (didn't bet)
Seat 2: TODO ADENTR0 folded before Flop (didn't bet)
Seat 3: leukehond collected ($5)
Seat 4: hellokittery (button) folded before Flop (didn't bet)
Seat 5: MooMooTin (small blind) folded before Flop
Seat 6: DURKADURDUR (big blind) folded before Flop




PokerStars Game #47185741960:  Hold'em No Limit ($1/$2 USD) - 2010/07/23 23:55:20 ET
Table 'Lonnrot III' 6-max Seat #3 is the button
Seat 1: THEDUTCH4141 ($200 in chips) 
Seat 2: Duke_Moto ($210.95 in chips) 
Seat 3: DURKADURDUR ($211.45 in chips) 
Seat 4: imthesky ($222.30 in chips) 
Seat 5: dajatt13 ($343 in chips) 
Seat 6: FrAnWaN ($277.75 in chips) 
imthesky: posts small blind $1
dajatt13: posts big blind $2
*** HOLE CARDS ***
FrAnWaN: folds 
THEDUTCH4141: raises $4 to $6
Duke_Moto: folds 
DURKADURDUR: folds 
imthesky: folds 
dajatt13: folds 
Uncalled bet ($4) returned to THEDUTCH4141
THEDUTCH4141 collected $5 from pot
THEDUTCH4141: doesn't show hand 
*** SUMMARY ***
Total pot $5 | Rake $0 
Seat 1: THEDUTCH4141 collected ($5)
Seat 2: Duke_Moto folded before Flop (didn't bet)
Seat 3: DURKADURDUR (button) folded before Flop (didn't bet)
Seat 4: imthesky (small blind) folded before Flop
Seat 5: dajatt13 (big blind) folded before Flop
Seat 6: FrAnWaN folded before Flop (didn't bet)




PokerStars Game #47185729375:  Hold'em No Limit ($1/$2 USD) - 2010/07/23 23:54:47 ET
Table 'Neckar VII' 6-max Seat #4 is the button
Seat 1: Marker275 ($196.10 in chips) 
Seat 2: DURKADURDUR ($284.10 in chips) 
Seat 3: dmyj ($200 in chips) 
Seat 4: THEDUTCH4141 ($211.55 in chips) 
Seat 5: imthesky ($212.65 in chips) 
Seat 6: botano ($100 in chips) 
imthesky: posts small blind $1
botano: posts big blind $2
*** HOLE CARDS ***
Marker275: folds 
DURKADURDUR: folds 
dmyj: raises $4 to $6
THEDUTCH4141: folds 
imthesky: folds 
botano: calls $4
*** FLOP *** [Kd 2h 7h]
botano: checks 
dmyj: bets $8
botano: calls $8
*** TURN *** [Kd 2h 7h] [2d]
botano: checks 
dmyj: bets $20
botano: folds 
Uncalled bet ($20) returned to dmyj
dmyj collected $27.60 from pot
dmyj: doesn't show hand 
*** SUMMARY ***
Total pot $29 | Rake $1.40 
Board [Kd 2h 7h 2d]
Seat 1: Marker275 folded before Flop (didn't bet)
Seat 2: DURKADURDUR folded before Flop (didn't bet)
Seat 3: dmyj collected ($27.60)
Seat 4: THEDUTCH4141 (button) folded before Flop (didn't bet)
Seat 5: imthesky (small blind) folded before Flop
Seat 6: botano (big blind) folded on the Turn




PokerStars Game #47185653491:  Hold'em No Limit ($1/$2 USD) - 2010/07/23 23:51:55 ET
Table 'Shajna' 6-max Seat #2 is the button
Seat 1: neni85 ($100 in chips) 
Seat 2: wheels6990 ($78.50 in chips) 
Seat 3: robsolo ($66.05 in chips) 
Seat 4: latebrake ($67.10 in chips) 
Seat 5: jimjam1979 ($34 in chips) 
Seat 6: AillemKall ($46.70 in chips) 
robsolo: posts small blind $1
latebrake: posts big blind $2
*** HOLE CARDS ***
jimjam1979: raises $2 to $4
AillemKall: folds 
neni85: folds 
wheels6990: calls $4
robsolo: folds 
latebrake: calls $2
*** FLOP *** [4d Qs 6d]
latebrake: checks 
jimjam1979: checks 
wheels6990: bets $4
latebrake: folds 
jimjam1979: folds 
Uncalled bet ($4) returned to wheels6990
wheels6990 collected $12.35 from pot
*** SUMMARY ***
Total pot $13 | Rake $0.65 
Board [4d Qs 6d]
Seat 1: neni85 folded before Flop (didn't bet)
Seat 2: wheels6990 (button) collected ($12.35)
Seat 3: robsolo (small blind) folded before Flop
Seat 4: latebrake (big blind) folded on the Flop
Seat 5: jimjam1979 folded on the Flop
Seat 6: AillemKall folded before Flop (didn't bet)




PokerStars Game #47185725542:  Hold'em No Limit ($1/$2 USD) - 2010/07/23 23:54:39 ET
Table 'Phoenix V' 6-max Seat #1 is the button
Seat 1: MJJ & ADT ($33 in chips) 
Seat 2: tdiddy ($145.05 in chips) 
Seat 3: pike2229 ($188.80 in chips) 
Seat 4: jimjam1979 ($43 in chips) 
Seat 6: neni85 ($448.50 in chips) 
tdiddy: posts small blind $1
pike2229: posts big blind $2
*** HOLE CARDS ***
jimjam1979: folds 
neni85: raises $3 to $5
MJJ & ADT: folds 
tdiddy: folds 
pike2229: calls $3
*** FLOP *** [7c 6c 2h]
pike2229: checks 
neni85: checks 
*** TURN *** [7c 6c 2h] [Qh]
pike2229: checks 
neni85: checks 
*** RIVER *** [7c 6c 2h Qh] [5s]
pike2229: checks 
neni85: checks 
*** SHOW DOWN ***
pike2229: shows [9d Ac] (high card Ace)
neni85: mucks hand 
pike2229 collected $10.45 from pot
*** SUMMARY ***
Total pot $11 | Rake $0.55 
Board [7c 6c 2h Qh 5s]
Seat 1: MJJ & ADT (button) folded before Flop (didn't bet)
Seat 2: tdiddy (small blind) folded before Flop
Seat 3: pike2229 (big blind) showed [9d Ac] and won ($10.45) with high card Ace
Seat 4: jimjam1979 folded before Flop (didn't bet)
Seat 6: neni85 mucked




PokerStars Game #47185726010:  Hold'em No Limit ($1/$2 USD) - 2010/07/23 23:54:40 ET
Table 'Wilhelmina' 6-max Seat #6 is the button
Seat 1: jaeh00d ($200 in chips) 
Seat 2: DMACM ($91 in chips) 
Seat 4: richard175 ($70.35 in chips) 
Seat 5: TODO ADENTR0 ($295.30 in chips) 
Seat 6: hellokittery ($216.95 in chips) 
jaeh00d: posts small blind $1
DMACM: posts big blind $2
THEDUTCH4141: sits out 
*** HOLE CARDS ***
richard175: calls $2
TODO ADENTR0: folds 
hellokittery: folds 
jaeh00d: folds 
DMACM: checks 
*** FLOP *** [2h 2s 9c]
DMACM: checks 
richard175: checks 
*** TURN *** [2h 2s 9c] [8c]
DMACM: checks 
richard175: checks 
*** RIVER *** [2h 2s 9c 8c] [2c]
DMACM: checks 
richard175: bets $4
DMACM: folds 
Uncalled bet ($4) returned to richard175
richard175 collected $4.75 from pot
*** SUMMARY ***
Total pot $5 | Rake $0.25 
Board [2h 2s 9c 8c 2c]
Seat 1: jaeh00d (small blind) folded before Flop
Seat 2: DMACM (big blind) folded on the River
Seat 4: richard175 collected ($4.75)
Seat 5: TODO ADENTR0 folded before Flop (didn't bet)
Seat 6: hellokittery (button) folded before Flop (didn't bet)




PokerStars Game #47185717072:  Hold'em No Limit ($1/$2 USD) - 2010/07/23 23:54:20 ET
Table 'Rafita IV' 6-max Seat #6 is the button
Seat 1: neni85 ($155.10 in chips) 
Seat 2: NewEra760 ($70.85 in chips) 
Seat 3: AillemKall ($57.90 in chips) 
Seat 4: WizardOfAhhs ($112.35 in chips) 
Seat 5: jimjam1979 ($43.15 in chips) 
Seat 6: Ricko7456 ($151 in chips) 
neni85: posts small blind $1
NewEra760: posts big blind $2
*** HOLE CARDS ***
AillemKall: raises $2.10 to $4.10
WizardOfAhhs: folds 
jimjam1979: folds 
Ricko7456: calls $4.10
neni85: folds 
NewEra760: calls $2.10
*** FLOP *** [Kd 4c 5s]
NewEra760: checks 
AillemKall: checks 
Ricko7456: bets $12
NewEra760: folds 
AillemKall: folds 
Uncalled bet ($12) returned to Ricko7456
Ricko7456 collected $12.65 from pot
*** SUMMARY ***
Total pot $13.30 | Rake $0.65 
Board [Kd 4c 5s]
Seat 1: neni85 (small blind) folded before Flop
Seat 2: NewEra760 (big blind) folded on the Flop
Seat 3: AillemKall folded on the Flop
Seat 4: WizardOfAhhs folded before Flop (didn't bet)
Seat 5: jimjam1979 folded before Flop (didn't bet)
Seat 6: Ricko7456 (button) collected ($12.65)




PokerStars Game #47185749014:  Hold'em No Limit ($1/$2 USD) - 2010/07/23 23:55:41 ET
Table 'Orthosie II' 6-max Seat #4 is the button
Seat 1: neni85 ($504.45 in chips) 
Seat 2: harujongil ($92.65 in chips) 
Seat 4: spiderfrank ($96.10 in chips) 
Seat 5: LeoFara ($39.40 in chips) 
Seat 6: onitsuaf ($68.05 in chips) 
LeoFara: posts small blind $1
onitsuaf: posts big blind $2
*** HOLE CARDS ***
neni85: folds 
harujongil: folds 
spiderfrank: folds 
LeoFara: raises $2.40 to $4.40
onitsuaf: calls $2.40
*** FLOP *** [7h 3s Ts]
LeoFara: checks 
onitsuaf: checks 
*** TURN *** [7h 3s Ts] [Jc]
LeoFara: bets $5
onitsuaf: folds 
Uncalled bet ($5) returned to LeoFara
LeoFara collected $8.40 from pot
*** SUMMARY ***
Total pot $8.80 | Rake $0.40 
Board [7h 3s Ts Jc]
Seat 1: neni85 folded before Flop (didn't bet)
Seat 2: harujongil folded before Flop (didn't bet)
Seat 4: spiderfrank (button) folded before Flop (didn't bet)
Seat 5: LeoFara (small blind) collected ($8.40)
Seat 6: onitsuaf (big blind) folded on the Turn




PokerStars Game #47185705224:  Hold'em No Limit ($1/$2 USD) - 2010/07/23 23:53:53 ET
Table 'Triton III' 6-max Seat #5 is the button
Seat 1: Cardsdevil27 ($82.85 in chips) 
Seat 2: Fierytycoon ($200 in chips) 
Seat 3: Jetize ($202 in chips) 
Seat 4: thomaswkm ($452.65 in chips) 
Seat 5: DURKADURDUR ($243.30 in chips) 
Seat 6: FrAnWaN ($427.25 in chips) 
FrAnWaN: posts small blind $1
Cardsdevil27: posts big blind $2
*** HOLE CARDS ***
Fierytycoon: folds 
Jetize: folds 
thomaswkm: folds 
DURKADURDUR: folds 
FrAnWaN: raises $4 to $6
Cardsdevil27: folds 
Uncalled bet ($4) returned to FrAnWaN
FrAnWaN collected $4 from pot
FrAnWaN: doesn't show hand 
*** SUMMARY ***
Total pot $4 | Rake $0 
Seat 1: Cardsdevil27 (big blind) folded before Flop
Seat 2: Fierytycoon folded before Flop (didn't bet)
Seat 3: Jetize folded before Flop (didn't bet)
Seat 4: thomaswkm folded before Flop (didn't bet)
Seat 5: DURKADURDUR (button) folded before Flop (didn't bet)
Seat 6: FrAnWaN (small blind) collected ($4)




PokerStars Game #47185699807:  Hold'em No Limit ($1/$2 USD) - 2010/07/23 23:53:41 ET
Table 'Ottegebe' 6-max Seat #3 is the button
Seat 1: RdrLuv ($93.20 in chips) 
Seat 2: picasso264 ($54.65 in chips) 
Seat 3: AironVega ($36 in chips) 
Seat 4: DMACM ($125.45 in chips) 
Seat 6: jimjam1979 ($33 in chips) 
DMACM: posts small blind $1
WizardOfAhhs: is sitting out 
jimjam1979: posts big blind $2
*** HOLE CARDS ***
RdrLuv: calls $2
WizardOfAhhs leaves the table
picasso264: calls $2
AironVega: folds 
DMACM: folds 
jimjam1979: checks 
*** FLOP *** [2h 6h 9s]
jimjam1979: checks 
RdrLuv: bets $4
picasso264: folds 
jimjam1979: folds 
Uncalled bet ($4) returned to RdrLuv
RdrLuv collected $6.65 from pot
RdrLuv: doesn't show hand 
*** SUMMARY ***
Total pot $7 | Rake $0.35 
Board [2h 6h 9s]
Seat 1: RdrLuv collected ($6.65)
Seat 2: picasso264 folded on the Flop
Seat 3: AironVega (button) folded before Flop (didn't bet)
Seat 4: DMACM (small blind) folded before Flop
Seat 6: jimjam1979 (big blind) folded on the Flop




PokerStars Game #47185728709:  Hold'em No Limit ($1/$2 USD) - 2010/07/23 23:54:46 ET
Table 'Triton III' 6-max Seat #6 is the button
Seat 1: Cardsdevil27 ($80.85 in chips) 
Seat 2: Fierytycoon ($200 in chips) 
Seat 3: Jetize ($202 in chips) 
Seat 4: thomaswkm ($452.65 in chips) 
Seat 5: DURKADURDUR ($243.30 in chips) 
Seat 6: FrAnWaN ($429.25 in chips) 
Cardsdevil27: posts small blind $1
Fierytycoon: posts big blind $2
*** HOLE CARDS ***
Jetize: folds 
thomaswkm: raises $4 to $6
DURKADURDUR: raises $14 to $20
FrAnWaN: folds 
Cardsdevil27: folds 
Fierytycoon: folds 
thomaswkm: calls $14
*** FLOP *** [6s 6c Qd]
thomaswkm: checks 
DURKADURDUR: bets $27
thomaswkm: raises $49 to $76
DURKADURDUR: raises $147.30 to $223.30 and is all-in
thomaswkm: folds 
Uncalled bet ($147.30) returned to DURKADURDUR
DURKADURDUR collected $192 from pot
DURKADURDUR: doesn't show hand 
*** SUMMARY ***
Total pot $195 | Rake $3 
Board [6s 6c Qd]
Seat 1: Cardsdevil27 (small blind) folded before Flop
Seat 2: Fierytycoon (big blind) folded before Flop
Seat 3: Jetize folded before Flop (didn't bet)
Seat 4: thomaswkm folded on the Flop
Seat 5: DURKADURDUR collected ($192)
Seat 6: FrAnWaN (button) folded before Flop (didn't bet)




PokerStars Game #47185746972:  Hold'em No Limit ($1/$2 USD) - 2010/07/23 23:55:35 ET
Table 'Phereclos II' 6-max Seat #3 is the button
Seat 1: mpolice2010 ($86.55 in chips) 
Seat 2: rafa1985 ($56 in chips) 
Seat 3: ILS16L ($47.25 in chips) 
Seat 4: mpm135 ($474.45 in chips) 
Seat 5: TexasSooner2 ($81.55 in chips) 
mpm135: posts small blind $1
TexasSooner2: posts big blind $2
*** HOLE CARDS ***
mpolice2010: calls $2
rafa1985: calls $2
ILS16L: calls $2
mpm135: folds 
TexasSooner2: checks 
*** FLOP *** [Kh 4h Ac]
TexasSooner2: checks 
mpolice2010: checks 
rafa1985: checks 
ILS16L: bets $6
TexasSooner2: folds 
mpolice2010: calls $6
rafa1985: folds 
*** TURN *** [Kh 4h Ac] [8h]
mpolice2010: checks 
ILS16L: checks 
*** RIVER *** [Kh 4h Ac 8h] [7h]
mpolice2010: checks 
ILS16L: bets $12
mpolice2010: folds 
Uncalled bet ($12) returned to ILS16L
ILS16L collected $20 from pot
ILS16L: doesn't show hand 
*** SUMMARY ***
Total pot $21 | Rake $1 
Board [Kh 4h Ac 8h 7h]
Seat 1: mpolice2010 folded on the River
Seat 2: rafa1985 folded on the Flop
Seat 3: ILS16L (button) collected ($20)
Seat 4: mpm135 (small blind) folded before Flop
Seat 5: TexasSooner2 (big blind) folded on the Flop




PokerStars Game #47185717577:  Hold'em No Limit ($1/$2 USD) - 2010/07/23 23:54:21 ET
Table 'Luscinia' 6-max Seat #3 is the button
Seat 1: AillemKall ($35.30 in chips) 
Seat 2: JDVC ($68.95 in chips) 
Seat 3: rodrieliot ($42 in chips) 
Seat 4: ILS16L ($79.65 in chips) 
Seat 5: Clabby01 ($99.70 in chips) 
Seat 6: sebass911 ($97 in chips) 
ILS16L: posts small blind $1
Clabby01: posts big blind $2
*** HOLE CARDS ***
sebass911: folds 
AillemKall: folds 
JDVC: raises $4 to $6
rodrieliot: folds 
ILS16L: folds 
Clabby01: folds 
Uncalled bet ($4) returned to JDVC
JDVC collected $5 from pot
JDVC: doesn't show hand 
*** SUMMARY ***
Total pot $5 | Rake $0 
Seat 1: AillemKall folded before Flop (didn't bet)
Seat 2: JDVC collected ($5)
Seat 3: rodrieliot (button) folded before Flop (didn't bet)
Seat 4: ILS16L (small blind) folded before Flop
Seat 5: Clabby01 (big blind) folded before Flop
Seat 6: sebass911 folded before Flop (didn't bet)




PokerStars Game #47185665337:  Hold'em No Limit ($1/$2 USD) - 2010/07/23 23:52:22 ET
Table 'Rigilkent VIII' 6-max Seat #2 is the button
Seat 1: TODO ADENTR0 ($203 in chips) 
Seat 2: DURKADURDUR ($233.30 in chips) 
Seat 3: -MinhNa- ($164.80 in chips) 
Seat 4: jaeh00d ($200 in chips) 
Seat 5: FrAnWaN ($234.75 in chips) 
Seat 6: thomaswkm ($127.75 in chips) 
-MinhNa-: posts small blind $1
jaeh00d: posts big blind $2
*** HOLE CARDS ***
FrAnWaN: folds 
thomaswkm: raises $4 to $6
TODO ADENTR0: folds 
DURKADURDUR: folds 
-MinhNa-: calls $5
jaeh00d: raises $22 to $28
thomaswkm: raises $36 to $64
-MinhNa-: folds 
jaeh00d: raises $134 to $198
thomaswkm: calls $63.75 and is all-in
Uncalled bet ($70.25) returned to jaeh00d
*** FLOP *** [6c 5h 9h]
*** TURN *** [6c 5h 9h] [3h]
*** RIVER *** [6c 5h 9h 3h] [2d]
*** SHOW DOWN ***
jaeh00d: shows [As Ad] (a pair of Aces)
thomaswkm: shows [Ac Kh] (high card Ace)
jaeh00d collected $258.50 from pot
*** SUMMARY ***
Total pot $261.50 | Rake $3 
Board [6c 5h 9h 3h 2d]
Seat 1: TODO ADENTR0 folded before Flop (didn't bet)
Seat 2: DURKADURDUR (button) folded before Flop (didn't bet)
Seat 3: -MinhNa- (small blind) folded before Flop
Seat 4: jaeh00d (big blind) showed [As Ad] and won ($258.50) with a pair of Aces
Seat 5: FrAnWaN folded before Flop (didn't bet)
Seat 6: thomaswkm showed [Ac Kh] and lost with high card Ace




PokerStars Game #47185701688:  Hold'em No Limit ($1/$2 USD) - 2010/07/23 23:53:45 ET
Table 'Lonnrot III' 6-max Seat #1 is the button
Seat 1: THEDUTCH4141 ($200 in chips) 
Seat 2: Duke_Moto ($193.40 in chips) 
Seat 3: DURKADURDUR ($214.45 in chips) 
Seat 4: imthesky ($224.30 in chips) 
Seat 5: dajatt13 ($343 in chips) 
Seat 6: FrAnWaN ($291.75 in chips) 
Duke_Moto: posts small blind $1
DURKADURDUR: posts big blind $2
*** HOLE CARDS ***
imthesky: folds 
dajatt13: folds 
FrAnWaN: raises $4 to $6
THEDUTCH4141: folds 
Duke_Moto: calls $5
DURKADURDUR: folds 
*** FLOP *** [6d 7d 3h]
Duke_Moto: checks 
FrAnWaN: checks 
*** TURN *** [6d 7d 3h] [Jc]
Duke_Moto: bets $8
FrAnWaN: calls $8
*** RIVER *** [6d 7d 3h Jc] [6h]
Duke_Moto: bets $24
FrAnWaN: folds 
Uncalled bet ($24) returned to Duke_Moto
Duke_Moto collected $28.55 from pot
Duke_Moto: doesn't show hand 
*** SUMMARY ***
Total pot $30 | Rake $1.45 
Board [6d 7d 3h Jc 6h]
Seat 1: THEDUTCH4141 (button) folded before Flop (didn't bet)
Seat 2: Duke_Moto (small blind) collected ($28.55)
Seat 3: DURKADURDUR (big blind) folded before Flop
Seat 4: imthesky folded before Flop (didn't bet)
Seat 5: dajatt13 folded before Flop (didn't bet)
Seat 6: FrAnWaN folded on the River




PokerStars Game #47185709993:  Hold'em No Limit ($1/$2 USD) - 2010/07/23 23:54:04 ET
Table 'Selene' 6-max Seat #2 is the button
Seat 1: beargood ($106.35 in chips) 
Seat 2: Rocco35 ($53.05 in chips) 
Seat 3: Mamoo ($99.25 in chips) 
Seat 4: HUMBLED1 ($278 in chips) 
Seat 5: DMACM ($86.35 in chips) 
Seat 6: BlindFlying ($161 in chips) 
Mamoo: posts small blind $1
HUMBLED1: posts big blind $2
*** HOLE CARDS ***
DMACM: folds 
BlindFlying: folds 
beargood: folds 
Rocco35: folds 
Mamoo: raises $4 to $6
HUMBLED1: calls $4
*** FLOP *** [2h 7s 5d]
Mamoo: bets $8
HUMBLED1: raises $8 to $16
Mamoo: calls $8
*** TURN *** [2h 7s 5d] [8d]
Mamoo: checks 
HUMBLED1: bets $8
Mamoo: calls $8
*** RIVER *** [2h 7s 5d 8d] [Kc]
Mamoo: checks 
HUMBLED1: checks 
*** SHOW DOWN ***
Mamoo: shows [Ad 7h] (a pair of Sevens)
HUMBLED1: mucks hand 
Mamoo collected $57.15 from pot
*** SUMMARY ***
Total pot $60 | Rake $2.85 
Board [2h 7s 5d 8d Kc]
Seat 1: beargood folded before Flop (didn't bet)
Seat 2: Rocco35 (button) folded before Flop (didn't bet)
Seat 3: Mamoo (small blind) showed [Ad 7h] and won ($57.15) with a pair of Sevens
Seat 4: HUMBLED1 (big blind) mucked
Seat 5: DMACM folded before Flop (didn't bet)
Seat 6: BlindFlying folded before Flop (didn't bet)




PokerStars Game #47185713555:  Hold'em No Limit ($1/$2 USD) - 2010/07/23 23:54:12 ET
Table 'Regulus' 6-max Seat #6 is the button
Seat 1: FrAnWaN ($243.05 in chips) 
Seat 2: Fierytycoon ($202.95 in chips) 
Seat 3: TODO ADENTR0 ($384.95 in chips) 
Seat 4: thomaswkm ($268.40 in chips) 
Seat 5: DURKADURDUR ($426.40 in chips) 
Seat 6: Rush51 ($80.80 in chips) 
FrAnWaN: posts small blind $1
Fierytycoon: posts big blind $2
*** HOLE CARDS ***
TODO ADENTR0: folds 
thomaswkm: folds 
DURKADURDUR: folds 
Rush51: calls $2
FrAnWaN: folds 
Fierytycoon: checks 
*** FLOP *** [2h 8d 5s]
Fierytycoon: checks 
Rush51: checks 
*** TURN *** [2h 8d 5s] [Ts]
Fierytycoon: checks 
Rush51: checks 
*** RIVER *** [2h 8d 5s Ts] [Jc]
Fierytycoon: checks 
Rush51: checks 
*** SHOW DOWN ***
Fierytycoon: shows [7d Ad] (high card Ace)
Rush51: mucks hand 
Fierytycoon collected $4.75 from pot
*** SUMMARY ***
Total pot $5 | Rake $0.25 
Board [2h 8d 5s Ts Jc]
Seat 1: FrAnWaN (small blind) folded before Flop
Seat 2: Fierytycoon (big blind) showed [7d Ad] and won ($4.75) with high card Ace
Seat 3: TODO ADENTR0 folded before Flop (didn't bet)
Seat 4: thomaswkm folded before Flop (didn't bet)
Seat 5: DURKADURDUR folded before Flop (didn't bet)
Seat 6: Rush51 (button) mucked




PokerStars Game #47185747933:  Hold'em No Limit ($1/$2 USD) - 2010/07/23 23:55:37 ET
Table 'Vitja' 6-max Seat #4 is the button
Seat 1: WizardOfAhhs ($76.85 in chips) 
Seat 2: Don brujo ($34.90 in chips) 
Seat 3: rodrieliot ($39 in chips) 
Seat 4: emilpetten ($35.25 in chips) 
Seat 5: EKkL ($51.80 in chips) 
Seat 6: LeoFara ($40 in chips) 
EKkL: posts small blind $1
LeoFara: posts big blind $2
*** HOLE CARDS ***
WizardOfAhhs: folds 
Don brujo: folds 
rodrieliot: folds 
emilpetten: folds 
EKkL: calls $1
LeoFara: checks 
*** FLOP *** [9d 8c Qc]
EKkL: checks 
LeoFara: checks 
*** TURN *** [9d 8c Qc] [7c]
EKkL: checks 
LeoFara: checks 
*** RIVER *** [9d 8c Qc 7c] [5c]
EKkL: checks 
LeoFara: checks 
*** SHOW DOWN ***
EKkL: shows [Js 9h] (a pair of Nines)
LeoFara: shows [7d 3c] (a flush, Queen high)
LeoFara collected $3.80 from pot
*** SUMMARY ***
Total pot $4 | Rake $0.20 
Board [9d 8c Qc 7c 5c]
Seat 1: WizardOfAhhs folded before Flop (didn't bet)
Seat 2: Don brujo folded before Flop (didn't bet)
Seat 3: rodrieliot folded before Flop (didn't bet)
Seat 4: emilpetten (button) folded before Flop (didn't bet)
Seat 5: EKkL (small blind) showed [Js 9h] and lost with a pair of Nines
Seat 6: LeoFara (big blind) showed [7d 3c] and won ($3.80) with a flush, Queen high




PokerStars Game #47185738078:  Hold'em No Limit ($1/$2 USD) - 2010/07/23 23:55:08 ET
Table 'Pavo' 6-max Seat #5 is the button
Seat 1: dajatt13 ($208.65 in chips) 
Seat 2: FrAnWaN ($394.90 in chips) 
Seat 4: thomaswkm ($201.25 in chips) 
Seat 5: THEDUTCH4141 ($200 in chips) 
Seat 6: TheAwfulDin ($232.50 in chips) 
TheAwfulDin: posts small blind $1
dajatt13: posts big blind $2
FastEddie267: sits out 
*** HOLE CARDS ***
FrAnWaN: folds 
thomaswkm: raises $4 to $6
THEDUTCH4141: calls $6
TheAwfulDin: folds 
dajatt13: folds 
*** FLOP *** [Kc 3d 6h]
thomaswkm: checks 
THEDUTCH4141: checks 
*** TURN *** [Kc 3d 6h] [8s]
thomaswkm: checks 
THEDUTCH4141: checks 
*** RIVER *** [Kc 3d 6h 8s] [Qd]
thomaswkm: checks 
THEDUTCH4141: checks 
*** SHOW DOWN ***
thomaswkm: shows [Td Ah] (high card Ace)
THEDUTCH4141: shows [5c 5d] (a pair of Fives)
THEDUTCH4141 collected $14.25 from pot
*** SUMMARY ***
Total pot $15 | Rake $0.75 
Board [Kc 3d 6h 8s Qd]
Seat 1: dajatt13 (big blind) folded before Flop
Seat 2: FrAnWaN folded before Flop (didn't bet)
Seat 4: thomaswkm showed [Td Ah] and lost with high card Ace
Seat 5: THEDUTCH4141 (button) showed [5c 5d] and won ($14.25) with a pair of Fives
Seat 6: TheAwfulDin (small blind) folded before Flop




PokerStars Game #47185664869:  Hold'em No Limit ($1/$2 USD) - 2010/07/23 23:52:21 ET
Table 'Pala II' 6-max Seat #2 is the button
Seat 1: Fierytycoon ($200 in chips) 
Seat 2: thomaswkm ($111.95 in chips) 
Seat 3: TheAwfulDin ($266.95 in chips) 
Seat 4: serj14 ($313.70 in chips) 
Seat 5: asseral ($200 in chips) 
TheAwfulDin: posts small blind $1
serj14: posts big blind $2
*** HOLE CARDS ***
asseral: folds 
Fierytycoon: raises $2 to $4
thomaswkm has timed out
thomaswkm: folds 
TheAwfulDin: folds 
serj14: calls $2
*** FLOP *** [Jh Kc Kh]
serj14: checks 
Fierytycoon: checks 
*** TURN *** [Jh Kc Kh] [Qh]
serj14: checks 
Fierytycoon: checks 
*** RIVER *** [Jh Kc Kh Qh] [7s]
serj14: checks 
Fierytycoon: checks 
*** SHOW DOWN ***
serj14: shows [5s 8s] (a pair of Kings)
Fierytycoon: shows [Ad 9d] (a pair of Kings - Ace kicker)
Fierytycoon collected $8.55 from pot
*** SUMMARY ***
Total pot $9 | Rake $0.45 
Board [Jh Kc Kh Qh 7s]
Seat 1: Fierytycoon showed [Ad 9d] and won ($8.55) with a pair of Kings
Seat 2: thomaswkm (button) folded before Flop (didn't bet)
Seat 3: TheAwfulDin (small blind) folded before Flop
Seat 4: serj14 (big blind) showed [5s 8s] and lost with a pair of Kings
Seat 5: asseral folded before Flop (didn't bet)




PokerStars Game #47185698255:  Hold'em No Limit ($1/$2 USD) - 2010/07/23 23:53:37 ET
Table 'Laodica' 6-max Seat #4 is the button
Seat 1: WizardOfAhhs ($81.50 in chips) 
Seat 2: LeoFara ($50.85 in chips) 
Seat 3: jimjam1979 ($41 in chips) 
Seat 4: BlindFlying ($99 in chips) 
Seat 5: rodrieliot ($58.60 in chips) 
Seat 6: JuStBLaZe908 ($226.85 in chips) 
rodrieliot: posts small blind $1
JuStBLaZe908: posts big blind $2
*** HOLE CARDS ***
WizardOfAhhs: folds 
LeoFara: folds 
jimjam1979: folds 
BlindFlying: raises $2 to $4
rodrieliot: folds 
JuStBLaZe908: calls $2
*** FLOP *** [8c Ah Js]
JuStBLaZe908: checks 
BlindFlying: bets $4
JuStBLaZe908: calls $4
*** TURN *** [8c Ah Js] [Qd]
JuStBLaZe908: checks 
BlindFlying: bets $8
JuStBLaZe908: folds 
Uncalled bet ($8) returned to BlindFlying
BlindFlying collected $16.20 from pot
BlindFlying: doesn't show hand 
*** SUMMARY ***
Total pot $17 | Rake $0.80 
Board [8c Ah Js Qd]
Seat 1: WizardOfAhhs folded before Flop (didn't bet)
Seat 2: LeoFara folded before Flop (didn't bet)
Seat 3: jimjam1979 folded before Flop (didn't bet)
Seat 4: BlindFlying (button) collected ($16.20)
Seat 5: rodrieliot (small blind) folded before Flop
Seat 6: JuStBLaZe908 (big blind) folded on the Turn




PokerStars Game #47185715312:  Hold'em No Limit ($1/$2 USD) - 2010/07/23 23:54:16 ET
Table 'Natalie' 6-max Seat #6 is the button
Seat 1: DURKADURDUR ($421.65 in chips) 
Seat 3: THEDUTCH4141 ($203 in chips) 
Seat 6: leukehond ($219.90 in chips) 
DURKADURDUR: posts small blind $1
TODO ADENTR0: is sitting out 
THEDUTCH4141: posts big blind $2
FastEddie267: sits out 
*** HOLE CARDS ***
TODO ADENTR0 leaves the table
leukehond: raises $3 to $5
DURKADURDUR: folds 
THEDUTCH4141: folds 
Uncalled bet ($3) returned to leukehond
leukehond collected $5 from pot
leukehond: doesn't show hand 
*** SUMMARY ***
Total pot $5 | Rake $0 
Seat 1: DURKADURDUR (small blind) folded before Flop
Seat 3: THEDUTCH4141 (big blind) folded before Flop
Seat 6: leukehond (button) collected ($5)




PokerStars Game #47185679904:  Hold'em No Limit ($1/$2 USD) - 2010/07/23 23:52:56 ET
Table 'Maia III' 6-max Seat #5 is the button
Seat 1: thomaswkm ($195.35 in chips) 
Seat 2: FrAnWaN ($371.65 in chips) 
Seat 3: dertaylor ($208.25 in chips) 
Seat 4: TODO ADENTR0 ($218 in chips) 
Seat 5: DURKADURDUR ($204.20 in chips) 
Seat 6: hellokittery ($220.40 in chips) 
hellokittery: posts small blind $1
thomaswkm: posts big blind $2
*** HOLE CARDS ***
FrAnWaN: folds 
dertaylor: folds 
TODO ADENTR0: raises $4 to $6
DURKADURDUR: folds 
hellokittery: folds 
thomaswkm: folds 
Uncalled bet ($4) returned to TODO ADENTR0
TODO ADENTR0 collected $5 from pot
TODO ADENTR0: doesn't show hand 
*** SUMMARY ***
Total pot $5 | Rake $0 
Seat 1: thomaswkm (big blind) folded before Flop
Seat 2: FrAnWaN folded before Flop (didn't bet)
Seat 3: dertaylor folded before Flop (didn't bet)
Seat 4: TODO ADENTR0 collected ($5)
Seat 5: DURKADURDUR (button) folded before Flop (didn't bet)
Seat 6: hellokittery (small blind) folded before Flop




PokerStars Game #47185684400:  Hold'em No Limit ($1/$2 USD) - 2010/07/23 23:53:06 ET
Table 'Menelaus II' 6-max Seat #6 is the button
Seat 1: LeoFara ($38 in chips) 
Seat 2: Berg58 ($100 in chips) 
Seat 3: topstich ($34.85 in chips) 
Seat 4: mzosh ($193.30 in chips) 
Seat 5: tdiddy ($163.25 in chips) 
Seat 6: sp4taxes ($68.85 in chips) 
LeoFara: posts small blind $1
Berg58: posts big blind $2
*** HOLE CARDS ***
topstich: folds 
mzosh: folds 
tdiddy: folds 
sp4taxes: calls $2
LeoFara: raises $6 to $8
Berg58: folds 
sp4taxes: calls $6
*** FLOP *** [Th Ad 6h]
LeoFara: bets $14
sp4taxes: folds 
Uncalled bet ($14) returned to LeoFara
LeoFara collected $17.10 from pot
*** SUMMARY ***
Total pot $18 | Rake $0.90 
Board [Th Ad 6h]
Seat 1: LeoFara (small blind) collected ($17.10)
Seat 2: Berg58 (big blind) folded before Flop
Seat 3: topstich folded before Flop (didn't bet)
Seat 4: mzosh folded before Flop (didn't bet)
Seat 5: tdiddy folded before Flop (didn't bet)
Seat 6: sp4taxes (button) folded on the Flop




PokerStars Game #47185681674:  Hold'em No Limit ($1/$2 USD) - 2010/07/23 23:53:00 ET
Table 'Orthosie II' 6-max Seat #5 is the button
Seat 1: neni85 ($504.45 in chips) 
Seat 3: WizardOfAhhs ($36 in chips) 
Seat 4: spiderfrank ($46.35 in chips) 
Seat 5: LeoFara ($41.40 in chips) 
Seat 6: onitsuaf ($72.25 in chips) 
onitsuaf: posts small blind $1
neni85: posts big blind $2
harujongil: sits out 
*** HOLE CARDS ***
WizardOfAhhs: folds 
spiderfrank: folds 
LeoFara: folds 
onitsuaf: calls $1
neni85: checks 
*** FLOP *** [9c Js Jh]
onitsuaf: checks 
neni85: checks 
*** TURN *** [9c Js Jh] [8d]
onitsuaf: bets $4
neni85: folds 
Uncalled bet ($4) returned to onitsuaf
onitsuaf collected $3.80 from pot
*** SUMMARY ***
Total pot $4 | Rake $0.20 
Board [9c Js Jh 8d]
Seat 1: neni85 (big blind) folded on the Turn
Seat 3: WizardOfAhhs folded before Flop (didn't bet)
Seat 4: spiderfrank folded before Flop (didn't bet)
Seat 5: LeoFara (button) folded before Flop (didn't bet)
Seat 6: onitsuaf (small blind) collected ($3.80)



PokerStars Game #47185681869:  Hold'em No Limit ($1/$2 USD) - 2010/07/23 23:53:00 ET
Table 'Rafita IV' 6-max Seat #4 is the button
Seat 1: neni85 ($157.10 in chips) 
Seat 2: NewEra760 ($67.85 in chips) 
Seat 3: AillemKall ($57.90 in chips) 
Seat 4: WizardOfAhhs ($109.35 in chips) 
Seat 5: jimjam1979 ($44.15 in chips) 
Seat 6: Ricko7456 ($154 in chips) 
jimjam1979: posts small blind $1
Ricko7456: posts big blind $2
*** HOLE CARDS ***
neni85: folds 
NewEra760: folds 
AillemKall: folds 
WizardOfAhhs: raises $2.10 to $4.10
jimjam1979: folds 
Ricko7456: folds 
Uncalled bet ($2.10) returned to WizardOfAhhs
WizardOfAhhs collected $5 from pot
WizardOfAhhs: doesn't show hand 
*** SUMMARY ***
Total pot $5 | Rake $0 
Seat 1: neni85 folded before Flop (didn't bet)
Seat 2: NewEra760 folded before Flop (didn't bet)
Seat 3: AillemKall folded before Flop (didn't bet)
Seat 4: WizardOfAhhs (button) collected ($5)
Seat 5: jimjam1979 (small blind) folded before Flop
Seat 6: Ricko7456 (big blind) folded before Flop




PokerStars Game #47185757899:  Hold'em No Limit ($1/$2 USD) - 2010/07/23 23:56:08 ET
Table 'Menelaus II' 6-max Seat #5 is the button
Seat 1: LeoFara ($60.60 in chips) 
Seat 4: mzosh ($224.15 in chips) 
Seat 5: tdiddy ($160.25 in chips) 
Seat 6: sp4taxes ($64.60 in chips) 
sp4taxes: posts small blind $1
LeoFara: posts big blind $2
*** HOLE CARDS ***
mzosh: folds 
tdiddy: folds 
sp4taxes: calls $1
LeoFara: raises $6 to $8
sp4taxes: folds 
Uncalled bet ($6) returned to LeoFara
topstich leaves the table
LeoFara collected $4 from pot
*** SUMMARY ***
Total pot $4 | Rake $0 
Seat 1: LeoFara (big blind) collected ($4)
Seat 4: mzosh folded before Flop (didn't bet)
Seat 5: tdiddy (button) folded before Flop (didn't bet)
Seat 6: sp4taxes (small blind) folded before Flop




PokerStars Game #47185669548:  Hold'em No Limit ($1/$2 USD) - 2010/07/23 23:52:32 ET
Table 'Sibylla II' 6-max Seat #5 is the button
Seat 1: LeoFara ($54.35 in chips) 
Seat 2: AironVega ($28.80 in chips) 
Seat 3: jimjam1979 ($39.85 in chips) 
Seat 4: sp4taxes ($57.85 in chips) 
Seat 5: BlindFlying ($206.30 in chips) 
Seat 6: tradan ($54.15 in chips) 
tradan: posts small blind $1
LeoFara: posts big blind $2
*** HOLE CARDS ***
AironVega: raises $2.10 to $4.10
jimjam1979: folds 
sp4taxes: calls $4.10
BlindFlying: folds 
tradan: calls $3.10
LeoFara: folds 
*** FLOP *** [3s Ks 7h]
tradan: checks 
AironVega: checks 
sp4taxes: bets $8
tradan: folds 
AironVega: folds 
Uncalled bet ($8) returned to sp4taxes
sp4taxes collected $13.60 from pot
sp4taxes: doesn't show hand 
*** SUMMARY ***
Total pot $14.30 | Rake $0.70 
Board [3s Ks 7h]
Seat 1: LeoFara (big blind) folded before Flop
Seat 2: AironVega folded on the Flop
Seat 3: jimjam1979 folded before Flop (didn't bet)
Seat 4: sp4taxes collected ($13.60)
Seat 5: BlindFlying (button) folded before Flop (didn't bet)
Seat 6: tradan (small blind) folded on the Flop




PokerStars Game #47185712979:  Hold'em No Limit ($1/$2 USD) - 2010/07/23 23:54:11 ET
Table 'Phoenix V' 6-max Seat #4 is the button
Seat 1: MJJ & ADT ($36 in chips) 
Seat 2: tdiddy ($144.05 in chips) 
Seat 3: pike2229 ($188.80 in chips) 
Seat 4: jimjam1979 ($40 in chips) 
Seat 6: neni85 ($449.50 in chips) 
neni85: posts small blind $1
MJJ & ADT: posts big blind $2
*** HOLE CARDS ***
tdiddy: folds 
pike2229: folds 
jimjam1979: raises $2 to $4
neni85: folds 
MJJ & ADT: folds 
Uncalled bet ($2) returned to jimjam1979
jimjam1979 collected $5 from pot
jimjam1979: doesn't show hand 
*** SUMMARY ***
Total pot $5 | Rake $0 
Seat 1: MJJ & ADT (big blind) folded before Flop
Seat 2: tdiddy folded before Flop (didn't bet)
Seat 3: pike2229 folded before Flop (didn't bet)
Seat 4: jimjam1979 (button) collected ($5)
Seat 6: neni85 (small blind) folded before Flop




PokerStars Game #47185702965:  Hold'em No Limit ($1/$2 USD) - 2010/07/23 23:53:48 ET
Table 'Margo II' 6-max Seat #4 is the button
Seat 1: wheels6990 ($43 in chips) 
Seat 2: AillemKall ($34 in chips) 
Seat 3: crock41 ($56.10 in chips) 
Seat 4: WizardOfAhhs ($81.35 in chips) 
Seat 5: AironVega ($46.60 in chips) 
Seat 6: JLS1956 ($52.65 in chips) 
AironVega: posts small blind $1
JLS1956: posts big blind $2
*** HOLE CARDS ***
wheels6990: folds 
AillemKall: folds 
crock41: calls $2
WizardOfAhhs: folds 
AironVega: folds 
JLS1956: checks 
*** FLOP *** [Js Th 6d]
JLS1956: checks 
crock41: bets $4
JLS1956: calls $4
*** TURN *** [Js Th 6d] [Kh]
JLS1956: checks 
crock41: bets $8
JLS1956: calls $8
*** RIVER *** [Js Th 6d Kh] [8h]
JLS1956: checks 
crock41: bets $10
JLS1956: calls $10
*** SHOW DOWN ***
crock41: shows [Ad Ah] (a pair of Aces)
JLS1956: shows [Td Ts] (three of a kind, Tens)
JLS1956 collected $46.65 from pot
*** SUMMARY ***
Total pot $49 | Rake $2.35 
Board [Js Th 6d Kh 8h]
Seat 1: wheels6990 folded before Flop (didn't bet)
Seat 2: AillemKall folded before Flop (didn't bet)
Seat 3: crock41 showed [Ad Ah] and lost with a pair of Aces
Seat 4: WizardOfAhhs (button) folded before Flop (didn't bet)
Seat 5: AironVega (small blind) folded before Flop
Seat 6: JLS1956 (big blind) showed [Td Ts] and won ($46.65) with three of a kind, Tens




PokerStars Game #47185719516:  Hold'em No Limit ($1/$2 USD) - 2010/07/23 23:54:25 ET
Table 'Neckar VII' 6-max Seat #3 is the button
Seat 1: Marker275 ($196.10 in chips) 
Seat 2: DURKADURDUR ($281.10 in chips) 
Seat 3: dmyj ($200 in chips) 
Seat 4: THEDUTCH4141 ($212.55 in chips) 
Seat 5: imthesky ($214.65 in chips) 
THEDUTCH4141: posts small blind $1
imthesky: posts big blind $2
botano: sits out 
*** HOLE CARDS ***
Marker275: folds 
DURKADURDUR: raises $4 to $6
dmyj: folds 
THEDUTCH4141: folds 
imthesky: folds 
Uncalled bet ($4) returned to DURKADURDUR
DURKADURDUR collected $5 from pot
DURKADURDUR: doesn't show hand 
*** SUMMARY ***
Total pot $5 | Rake $0 
Seat 1: Marker275 folded before Flop (didn't bet)
Seat 2: DURKADURDUR collected ($5)
Seat 3: dmyj (button) folded before Flop (didn't bet)
Seat 4: THEDUTCH4141 (small blind) folded before Flop
Seat 5: imthesky (big blind) folded before Flop




PokerStars Game #47185742594:  Hold'em No Limit ($1/$2 USD) - 2010/07/23 23:55:22 ET
Table 'Menelaus II' 6-max Seat #3 is the button
Seat 1: LeoFara ($65 in chips) 
Seat 2: Berg58 ($83.95 in chips) 
Seat 3: topstich ($28.45 in chips) 
Seat 4: mzosh ($191.30 in chips) 
Seat 5: tdiddy ($163.25 in chips) 
Seat 6: sp4taxes ($63.60 in chips) 
mzosh: posts small blind $1
tdiddy: posts big blind $2
*** HOLE CARDS ***
sp4taxes: raises $4 to $6
LeoFara: folds 
Berg58: folds 
Berg58 leaves the table
topstich: folds 
mzosh: folds 
tdiddy: folds 
Uncalled bet ($4) returned to sp4taxes
sp4taxes collected $5 from pot
sp4taxes: doesn't show hand 
*** SUMMARY ***
Total pot $5 | Rake $0 
Seat 1: LeoFara folded before Flop (didn't bet)
Seat 2: Berg58 folded before Flop (didn't bet)
Seat 3: topstich (button) folded before Flop (didn't bet)
Seat 4: mzosh (small blind) folded before Flop
Seat 5: tdiddy (big blind) folded before Flop
Seat 6: sp4taxes collected ($5)




PokerStars Game #47185750573:  Hold'em No Limit ($1/$2 USD) - 2010/07/23 23:55:46 ET
Table 'Rafita IV' 6-max Seat #2 is the button
Seat 1: neni85 ($157.10 in chips) 
Seat 2: NewEra760 ($65.75 in chips) 
Seat 3: AillemKall ($51.80 in chips) 
Seat 5: jimjam1979 ($43.15 in chips) 
Seat 6: Ricko7456 ($159.55 in chips) 
AillemKall: posts small blind $1
WizardOfAhhs: is sitting out 
jimjam1979: posts big blind $2
*** HOLE CARDS ***
WizardOfAhhs leaves the table
Ricko7456: folds 
neni85: folds 
NewEra760: raises $3 to $5
AillemKall: folds 
jimjam1979: folds 
Uncalled bet ($3) returned to NewEra760
NewEra760 collected $5 from pot
NewEra760: doesn't show hand 
*** SUMMARY ***
Total pot $5 | Rake $0 
Seat 1: neni85 folded before Flop (didn't bet)
Seat 2: NewEra760 (button) collected ($5)
Seat 3: AillemKall (small blind) folded before Flop
Seat 5: jimjam1979 (big blind) folded before Flop
Seat 6: Ricko7456 folded before Flop (didn't bet)




PokerStars Game #47185703640:  Hold'em No Limit ($1/$2 USD) - 2010/07/23 23:53:49 ET
Table 'Luscinia' 6-max Seat #1 is the button
Seat 1: AillemKall ($35.30 in chips) 
Seat 2: JDVC ($69.95 in chips) 
Seat 3: rodrieliot ($42 in chips) 
Seat 4: ILS16L ($78.65 in chips) 
Seat 5: Clabby01 ($99.70 in chips) 
Seat 6: sebass911 ($97 in chips) 
JDVC: posts small blind $1
rodrieliot: posts big blind $2
*** HOLE CARDS ***
ILS16L: folds 
Clabby01: folds 
sebass911: folds 
AillemKall: folds 
JDVC: folds 
Uncalled bet ($1) returned to rodrieliot
rodrieliot collected $2 from pot
*** SUMMARY ***
Total pot $2 | Rake $0 
Seat 1: AillemKall (button) folded before Flop (didn't bet)
Seat 2: JDVC (small blind) folded before Flop
Seat 3: rodrieliot (big blind) collected ($2)
Seat 4: ILS16L folded before Flop (didn't bet)
Seat 5: Clabby01 folded before Flop (didn't bet)
Seat 6: sebass911 folded before Flop (didn't bet)




PokerStars Game #47185694214:  Hold'em No Limit ($1/$2 USD) - 2010/07/23 23:53:28 ET
Table 'Luscinia' 6-max Seat #6 is the button
Seat 1: AillemKall ($36.30 in chips) 
Seat 2: JDVC ($71.95 in chips) 
Seat 3: rodrieliot ($42 in chips) 
Seat 4: ILS16L ($78.65 in chips) 
Seat 5: Clabby01 ($96.70 in chips) 
Seat 6: sebass911 ($97 in chips) 
AillemKall: posts small blind $1
JDVC: posts big blind $2
*** HOLE CARDS ***
rodrieliot: folds 
ILS16L: folds 
Clabby01: raises $4 to $6
sebass911: folds 
AillemKall: folds 
JDVC: folds 
Uncalled bet ($4) returned to Clabby01
Clabby01 collected $5 from pot
*** SUMMARY ***
Total pot $5 | Rake $0 
Seat 1: AillemKall (small blind) folded before Flop
Seat 2: JDVC (big blind) folded before Flop
Seat 3: rodrieliot folded before Flop (didn't bet)
Seat 4: ILS16L folded before Flop (didn't bet)
Seat 5: Clabby01 collected ($5)
Seat 6: sebass911 (button) folded before Flop (didn't bet)




PokerStars Game #47185726292:  Hold'em No Limit ($1/$2 USD) - 2010/07/23 23:54:40 ET
Table 'Pavo' 6-max Seat #4 is the button
Seat 1: dajatt13 ($208.65 in chips) 
Seat 2: FrAnWaN ($394.90 in chips) 
Seat 4: thomaswkm ($198.25 in chips) 
Seat 5: THEDUTCH4141 ($200 in chips) 
Seat 6: TheAwfulDin ($234.50 in chips) 
THEDUTCH4141: posts small blind $1
TheAwfulDin: posts big blind $2
FastEddie267: sits out 
*** HOLE CARDS ***
dajatt13: folds 
FrAnWaN: folds 
thomaswkm: raises $4 to $6
THEDUTCH4141: folds 
TheAwfulDin: folds 
Uncalled bet ($4) returned to thomaswkm
thomaswkm collected $5 from pot
thomaswkm: doesn't show hand 
*** SUMMARY ***
Total pot $5 | Rake $0 
Seat 1: dajatt13 folded before Flop (didn't bet)
Seat 2: FrAnWaN folded before Flop (didn't bet)
Seat 4: thomaswkm (button) collected ($5)
Seat 5: THEDUTCH4141 (small blind) folded before Flop
Seat 6: TheAwfulDin (big blind) folded before Flop




PokerStars Game #47185740833:  Hold'em No Limit ($1/$2 USD) - 2010/07/23 23:55:16 ET
Table 'Phoenix V' 6-max Seat #2 is the button
Seat 1: MJJ & ADT ($33 in chips) 
Seat 2: tdiddy ($144.05 in chips) 
Seat 3: pike2229 ($194.25 in chips) 
Seat 4: jimjam1979 ($43 in chips) 
Seat 6: neni85 ($443.50 in chips) 
pike2229: posts small blind $1
jimjam1979: posts big blind $2
*** HOLE CARDS ***
neni85: raises $3 to $5
MJJ & ADT: folds 
tdiddy: folds 
pike2229: calls $4
jimjam1979: folds 
*** FLOP *** [9s Ks Tc]
pike2229: checks 
neni85: bets $10
pike2229: folds 
Uncalled bet ($10) returned to neni85
neni85 collected $11.40 from pot
neni85: doesn't show hand 
*** SUMMARY ***
Total pot $12 | Rake $0.60 
Board [9s Ks Tc]
Seat 1: MJJ & ADT folded before Flop (didn't bet)
Seat 2: tdiddy (button) folded before Flop (didn't bet)
Seat 3: pike2229 (small blind) folded on the Flop
Seat 4: jimjam1979 (big blind) folded before Flop
Seat 6: neni85 collected ($11.40)




PokerStars Game #47185727616:  Hold'em No Limit ($1/$2 USD) - 2010/07/23 23:54:43 ET
Table 'Selene' 6-max Seat #3 is the button
Seat 1: beargood ($106.35 in chips) 
Seat 2: Rocco35 ($53.05 in chips) 
Seat 3: Mamoo ($126.40 in chips) 
Seat 4: HUMBLED1 ($248 in chips) 
Seat 5: DMACM ($86.35 in chips) 
Seat 6: BlindFlying ($161 in chips) 
HUMBLED1: posts small blind $1
DMACM: posts big blind $2
*** HOLE CARDS ***
BlindFlying: folds 
beargood: folds 
Rocco35: folds 
Mamoo: folds 
HUMBLED1: folds 
Uncalled bet ($1) returned to DMACM
DMACM collected $2 from pot
*** SUMMARY ***
Total pot $2 | Rake $0 
Seat 1: beargood folded before Flop (didn't bet)
Seat 2: Rocco35 folded before Flop (didn't bet)
Seat 3: Mamoo (button) folded before Flop (didn't bet)
Seat 4: HUMBLED1 (small blind) folded before Flop
Seat 5: DMACM (big blind) collected ($2)
Seat 6: BlindFlying folded before Flop (didn't bet)




PokerStars Game #47185716952:  Hold'em No Limit ($1/$2 USD) - 2010/07/23 23:54:19 ET
Table 'Wilhelmina' 6-max Seat #5 is the button
Seat 1: jaeh00d ($200 in chips) 
Seat 2: DMACM ($91 in chips) 
Seat 4: richard175 ($70.35 in chips) 
Seat 5: TODO ADENTR0 ($292.30 in chips) 
Seat 6: hellokittery ($217.95 in chips) 
hellokittery: posts small blind $1
jaeh00d: posts big blind $2
THEDUTCH4141: sits out 
*** HOLE CARDS ***
DMACM: folds 
richard175: folds 
TODO ADENTR0: raises $3 to $5
hellokittery: folds 
jaeh00d: folds 
Uncalled bet ($3) returned to TODO ADENTR0
TODO ADENTR0 collected $5 from pot
TODO ADENTR0: doesn't show hand 
*** SUMMARY ***
Total pot $5 | Rake $0 
Seat 1: jaeh00d (big blind) folded before Flop
Seat 2: DMACM folded before Flop (didn't bet)
Seat 4: richard175 folded before Flop (didn't bet)
Seat 5: TODO ADENTR0 (button) collected ($5)
Seat 6: hellokittery (small blind) folded before Flop




PokerStars Game #47185755693:  Hold'em No Limit ($1/$2 USD) - 2010/07/23 23:56:01 ET
Table 'Strenua' 6-max Seat #5 is the button
Seat 1: neni85 ($207.60 in chips) 
Seat 3: jenny12346 ($128.45 in chips) 
Seat 4: tdiddy ($109.15 in chips) 
Seat 5: AillemKall ($51 in chips) 
Seat 6: C6Z06 2GO ($125.65 in chips) 
C6Z06 2GO: posts small blind $1
neni85: posts big blind $2
AironVega: sits out 
*** HOLE CARDS ***
jenny12346: folds 
tdiddy: folds 
AillemKall: folds 
C6Z06 2GO: calls $1
neni85: raises $6 to $8
C6Z06 2GO: folds 
Uncalled bet ($6) returned to neni85
neni85 collected $4 from pot
neni85: doesn't show hand 
*** SUMMARY ***
Total pot $4 | Rake $0 
Seat 1: neni85 (big blind) collected ($4)
Seat 3: jenny12346 folded before Flop (didn't bet)
Seat 4: tdiddy folded before Flop (didn't bet)
Seat 5: AillemKall (button) folded before Flop (didn't bet)
Seat 6: C6Z06 2GO (small blind) folded before Flop




PokerStars Game #47185712786:  Hold'em No Limit ($1/$2 USD) - 2010/07/23 23:54:10 ET
Table 'Laocoon III' 6-max Seat #4 is the button
Seat 1: 1tormentor ($292.20 in chips) 
Seat 2: angryjamman ($191.85 in chips) 
Seat 3: TODO ADENTR0 ($212.90 in chips) 
Seat 4: Fierytycoon ($200 in chips) 
Seat 5: DURKADURDUR ($200 in chips) 
Seat 6: FrAnWaN ($315.70 in chips) 
DURKADURDUR: posts small blind $1
FrAnWaN: posts big blind $2
*** HOLE CARDS ***
1tormentor: folds 
angryjamman: folds 
TODO ADENTR0: folds 
Fierytycoon: folds 
DURKADURDUR: folds 
Uncalled bet ($1) returned to FrAnWaN
FrAnWaN collected $2 from pot
FrAnWaN: doesn't show hand 
*** SUMMARY ***
Total pot $2 | Rake $0 
Seat 1: 1tormentor folded before Flop (didn't bet)
Seat 2: angryjamman folded before Flop (didn't bet)
Seat 3: TODO ADENTR0 folded before Flop (didn't bet)
Seat 4: Fierytycoon (button) folded before Flop (didn't bet)
Seat 5: DURKADURDUR (small blind) folded before Flop
Seat 6: FrAnWaN (big blind) collected ($2)




PokerStars Game #47185701386:  Hold'em No Limit ($1/$2 USD) - 2010/07/23 23:53:44 ET
Table 'Neckar VII' 6-max Seat #2 is the button
Seat 1: Marker275 ($204.10 in chips) 
Seat 2: DURKADURDUR ($281.10 in chips) 
Seat 3: dmyj ($200 in chips) 
Seat 4: THEDUTCH4141 ($214.55 in chips) 
Seat 5: imthesky ($204.60 in chips) 
dmyj: posts small blind $1
THEDUTCH4141: posts big blind $2
botano: sits out 
*** HOLE CARDS ***
imthesky: raises $6 to $8
Marker275: calls $8
DURKADURDUR has timed out
DURKADURDUR: folds 
dmyj: folds 
THEDUTCH4141: folds 
*** FLOP *** [Ks Jd 5d]
imthesky: bets $18
Marker275: folds 
Uncalled bet ($18) returned to imthesky
imthesky collected $18.05 from pot
imthesky: doesn't show hand 
*** SUMMARY ***
Total pot $19 | Rake $0.95 
Board [Ks Jd 5d]
Seat 1: Marker275 folded on the Flop
Seat 2: DURKADURDUR (button) folded before Flop (didn't bet)
Seat 3: dmyj (small blind) folded before Flop
Seat 4: THEDUTCH4141 (big blind) folded before Flop
Seat 5: imthesky collected ($18.05)




PokerStars Game #47185698000:  Hold'em No Limit ($1/$2 USD) - 2010/07/23 23:53:36 ET
Table 'Natalie' 6-max Seat #2 is the button
Seat 1: DURKADURDUR ($423.65 in chips) 
Seat 2: TODO ADENTR0 ($206.65 in chips) 
Seat 3: THEDUTCH4141 ($200 in chips) 
Seat 6: leukehond ($219.90 in chips) 
THEDUTCH4141: posts small blind $1
leukehond: posts big blind $2
*** HOLE CARDS ***
DURKADURDUR: folds 
TODO ADENTR0: folds 
THEDUTCH4141: folds 
Uncalled bet ($1) returned to leukehond
leukehond collected $2 from pot
leukehond: doesn't show hand 
*** SUMMARY ***
Total pot $2 | Rake $0 
Seat 1: DURKADURDUR folded before Flop (didn't bet)
Seat 2: TODO ADENTR0 (button) folded before Flop (didn't bet)
Seat 3: THEDUTCH4141 (small blind) folded before Flop
Seat 6: leukehond (big blind) collected ($2)




PokerStars Game #47185733886:  Hold'em No Limit ($1/$2 USD) - 2010/07/23 23:54:58 ET
Table 'Katanga II' 6-max Seat #5 is the button
Seat 1: beargood ($143.70 in chips) 
Seat 2: generaaltrab ($132.55 in chips) 
Seat 3: BounceSower ($36.70 in chips) 
Seat 4: kaomaaje ($36 in chips) 
Seat 5: Revolucion51 ($193.50 in chips) 
Seat 6: neni85 ($103.65 in chips) 
neni85: posts small blind $1
beargood: posts big blind $2
*** HOLE CARDS ***
generaaltrab: folds 
BounceSower: raises $3 to $5
kaomaaje: folds 
Revolucion51: folds 
neni85: folds 
beargood: folds 
Uncalled bet ($3) returned to BounceSower
BounceSower collected $5 from pot
*** SUMMARY ***
Total pot $5 | Rake $0 
Seat 1: beargood (big blind) folded before Flop
Seat 2: generaaltrab folded before Flop (didn't bet)
Seat 3: BounceSower collected ($5)
Seat 4: kaomaaje folded before Flop (didn't bet)
Seat 5: Revolucion51 (button) folded before Flop (didn't bet)
Seat 6: neni85 (small blind) folded before Flop




PokerStars Game #47185738957:  Hold'em No Limit ($1/$2 USD) - 2010/07/23 23:55:11 ET
Table 'Sibylla II' 6-max Seat #3 is the button
Seat 1: LeoFara ($51.35 in chips) 
Seat 2: AironVega ($26.70 in chips) 
Seat 3: jimjam1979 ($39.85 in chips) 
Seat 4: sp4taxes ($65.35 in chips) 
Seat 5: BlindFlying ($206.30 in chips) 
Seat 6: tradan ($50.80 in chips) 
sp4taxes: posts small blind $1
BlindFlying: posts big blind $2
*** HOLE CARDS ***
tradan: folds 
LeoFara: folds 
AironVega: folds 
jimjam1979: folds 
sp4taxes: folds 
Uncalled bet ($1) returned to BlindFlying
BlindFlying collected $2 from pot
BlindFlying: doesn't show hand 
*** SUMMARY ***
Total pot $2 | Rake $0 
Seat 1: LeoFara folded before Flop (didn't bet)
Seat 2: AironVega folded before Flop (didn't bet)
Seat 3: jimjam1979 (button) folded before Flop (didn't bet)
Seat 4: sp4taxes (small blind) folded before Flop
Seat 5: BlindFlying (big blind) collected ($2)
Seat 6: tradan folded before Flop (didn't bet)




PokerStars Game #47185741250:  Hold'em No Limit ($1/$2 USD) - 2010/07/23 23:55:17 ET
Table 'Rafita IV' 6-max Seat #1 is the button
Seat 1: neni85 ($154.10 in chips) 
Seat 2: NewEra760 ($66.75 in chips) 
Seat 3: AillemKall ($53.80 in chips) 
Seat 4: WizardOfAhhs ($112.35 in chips) 
Seat 5: jimjam1979 ($43.15 in chips) 
Seat 6: Ricko7456 ($159.55 in chips) 
NewEra760: posts small blind $1
AillemKall: posts big blind $2
*** HOLE CARDS ***
WizardOfAhhs: folds 
jimjam1979: folds 
Ricko7456: folds 
neni85: raises $3 to $5
NewEra760: folds 
AillemKall: folds 
Uncalled bet ($3) returned to neni85
neni85 collected $5 from pot
neni85: doesn't show hand 
*** SUMMARY ***
Total pot $5 | Rake $0 
Seat 1: neni85 (button) collected ($5)
Seat 2: NewEra760 (small blind) folded before Flop
Seat 3: AillemKall (big blind) folded before Flop
Seat 4: WizardOfAhhs folded before Flop (didn't bet)
Seat 5: jimjam1979 folded before Flop (didn't bet)
Seat 6: Ricko7456 folded before Flop (didn't bet)




PokerStars Game #47185713781:  Hold'em No Limit ($1/$2 USD) - 2010/07/23 23:54:12 ET
Table 'Shajna' 6-max Seat #5 is the button
Seat 1: neni85 ($100 in chips) 
Seat 2: wheels6990 ($89.85 in chips) 
Seat 3: robsolo ($65.05 in chips) 
Seat 4: latebrake ($62.10 in chips) 
Seat 5: jimjam1979 ($30 in chips) 
Seat 6: AillemKall ($44.70 in chips) 
AillemKall: posts small blind $1
neni85: posts big blind $2
*** HOLE CARDS ***
wheels6990: folds 
robsolo: raises $4 to $6
latebrake: folds 
jimjam1979: folds 
wheels6990 leaves the table
AillemKall: folds 
neni85: folds 
Uncalled bet ($4) returned to robsolo
robsolo collected $5 from pot
robsolo: doesn't show hand 
*** SUMMARY ***
Total pot $5 | Rake $0 
Seat 1: neni85 (big blind) folded before Flop
Seat 2: wheels6990 folded before Flop (didn't bet)
Seat 3: robsolo collected ($5)
Seat 4: latebrake folded before Flop (didn't bet)
Seat 5: jimjam1979 (button) folded before Flop (didn't bet)
Seat 6: AillemKall (small blind) folded before Flop




PokerStars Game #47185724941:  Hold'em No Limit ($1/$2 USD) - 2010/07/23 23:54:37 ET
Table 'Natalie' 6-max Seat #1 is the button
Seat 1: DURKADURDUR ($420.65 in chips) 
Seat 3: THEDUTCH4141 ($201 in chips) 
Seat 5: FastEddie267 ($215.60 in chips) 
Seat 6: leukehond ($222.90 in chips) 
THEDUTCH4141: posts small blind $1
FastEddie267: posts big blind $2
*** HOLE CARDS ***
leukehond: folds 
DURKADURDUR: raises $4 to $6
THEDUTCH4141: folds 
FastEddie267: folds 
Uncalled bet ($4) returned to DURKADURDUR
DURKADURDUR collected $5 from pot
DURKADURDUR: doesn't show hand 
*** SUMMARY ***
Total pot $5 | Rake $0 
Seat 1: DURKADURDUR (button) collected ($5)
Seat 3: THEDUTCH4141 (small blind) folded before Flop
Seat 5: FastEddie267 (big blind) folded before Flop
Seat 6: leukehond folded before Flop (didn't bet)




PokerStars Game #47185741979:  Hold'em No Limit ($1/$2 USD) - 2010/07/23 23:55:20 ET
Table 'Natalie' 6-max Seat #3 is the button
Seat 1: DURKADURDUR ($423.65 in chips) 
Seat 3: THEDUTCH4141 ($200 in chips) 
Seat 5: FastEddie267 ($213.60 in chips) 
Seat 6: leukehond ($222.90 in chips) 
FastEddie267: posts small blind $1
leukehond: posts big blind $2
*** HOLE CARDS ***
DURKADURDUR: raises $4 to $6
THEDUTCH4141: folds 
FastEddie267: folds 
leukehond: folds 
Uncalled bet ($4) returned to DURKADURDUR
DURKADURDUR collected $5 from pot
DURKADURDUR: doesn't show hand 
*** SUMMARY ***
Total pot $5 | Rake $0 
Seat 1: DURKADURDUR collected ($5)
Seat 3: THEDUTCH4141 (button) folded before Flop (didn't bet)
Seat 5: FastEddie267 (small blind) folded before Flop
Seat 6: leukehond (big blind) folded before Flop




PokerStars Game #47185757655:  Hold'em No Limit ($1/$2 USD) - 2010/07/23 23:56:07 ET
Table 'Shajna' 6-max Seat #4 is the button
Seat 1: neni85 ($100 in chips) 
Seat 4: latebrake ($69.90 in chips) 
Seat 5: jimjam1979 ($34.55 in chips) 
Seat 6: AillemKall ($43.70 in chips) 
jimjam1979: posts small blind $1
AillemKall: posts big blind $2
bj2207: sits out 
*** HOLE CARDS ***
neni85: folds 
latebrake: raises $2 to $4
jimjam1979: raises $30.55 to $34.55 and is all-in
AillemKall: folds 
latebrake: folds 
Uncalled bet ($30.55) returned to jimjam1979
jimjam1979 collected $10 from pot
jimjam1979: doesn't show hand 
*** SUMMARY ***
Total pot $10 | Rake $0 
Seat 1: neni85 folded before Flop (didn't bet)
Seat 4: latebrake (button) folded before Flop
Seat 5: jimjam1979 (small blind) collected ($10)
Seat 6: AillemKall (big blind) folded before Flop




PokerStars Game #47185694578:  Hold'em No Limit ($1/$2 USD) - 2010/07/23 23:53:29 ET
Table 'Thoas' 6-max Seat #5 is the button
Seat 1: mdeckND ($287.20 in chips) 
Seat 2: DURKADURDUR ($705.25 in chips) 
Seat 3: Jetize ($235.40 in chips) 
Seat 4: mojox ($48.75 in chips) 
Seat 5: FrAnWaN ($322.50 in chips) 
Seat 6: asseral ($236.60 in chips) 
asseral: posts small blind $1
mdeckND: posts big blind $2
*** HOLE CARDS ***
DURKADURDUR: folds 
Jetize: raises $4 to $6
mojox: calls $6
FrAnWaN: folds 
asseral: folds 
mdeckND: folds 
*** FLOP *** [Qd 5d 8h]
Jetize: checks 
mojox: bets $4
Jetize: folds 
Uncalled bet ($4) returned to mojox
mojox collected $14.25 from pot
mojox: doesn't show hand 
*** SUMMARY ***
Total pot $15 | Rake $0.75 
Board [Qd 5d 8h]
Seat 1: mdeckND (big blind) folded before Flop
Seat 2: DURKADURDUR folded before Flop (didn't bet)
Seat 3: Jetize folded on the Flop
Seat 4: mojox collected ($14.25)
Seat 5: FrAnWaN (button) folded before Flop (didn't bet)
Seat 6: asseral (small blind) folded before Flop




PokerStars Game #47185740472:  Hold'em No Limit ($1/$2 USD) - 2010/07/23 23:55:15 ET
Table 'Rigilkent VIII' 6-max Seat #4 is the button
Seat 1: TODO ADENTR0 ($407 in chips) 
Seat 2: DURKADURDUR ($200 in chips) 
Seat 3: -MinhNa- ($158.80 in chips) 
Seat 4: jaeh00d ($329.75 in chips) 
Seat 5: FrAnWaN ($232.75 in chips) 
Seat 6: thomaswkm ($200 in chips) 
FrAnWaN: posts small blind $1
thomaswkm: posts big blind $2
*** HOLE CARDS ***
TODO ADENTR0: folds 
DURKADURDUR: folds 
-MinhNa-: calls $2
jaeh00d: folds 
FrAnWaN: folds 
thomaswkm: checks 
*** FLOP *** [6c 8s 9d]
thomaswkm: checks 
-MinhNa-: bets $4
thomaswkm: folds 
Uncalled bet ($4) returned to -MinhNa-
-MinhNa- collected $4.75 from pot
-MinhNa-: doesn't show hand 
*** SUMMARY ***
Total pot $5 | Rake $0.25 
Board [6c 8s 9d]
Seat 1: TODO ADENTR0 folded before Flop (didn't bet)
Seat 2: DURKADURDUR folded before Flop (didn't bet)
Seat 3: -MinhNa- collected ($4.75)
Seat 4: jaeh00d (button) folded before Flop (didn't bet)
Seat 5: FrAnWaN (small blind) folded before Flop
Seat 6: thomaswkm (big blind) folded on the Flop




PokerStars Game #47185735627:  Hold'em No Limit ($1/$2 USD) - 2010/07/23 23:55:02 ET
Table 'Phereclos II' 6-max Seat #2 is the button
Seat 1: mpolice2010 ($81.95 in chips) 
Seat 2: rafa1985 ($56 in chips) 
Seat 3: ILS16L ($48.25 in chips) 
Seat 4: mpm135 ($478.45 in chips) 
Seat 5: TexasSooner2 ($81.55 in chips) 
ILS16L: posts small blind $1
mpm135: posts big blind $2
*** HOLE CARDS ***
TexasSooner2: folds 
mpolice2010: calls $2
rafa1985: folds 
ILS16L: folds 
mpm135: checks 
*** FLOP *** [5s 3c Qh]
mpm135: checks 
mpolice2010: checks 
*** TURN *** [5s 3c Qh] [Kd]
mpm135: checks 
mpolice2010: checks 
*** RIVER *** [5s 3c Qh Kd] [Qc]
Chickencatch leaves the table
mpm135: bets $2
mpolice2010: raises $2 to $4
mpm135: folds 
Uncalled bet ($2) returned to mpolice2010
mpolice2010 collected $8.60 from pot
*** SUMMARY ***
Total pot $9 | Rake $0.40 
Board [5s 3c Qh Kd Qc]
Seat 1: mpolice2010 collected ($8.60)
Seat 2: rafa1985 (button) folded before Flop (didn't bet)
Seat 3: ILS16L (small blind) folded before Flop
Seat 4: mpm135 (big blind) folded on the River
Seat 5: TexasSooner2 folded before Flop (didn't bet)




PokerStars Game #47185682227:  Hold'em No Limit ($1/$2 USD) - 2010/07/23 23:53:01 ET
Table 'Laocoon III' 6-max Seat #3 is the button
Seat 1: 1tormentor ($292.20 in chips) 
Seat 2: angryjamman ($191.85 in chips) 
Seat 3: TODO ADENTR0 ($212.90 in chips) 
Seat 4: Fierytycoon ($201 in chips) 
Seat 5: DURKADURDUR ($200 in chips) 
Seat 6: FrAnWaN ($293.70 in chips) 
Fierytycoon: posts small blind $1
DURKADURDUR: posts big blind $2
*** HOLE CARDS ***
FrAnWaN: raises $4 to $6
1tormentor: folds 
angryjamman: folds 
TODO ADENTR0: folds 
Fierytycoon: raises $14 to $20
DURKADURDUR: folds 
FrAnWaN: raises $30 to $50
Fierytycoon: folds 
Uncalled bet ($30) returned to FrAnWaN
FrAnWaN collected $42 from pot
FrAnWaN: doesn't show hand 
*** SUMMARY ***
Total pot $42 | Rake $0 
Seat 1: 1tormentor folded before Flop (didn't bet)
Seat 2: angryjamman folded before Flop (didn't bet)
Seat 3: TODO ADENTR0 (button) folded before Flop (didn't bet)
Seat 4: Fierytycoon (small blind) folded before Flop
Seat 5: DURKADURDUR (big blind) folded before Flop
Seat 6: FrAnWaN collected ($42)




PokerStars Game #47185699521:  Hold'em No Limit ($1/$2 USD) - 2010/07/23 23:53:40 ET
Table 'Wilhelmina' 6-max Seat #4 is the button
Seat 2: DMACM ($91 in chips) 
Seat 4: richard175 ($52.20 in chips) 
Seat 5: TODO ADENTR0 ($310.30 in chips) 
Seat 6: hellokittery ($219.95 in chips) 
TODO ADENTR0: posts small blind $1
hellokittery: posts big blind $2
jaeh00d: sits out 
THEDUTCH4141: sits out 
*** HOLE CARDS ***
DMACM: folds 
richard175: calls $2
TODO ADENTR0: raises $5 to $7
hellokittery: folds 
richard175: calls $5
*** FLOP *** [As 5h Jh]
TODO ADENTR0: bets $11
richard175: calls $11
*** TURN *** [As 5h Jh] [3c]
TODO ADENTR0: checks 
richard175: bets $12
TODO ADENTR0: folds 
Uncalled bet ($12) returned to richard175
richard175 collected $36.15 from pot
richard175: doesn't show hand 
*** SUMMARY ***
Total pot $38 | Rake $1.85 
Board [As 5h Jh 3c]
Seat 2: DMACM folded before Flop (didn't bet)
Seat 4: richard175 (button) collected ($36.15)
Seat 5: TODO ADENTR0 (small blind) folded on the Turn
Seat 6: hellokittery (big blind) folded before Flop




PokerStars Game #47185760116:  Hold'em No Limit ($1/$2 USD) - 2010/07/23 23:56:14 ET
Table 'Neckar VII' 6-max Seat #6 is the button
Seat 1: Marker275 ($194.10 in chips) 
Seat 2: DURKADURDUR ($284.10 in chips) 
Seat 3: dmyj ($213.60 in chips) 
Seat 4: THEDUTCH4141 ($211.55 in chips) 
Seat 5: imthesky ($214.65 in chips) 
Seat 6: botano ($100 in chips) 
Marker275: posts small blind $1
DURKADURDUR: posts big blind $2
*** HOLE CARDS ***
dmyj: folds 
dmyj leaves the table
THEDUTCH4141: folds 
TODO ADENTR0 joins the table at seat #3 
imthesky: folds 
botano: folds 
Marker275: folds 
Uncalled bet ($1) returned to DURKADURDUR
DURKADURDUR collected $2 from pot
DURKADURDUR: doesn't show hand 
*** SUMMARY ***
Total pot $2 | Rake $0 
Seat 1: Marker275 (small blind) folded before Flop
Seat 2: DURKADURDUR (big blind) collected ($2)
Seat 3: dmyj folded before Flop (didn't bet)
Seat 4: THEDUTCH4141 folded before Flop (didn't bet)
Seat 5: imthesky folded before Flop (didn't bet)
Seat 6: botano (button) folded before Flop (didn't bet)




PokerStars Game #47185729281:  Hold'em No Limit ($1/$2 USD) - 2010/07/23 23:54:47 ET
Table 'Luscinia' 6-max Seat #4 is the button
Seat 1: AillemKall ($35.30 in chips) 
Seat 2: JDVC ($71.95 in chips) 
Seat 3: rodrieliot ($42 in chips) 
Seat 4: ILS16L ($78.65 in chips) 
Seat 5: Clabby01 ($97.70 in chips) 
Seat 6: sebass911 ($97 in chips) 
Clabby01: posts small blind $1
sebass911: posts big blind $2
*** HOLE CARDS ***
AillemKall: folds 
JDVC: calls $2
rodrieliot: raises $4 to $6
ILS16L: folds 
Clabby01: folds 
sebass911: folds 
JDVC: calls $4
*** FLOP *** [3c 2c 3h]
JDVC: checks 
rodrieliot: bets $10
JDVC: folds 
Uncalled bet ($10) returned to rodrieliot
rodrieliot collected $14.25 from pot
*** SUMMARY ***
Total pot $15 | Rake $0.75 
Board [3c 2c 3h]
Seat 1: AillemKall folded before Flop (didn't bet)
Seat 2: JDVC folded on the Flop
Seat 3: rodrieliot collected ($14.25)
Seat 4: ILS16L (button) folded before Flop (didn't bet)
Seat 5: Clabby01 (small blind) folded before Flop
Seat 6: sebass911 (big blind) folded before Flop




PokerStars Game #47185726827:  Hold'em No Limit ($1/$2 USD) - 2010/07/23 23:54:42 ET
Table 'Shajna' 6-max Seat #6 is the button
Seat 1: neni85 ($100 in chips) 
Seat 3: robsolo ($68.05 in chips) 
Seat 4: latebrake ($62.10 in chips) 
Seat 5: jimjam1979 ($30 in chips) 
Seat 6: AillemKall ($43.70 in chips) 
neni85: posts small blind $1
robsolo: posts big blind $2
*** HOLE CARDS ***
latebrake: raises $2 to $4
jimjam1979: folds 
AillemKall: folds 
neni85: folds 
robsolo: calls $2
*** FLOP *** [Th 3c 9c]
robsolo: bets $4
latebrake: raises $4 to $8
robsolo: calls $4
*** TURN *** [Th 3c 9c] [6h]
robsolo: checks 
latebrake: bets $20
robsolo: folds 
Uncalled bet ($20) returned to latebrake
bj2207 joins the table at seat #2 
latebrake collected $23.80 from pot
*** SUMMARY ***
Total pot $25 | Rake $1.20 
Board [Th 3c 9c 6h]
Seat 1: neni85 (small blind) folded before Flop
Seat 3: robsolo (big blind) folded on the Turn
Seat 4: latebrake collected ($23.80)
Seat 5: jimjam1979 folded before Flop (didn't bet)
Seat 6: AillemKall (button) folded before Flop (didn't bet)




PokerStars Game #47185733371:  Hold'em No Limit ($1/$2 USD) - 2010/07/23 23:54:57 ET
Table 'Strenua' 6-max Seat #3 is the button
Seat 1: neni85 ($207.60 in chips) 
Seat 2: blackduck11 ($129.05 in chips) 
Seat 3: jenny12346 ($128.45 in chips) 
Seat 4: tdiddy ($115.15 in chips) 
Seat 5: AillemKall ($39 in chips) 
Seat 6: C6Z06 2GO ($129.65 in chips) 
tdiddy: posts small blind $1
AillemKall: posts big blind $2
*** HOLE CARDS ***
C6Z06 2GO: calls $2
neni85: folds 
blackduck11: calls $2
jenny12346: folds 
tdiddy: folds 
AillemKall: raises $37 to $39 and is all-in
C6Z06 2GO: folds 
blackduck11: folds 
Uncalled bet ($37) returned to AillemKall
AillemKall collected $7 from pot
AillemKall: doesn't show hand 
*** SUMMARY ***
Total pot $7 | Rake $0 
Seat 1: neni85 folded before Flop (didn't bet)
Seat 2: blackduck11 folded before Flop
Seat 3: jenny12346 (button) folded before Flop (didn't bet)
Seat 4: tdiddy (small blind) folded before Flop
Seat 5: AillemKall (big blind) collected ($7)
Seat 6: C6Z06 2GO folded before Flop




PokerStars Game #47185737120:  Hold'em No Limit ($1/$2 USD) - 2010/07/23 23:55:05 ET
Table 'Selene' 6-max Seat #4 is the button
Seat 1: beargood ($106.35 in chips) 
Seat 2: Rocco35 ($53.05 in chips) 
Seat 3: Mamoo ($126.40 in chips) 
Seat 4: HUMBLED1 ($247 in chips) 
Seat 5: DMACM ($87.35 in chips) 
Seat 6: BlindFlying ($161 in chips) 
DMACM: posts small blind $1
BlindFlying: posts big blind $2
*** HOLE CARDS ***
beargood: folds 
Rocco35: calls $2
Mamoo: folds 
HUMBLED1: raises $6 to $8
DMACM: folds 
BlindFlying: folds 
Rocco35: calls $6
*** FLOP *** [Jd 5d Kh]
Rocco35: checks 
HUMBLED1: bets $10
Rocco35: raises $35.05 to $45.05 and is all-in
HUMBLED1: folds 
Uncalled bet ($35.05) returned to Rocco35
Rocco35 collected $37.10 from pot
*** SUMMARY ***
Total pot $39 | Rake $1.90 
Board [Jd 5d Kh]
Seat 1: beargood folded before Flop (didn't bet)
Seat 2: Rocco35 collected ($37.10)
Seat 3: Mamoo folded before Flop (didn't bet)
Seat 4: HUMBLED1 (button) folded on the Flop
Seat 5: DMACM (small blind) folded before Flop
Seat 6: BlindFlying (big blind) folded before Flop




PokerStars Game #47185686826:  Hold'em No Limit ($1/$2 USD) - 2010/07/23 23:53:11 ET
Table 'Kentaurus IV' 6-max Seat #6 is the button
Seat 1: neni85 ($263.45 in chips) 
Seat 2: DMACM ($96.25 in chips) 
Seat 4: AillemKall ($71.80 in chips) 
Seat 5: LeoFara ($60.80 in chips) 
Seat 6: FlushVirus ($84.30 in chips) 
neni85: posts small blind $1
DMACM: posts big blind $2
*** HOLE CARDS ***
AillemKall: raises $2.10 to $4.10
LeoFara: folds 
FlushVirus: calls $4.10
neni85: folds 
DMACM: folds 
*** FLOP *** [Jc 6d Ac]
AillemKall: checks 
FlushVirus: checks 
*** TURN *** [Jc 6d Ac] [4s]
AillemKall: bets $4.25
FlushVirus: raises $4.25 to $8.50
THEDUTCH4141 joins the table at seat #3 
AillemKall: folds 
Uncalled bet ($4.25) returned to FlushVirus
FlushVirus collected $18.75 from pot
*** SUMMARY ***
Total pot $19.70 | Rake $0.95 
Board [Jc 6d Ac 4s]
Seat 1: neni85 (small blind) folded before Flop
Seat 2: DMACM (big blind) folded before Flop
Seat 4: AillemKall folded on the Turn
Seat 5: LeoFara folded before Flop (didn't bet)
Seat 6: FlushVirus (button) collected ($18.75)




PokerStars Game #47185708281:  Hold'em No Limit ($1/$2 USD) - 2010/07/23 23:54:00 ET
Table 'Sibylla II' 6-max Seat #1 is the button
Seat 1: LeoFara ($51.35 in chips) 
Seat 2: AironVega ($22.70 in chips) 
Seat 3: jimjam1979 ($42.85 in chips) 
Seat 4: sp4taxes ($67.35 in chips) 
Seat 5: BlindFlying ($206.30 in chips) 
Seat 6: tradan ($50.05 in chips) 
AironVega: posts small blind $1
jimjam1979: posts big blind $2
*** HOLE CARDS ***
sp4taxes: folds 
BlindFlying: folds 
tradan: calls $2
LeoFara: folds 
AironVega: folds 
jimjam1979: checks 
*** FLOP *** [Ah 9s Kc]
jimjam1979: checks 
tradan: bets $4
jimjam1979: folds 
Uncalled bet ($4) returned to tradan
tradan collected $4.75 from pot
*** SUMMARY ***
Total pot $5 | Rake $0.25 
Board [Ah 9s Kc]
Seat 1: LeoFara (button) folded before Flop (didn't bet)
Seat 2: AironVega (small blind) folded before Flop
Seat 3: jimjam1979 (big blind) folded on the Flop
Seat 4: sp4taxes folded before Flop (didn't bet)
Seat 5: BlindFlying folded before Flop (didn't bet)
Seat 6: tradan collected ($4.75)




PokerStars Game #47185712759:  Hold'em No Limit ($1/$2 USD) - 2010/07/23 23:54:10 ET
Table 'Vitja' 6-max Seat #2 is the button
Seat 1: WizardOfAhhs ($76.85 in chips) 
Seat 2: Don brujo ($34.90 in chips) 
Seat 3: rodrieliot ($40 in chips) 
Seat 4: emilpetten ($35.25 in chips) 
Seat 5: EKkL ($38.45 in chips) 
Seat 6: LeoFara ($37 in chips) 
rodrieliot: posts small blind $1
emilpetten: posts big blind $2
*** HOLE CARDS ***
EKkL: folds 
LeoFara: folds 
WizardOfAhhs: folds 
Don brujo: folds 
rodrieliot: folds 
Uncalled bet ($1) returned to emilpetten
emilpetten collected $2 from pot
emilpetten: doesn't show hand 
*** SUMMARY ***
Total pot $2 | Rake $0 
Seat 1: WizardOfAhhs folded before Flop (didn't bet)
Seat 2: Don brujo (button) folded before Flop (didn't bet)
Seat 3: rodrieliot (small blind) folded before Flop
Seat 4: emilpetten (big blind) collected ($2)
Seat 5: EKkL folded before Flop (didn't bet)
Seat 6: LeoFara folded before Flop (didn't bet)




PokerStars Game #47185700605:  Hold'em No Limit ($1/$2 USD) - 2010/07/23 23:53:42 ET
Table 'Menelaus II' 6-max Seat #1 is the button
Seat 1: LeoFara ($47.10 in chips) 
Seat 2: Berg58 ($98 in chips) 
Seat 3: topstich ($34.85 in chips) 
Seat 4: mzosh ($193.30 in chips) 
Seat 5: tdiddy ($163.25 in chips) 
Seat 6: sp4taxes ($60.85 in chips) 
Berg58: posts small blind $1
topstich: posts big blind $2
*** HOLE CARDS ***
mzosh: folds 
tdiddy: folds 
sp4taxes: calls $2
LeoFara: folds 
Berg58: folds 
topstich: checks 
*** FLOP *** [7c Tc 3h]
topstich: checks 
sp4taxes: checks 
*** TURN *** [7c Tc 3h] [Ts]
topstich: checks 
sp4taxes: bets $4
topstich: folds 
Uncalled bet ($4) returned to sp4taxes
sp4taxes collected $4.75 from pot
sp4taxes: doesn't show hand 
*** SUMMARY ***
Total pot $5 | Rake $0.25 
Board [7c Tc 3h Ts]
Seat 1: LeoFara (button) folded before Flop (didn't bet)
Seat 2: Berg58 (small blind) folded before Flop
Seat 3: topstich (big blind) folded on the Turn
Seat 4: mzosh folded before Flop (didn't bet)
Seat 5: tdiddy folded before Flop (didn't bet)
Seat 6: sp4taxes collected ($4.75)




PokerStars Game #47185727077:  Hold'em No Limit ($1/$2 USD) - 2010/07/23 23:54:42 ET
Table 'Margo II' 6-max Seat #5 is the button
Seat 1: wheels6990 ($43 in chips) 
Seat 2: AillemKall ($34 in chips) 
Seat 3: crock41 ($32.10 in chips) 
Seat 4: WizardOfAhhs ($81.35 in chips) 
Seat 5: AironVega ($45.60 in chips) 
Seat 6: JLS1956 ($75.30 in chips) 
JLS1956: posts small blind $1
wheels6990: posts big blind $2
*** HOLE CARDS ***
AillemKall: folds 
crock41: folds 
WizardOfAhhs: folds 
AironVega: raises $2.10 to $4.10
JLS1956: folds 
wheels6990: calls $2.10
*** FLOP *** [3d 3s Jd]
wheels6990: checks 
AironVega: bets $5.40
wheels6990: folds 
Uncalled bet ($5.40) returned to AironVega
AironVega collected $8.75 from pot
AironVega: doesn't show hand 
*** SUMMARY ***
Total pot $9.20 | Rake $0.45 
Board [3d 3s Jd]
Seat 1: wheels6990 (big blind) folded on the Flop
Seat 2: AillemKall folded before Flop (didn't bet)
Seat 3: crock41 folded before Flop (didn't bet)
Seat 4: WizardOfAhhs folded before Flop (didn't bet)
Seat 5: AironVega (button) collected ($8.75)
Seat 6: JLS1956 (small blind) folded before Flop




PokerStars Game #47185729530:  Hold'em No Limit ($1/$2 USD) - 2010/07/23 23:54:48 ET
Table 'Vitja' 6-max Seat #3 is the button
Seat 1: WizardOfAhhs ($76.85 in chips) 
Seat 2: Don brujo ($34.90 in chips) 
Seat 3: rodrieliot ($39 in chips) 
Seat 4: emilpetten ($36.25 in chips) 
Seat 5: EKkL ($38.45 in chips) 
Seat 6: LeoFara ($37 in chips) 
emilpetten: posts small blind $1
EKkL: posts big blind $2
*** HOLE CARDS ***
LeoFara: raises $2.40 to $4.40
WizardOfAhhs: folds 
Don brujo: folds 
rodrieliot: folds 
emilpetten: folds 
EKkL: calls $2.40
*** FLOP *** [Kc 8h 3d]
EKkL: checks 
LeoFara: bets $9.35
EKkL: raises $24.70 to $34.05 and is all-in
LeoFara: folds 
Uncalled bet ($24.70) returned to EKkL
EKkL collected $27.10 from pot
*** SUMMARY ***
Total pot $28.50 | Rake $1.40 
Board [Kc 8h 3d]
Seat 1: WizardOfAhhs folded before Flop (didn't bet)
Seat 2: Don brujo folded before Flop (didn't bet)
Seat 3: rodrieliot (button) folded before Flop (didn't bet)
Seat 4: emilpetten (small blind) folded before Flop
Seat 5: EKkL (big blind) collected ($27.10)
Seat 6: LeoFara folded on the Flop




PokerStars Game #47185692289:  Hold'em No Limit ($1/$2 USD) - 2010/07/23 23:53:23 ET
Table 'Selene' 6-max Seat #1 is the button
Seat 1: beargood ($106.35 in chips) 
Seat 2: Rocco35 ($45.65 in chips) 
Seat 3: Mamoo ($103.25 in chips) 
Seat 4: HUMBLED1 ($278 in chips) 
Seat 5: DMACM ($86.35 in chips) 
Seat 6: BlindFlying ($165 in chips) 
Rocco35: posts small blind $1
Mamoo: posts big blind $2
*** HOLE CARDS ***
HUMBLED1: folds 
DMACM: folds 
BlindFlying: raises $2 to $4
beargood: folds 
Rocco35: calls $3
Mamoo: calls $2
*** FLOP *** [2s 9s 5h]
Rocco35: checks 
Mamoo: checks 
BlindFlying: checks 
*** TURN *** [2s 9s 5h] [5d]
Rocco35: bets $6
Mamoo: folds 
BlindFlying: folds 
Uncalled bet ($6) returned to Rocco35
Rocco35 collected $11.40 from pot
Rocco35: doesn't show hand 
*** SUMMARY ***
Total pot $12 | Rake $0.60 
Board [2s 9s 5h 5d]
Seat 1: beargood (button) folded before Flop (didn't bet)
Seat 2: Rocco35 (small blind) collected ($11.40)
Seat 3: Mamoo (big blind) folded on the Turn
Seat 4: HUMBLED1 folded before Flop (didn't bet)
Seat 5: DMACM folded before Flop (didn't bet)
Seat 6: BlindFlying folded on the Turn




PokerStars Game #47185661521:  Hold'em No Limit ($1/$2 USD) - 2010/07/23 23:52:13 ET
Table 'Margo II' 6-max Seat #3 is the button
Seat 1: wheels6990 ($43 in chips) 
Seat 2: AillemKall ($34 in chips) 
Seat 3: crock41 ($66.10 in chips) 
Seat 4: WizardOfAhhs ($82.35 in chips) 
Seat 5: AironVega ($36.60 in chips) 
Seat 6: JLS1956 ($52.65 in chips) 
WizardOfAhhs: posts small blind $1
AironVega: posts big blind $2
*** HOLE CARDS ***
JLS1956: folds 
wheels6990: folds 
AillemKall: folds 
crock41: calls $2
WizardOfAhhs has timed out
WizardOfAhhs: folds 
AironVega: checks 
*** FLOP *** [Kd 9d 5s]
AironVega: checks 
crock41: checks 
*** TURN *** [Kd 9d 5s] [Ah]
AironVega: checks 
crock41: checks 
*** RIVER *** [Kd 9d 5s Ah] [Ks]
AironVega: checks 
crock41: bets $8
AironVega: calls $8
*** SHOW DOWN ***
crock41: shows [Jc Td] (a pair of Kings)
AironVega: shows [3c Ad] (two pair, Aces and Kings)
AironVega collected $20 from pot
*** SUMMARY ***
Total pot $21 | Rake $1 
Board [Kd 9d 5s Ah Ks]
Seat 1: wheels6990 folded before Flop (didn't bet)
Seat 2: AillemKall folded before Flop (didn't bet)
Seat 3: crock41 (button) showed [Jc Td] and lost with a pair of Kings
Seat 4: WizardOfAhhs (small blind) folded before Flop
Seat 5: AironVega (big blind) showed [3c Ad] and won ($20) with two pair, Aces and Kings
Seat 6: JLS1956 folded before Flop (didn't bet)




PokerStars Game #47185706713:  Hold'em No Limit ($1/$2 USD) - 2010/07/23 23:53:56 ET
Table 'Pala II' 6-max Seat #3 is the button
Seat 1: Fierytycoon ($204.55 in chips) 
Seat 2: thomaswkm ($111.95 in chips) 
Seat 3: TheAwfulDin ($265.95 in chips) 
Seat 4: serj14 ($309.70 in chips) 
Seat 5: asseral ($200 in chips) 
serj14: posts small blind $1
asseral: posts big blind $2
*** HOLE CARDS ***
Fierytycoon: folds 
thomaswkm: folds 
TheAwfulDin: raises $3 to $5
serj14: folds 
asseral: folds 
Uncalled bet ($3) returned to TheAwfulDin
TheAwfulDin collected $5 from pot
TheAwfulDin: doesn't show hand 
*** SUMMARY ***
Total pot $5 | Rake $0 
Seat 1: Fierytycoon folded before Flop (didn't bet)
Seat 2: thomaswkm folded before Flop (didn't bet)
Seat 3: TheAwfulDin (button) collected ($5)
Seat 4: serj14 (small blind) folded before Flop
Seat 5: asseral (big blind) folded before Flop




PokerStars Game #47185713127:  Hold'em No Limit ($1/$2 USD) - 2010/07/23 23:54:11 ET
Table 'Rigilkent VIII' 6-max Seat #3 is the button
Seat 1: TODO ADENTR0 ($203 in chips) 
Seat 2: DURKADURDUR ($233.30 in chips) 
Seat 3: -MinhNa- ($158.80 in chips) 
Seat 4: jaeh00d ($330.75 in chips) 
Seat 5: FrAnWaN ($234.75 in chips) 
jaeh00d: posts small blind $1
FrAnWaN: posts big blind $2
*** HOLE CARDS ***
TODO ADENTR0: raises $4 to $6
DURKADURDUR: raises $14 to $20
-MinhNa-: folds 
jaeh00d: folds 
FrAnWaN: folds 
TODO ADENTR0: calls $14
*** FLOP *** [4s 9s Td]
TODO ADENTR0: checks 
DURKADURDUR: bets $27
TODO ADENTR0: raises $156 to $183 and is all-in
DURKADURDUR: calls $156
*** TURN *** [4s 9s Td] [Qs]
*** RIVER *** [4s 9s Td Qs] [7c]
*** SHOW DOWN ***
TODO ADENTR0: shows [9h 9c] (three of a kind, Nines)
DURKADURDUR: shows [Kd Kh] (a pair of Kings)
TODO ADENTR0 collected $407 from pot
*** SUMMARY ***
Total pot $409 | Rake $2 
Board [4s 9s Td Qs 7c]
Seat 1: TODO ADENTR0 showed [9h 9c] and won ($407) with three of a kind, Nines
Seat 2: DURKADURDUR showed [Kd Kh] and lost with a pair of Kings
Seat 3: -MinhNa- (button) folded before Flop (didn't bet)
Seat 4: jaeh00d (small blind) folded before Flop
Seat 5: FrAnWaN (big blind) folded before Flop




PokerStars Game #47185710993:  Hold'em No Limit ($1/$2 USD) - 2010/07/23 23:54:06 ET
Table 'Thoas' 6-max Seat #6 is the button
Seat 1: mdeckND ($285.20 in chips) 
Seat 2: DURKADURDUR ($705.25 in chips) 
Seat 3: Jetize ($229.40 in chips) 
Seat 4: mojox ($57 in chips) 
Seat 5: FrAnWaN ($322.50 in chips) 
Seat 6: asseral ($235.60 in chips) 
mdeckND: posts small blind $1
DURKADURDUR: posts big blind $2
*** HOLE CARDS ***
Jetize: folds 
mojox: raises $4 to $6
FrAnWaN: folds 
asseral: folds 
mdeckND: folds 
DURKADURDUR: folds 
Uncalled bet ($4) returned to mojox
mojox collected $5 from pot
mojox: doesn't show hand 
*** SUMMARY ***
Total pot $5 | Rake $0 
Seat 1: mdeckND (small blind) folded before Flop
Seat 2: DURKADURDUR (big blind) folded before Flop
Seat 3: Jetize folded before Flop (didn't bet)
Seat 4: mojox collected ($5)
Seat 5: FrAnWaN folded before Flop (didn't bet)
Seat 6: asseral (button) folded before Flop (didn't bet)




PokerStars Game #47185706205:  Hold'em No Limit ($1/$2 USD) - 2010/07/23 23:53:55 ET
Table 'Phereclos II' 6-max Seat #5 is the button
Seat 1: mpolice2010 ($54.25 in chips) 
Seat 2: rafa1985 ($80 in chips) 
Seat 3: ILS16L ($52.25 in chips) 
Seat 4: mpm135 ($478.45 in chips) 
Seat 5: TexasSooner2 ($83.55 in chips) 
mpolice2010: posts small blind $1
rafa1985: posts big blind $2
*** HOLE CARDS ***
ILS16L: folds 
mpm135: folds 
TexasSooner2: calls $2
mpolice2010: calls $1
rafa1985: checks 
*** FLOP *** [Jd Js Qd]
mpolice2010: bets $2
rafa1985: folds 
TexasSooner2: folds 
Uncalled bet ($2) returned to mpolice2010
mpolice2010 collected $5.70 from pot
*** SUMMARY ***
Total pot $6 | Rake $0.30 
Board [Jd Js Qd]
Seat 1: mpolice2010 (small blind) collected ($5.70)
Seat 2: rafa1985 (big blind) folded on the Flop
Seat 3: ILS16L folded before Flop (didn't bet)
Seat 4: mpm135 folded before Flop (didn't bet)
Seat 5: TexasSooner2 (button) folded on the Flop




PokerStars Game #47185709178:  Hold'em No Limit ($1/$2 USD) - 2010/07/23 23:54:02 ET
Table 'Pavo' 6-max Seat #2 is the button
Seat 1: dajatt13 ($208.65 in chips) 
Seat 2: FrAnWaN ($391.90 in chips) 
Seat 4: thomaswkm ($199.25 in chips) 
Seat 5: THEDUTCH4141 ($200 in chips) 
Seat 6: TheAwfulDin ($234.50 in chips) 
FastEddie267 will be allowed to play after the button
thomaswkm: posts small blind $1
THEDUTCH4141: posts big blind $2
*** HOLE CARDS ***
TheAwfulDin: folds 
dajatt13: folds 
FrAnWaN: raises $4 to $6
thomaswkm: folds 
THEDUTCH4141: folds 
Uncalled bet ($4) returned to FrAnWaN
FrAnWaN collected $5 from pot
FrAnWaN: doesn't show hand 
*** SUMMARY ***
Total pot $5 | Rake $0 
Seat 1: dajatt13 folded before Flop (didn't bet)
Seat 2: FrAnWaN (button) collected ($5)
Seat 4: thomaswkm (small blind) folded before Flop
Seat 5: THEDUTCH4141 (big blind) folded before Flop
Seat 6: TheAwfulDin folded before Flop (didn't bet)




PokerStars Game #47185709566:  Hold'em No Limit ($1/$2 USD) - 2010/07/23 23:54:03 ET
Table 'Luscinia' 6-max Seat #2 is the button
Seat 1: AillemKall ($35.30 in chips) 
Seat 2: JDVC ($68.95 in chips) 
Seat 3: rodrieliot ($43 in chips) 
Seat 4: ILS16L ($78.65 in chips) 
Seat 5: Clabby01 ($99.70 in chips) 
Seat 6: sebass911 ($97 in chips) 
rodrieliot: posts small blind $1
ILS16L: posts big blind $2
*** HOLE CARDS ***
Clabby01: folds 
sebass911: folds 
AillemKall: folds 
JDVC: folds 
rodrieliot: folds 
Uncalled bet ($1) returned to ILS16L
ILS16L collected $2 from pot
ILS16L: doesn't show hand 
*** SUMMARY ***
Total pot $2 | Rake $0 
Seat 1: AillemKall folded before Flop (didn't bet)
Seat 2: JDVC (button) folded before Flop (didn't bet)
Seat 3: rodrieliot (small blind) folded before Flop
Seat 4: ILS16L (big blind) collected ($2)
Seat 5: Clabby01 folded before Flop (didn't bet)
Seat 6: sebass911 folded before Flop (didn't bet)




PokerStars Game #47185754216:  Hold'em No Limit ($1/$2 USD) - 2010/07/23 23:55:56 ET
Table 'Kentaurus IV' 6-max Seat #2 is the button
Seat 1: neni85 ($262.45 in chips) 
Seat 2: DMACM ($94.75 in chips) 
Seat 3: THEDUTCH4141 ($100.50 in chips) 
Seat 5: LeoFara ($58.80 in chips) 
Seat 6: FlushVirus ($92.70 in chips) 
THEDUTCH4141: posts small blind $1
AillemKall: is sitting out 
LeoFara: posts big blind $2
*** HOLE CARDS ***
AillemKall leaves the table
FlushVirus: raises $4 to $6
neni85: folds 
DMACM: folds 
THEDUTCH4141: folds 
LeoFara: folds 
Uncalled bet ($4) returned to FlushVirus
FlushVirus collected $5 from pot
*** SUMMARY ***
Total pot $5 | Rake $0 
Seat 1: neni85 folded before Flop (didn't bet)
Seat 2: DMACM (button) folded before Flop (didn't bet)
Seat 3: THEDUTCH4141 (small blind) folded before Flop
Seat 5: LeoFara (big blind) folded before Flop
Seat 6: FlushVirus collected ($5)




PokerStars Game #47185697689:  Hold'em No Limit ($1/$2 USD) - 2010/07/23 23:53:36 ET
Table 'Strenua' 6-max Seat #2 is the button
Seat 1: neni85 ($207.60 in chips) 
Seat 2: blackduck11 ($134.05 in chips) 
Seat 3: jenny12346 ($129.45 in chips) 
Seat 4: tdiddy ($109.65 in chips) 
Seat 5: AillemKall ($39 in chips) 
Seat 6: C6Z06 2GO ($129.65 in chips) 
jenny12346: posts small blind $1
tdiddy: posts big blind $2
*** HOLE CARDS ***
AillemKall: folds 
C6Z06 2GO: folds 
neni85: folds 
blackduck11: calls $2
jenny12346: folds 
tdiddy: checks 
*** FLOP *** [Tc 4s 7c]
tdiddy: bets $3
blackduck11: calls $3
*** TURN *** [Tc 4s 7c] [Ad]
tdiddy: checks 
blackduck11: checks 
*** RIVER *** [Tc 4s 7c Ad] [Js]
tdiddy: checks 
blackduck11: checks 
*** SHOW DOWN ***
tdiddy: shows [6s Ts] (a pair of Tens)
blackduck11: mucks hand 
tdiddy collected $10.50 from pot
*** SUMMARY ***
Total pot $11 | Rake $0.50 
Board [Tc 4s 7c Ad Js]
Seat 1: neni85 folded before Flop (didn't bet)
Seat 2: blackduck11 (button) mucked
Seat 3: jenny12346 (small blind) folded before Flop
Seat 4: tdiddy (big blind) showed [6s Ts] and won ($10.50) with a pair of Tens
Seat 5: AillemKall folded before Flop (didn't bet)
Seat 6: C6Z06 2GO folded before Flop (didn't bet)




PokerStars Game #47185743669:  Hold'em No Limit ($1/$2 USD) - 2010/07/23 23:55:25 ET
Table 'Margo II' 6-max Seat #6 is the button
Seat 1: wheels6990 ($38.90 in chips) 
Seat 2: AillemKall ($34 in chips) 
Seat 3: crock41 ($32.10 in chips) 
Seat 4: WizardOfAhhs ($81.35 in chips) 
Seat 5: AironVega ($50.25 in chips) 
Seat 6: JLS1956 ($74.30 in chips) 
wheels6990: posts small blind $1
AillemKall: posts big blind $2
*** HOLE CARDS ***
crock41: folds 
WizardOfAhhs: folds 
AironVega: folds 
JLS1956: folds 
wheels6990: raises $2 to $4
AillemKall: folds 
Uncalled bet ($2) returned to wheels6990
wheels6990 collected $4 from pot
*** SUMMARY ***
Total pot $4 | Rake $0 
Seat 1: wheels6990 (small blind) collected ($4)
Seat 2: AillemKall (big blind) folded before Flop
Seat 3: crock41 folded before Flop (didn't bet)
Seat 4: WizardOfAhhs folded before Flop (didn't bet)
Seat 5: AironVega folded before Flop (didn't bet)
Seat 6: JLS1956 (button) folded before Flop (didn't bet)




PokerStars Game #47185750878:  Hold'em No Limit ($1/$2 USD) - 2010/07/23 23:55:46 ET
Table 'Phoenix V' 6-max Seat #3 is the button
Seat 1: MJJ & ADT ($33 in chips) 
Seat 2: tdiddy ($144.05 in chips) 
Seat 3: pike2229 ($189.25 in chips) 
Seat 4: jimjam1979 ($41 in chips) 
Seat 6: neni85 ($449.90 in chips) 
jimjam1979: posts small blind $1
neni85: posts big blind $2
*** HOLE CARDS ***
MJJ & ADT: folds 
tdiddy: folds 
pike2229: calls $2
jimjam1979: folds 
neni85: raises $10 to $12
pike2229: calls $10
*** FLOP *** [Ac 8s 5s]
neni85: bets $16
pike2229: folds 
Uncalled bet ($16) returned to neni85
neni85 collected $23.75 from pot
neni85: doesn't show hand 
*** SUMMARY ***
Total pot $25 | Rake $1.25 
Board [Ac 8s 5s]
Seat 1: MJJ & ADT folded before Flop (didn't bet)
Seat 2: tdiddy folded before Flop (didn't bet)
Seat 3: pike2229 (button) folded on the Flop
Seat 4: jimjam1979 (small blind) folded before Flop
Seat 6: neni85 (big blind) collected ($23.75)




PokerStars Game #47185718936:  Hold'em No Limit ($1/$2 USD) - 2010/07/23 23:54:24 ET
Table 'Laodica' 6-max Seat #5 is the button
Seat 2: LeoFara ($50.85 in chips) 
Seat 3: jimjam1979 ($41 in chips) 
Seat 4: BlindFlying ($107.20 in chips) 
Seat 5: rodrieliot ($57.60 in chips) 
Seat 6: JuStBLaZe908 ($218.85 in chips) 
JuStBLaZe908: posts small blind $1
WizardOfAhhs: is sitting out 
LeoFara: posts big blind $2
*** HOLE CARDS ***
WizardOfAhhs leaves the table
jimjam1979: folds 
BlindFlying: folds 
rodrieliot: folds 
JuStBLaZe908: raises $4 to $6
LeoFara: raises $44.85 to $50.85 and is all-in
JuStBLaZe908: calls $44.85
*** FLOP *** [Ac 6h Kd]
*** TURN *** [Ac 6h Kd] [5c]
*** RIVER *** [Ac 6h Kd 5c] [Kh]
*** SHOW DOWN ***
JuStBLaZe908: shows [Qc Ah] (two pair, Aces and Kings)
LeoFara: shows [4d 4s] (two pair, Kings and Fours)
JuStBLaZe908 collected $99.70 from pot
*** SUMMARY ***
Total pot $101.70 | Rake $2 
Board [Ac 6h Kd 5c Kh]
Seat 2: LeoFara (big blind) showed [4d 4s] and lost with two pair, Kings and Fours
Seat 3: jimjam1979 folded before Flop (didn't bet)
Seat 4: BlindFlying folded before Flop (didn't bet)
Seat 5: rodrieliot (button) folded before Flop (didn't bet)
Seat 6: JuStBLaZe908 (small blind) showed [Qc Ah] and won ($99.70) with two pair, Aces and Kings




PokerStars Game #47185663339:  Hold'em No Limit ($1/$2 USD) - 2010/07/23 23:52:18 ET
Table 'Triton III' 6-max Seat #4 is the button
Seat 1: Cardsdevil27 ($72.80 in chips) 
Seat 2: Fierytycoon ($200 in chips) 
Seat 3: Jetize ($210 in chips) 
Seat 4: thomaswkm ($452.65 in chips) 
Seat 5: DURKADURDUR ($244.30 in chips) 
Seat 6: FrAnWaN ($429.25 in chips) 
DURKADURDUR: posts small blind $1
FrAnWaN: posts big blind $2
*** HOLE CARDS ***
Cardsdevil27: calls $2
Fierytycoon: folds 
Jetize: raises $6 to $8
thomaswkm has timed out
thomaswkm: folds 
DURKADURDUR: folds 
FrAnWaN: folds 
Cardsdevil27: calls $6
*** FLOP *** [9h 2c Js]
Cardsdevil27: checks 
Jetize: checks 
*** TURN *** [9h 2c Js] [Qs]
Cardsdevil27: checks 
Jetize: checks 
*** RIVER *** [9h 2c Js Qs] [3d]
Cardsdevil27: checks 
Jetize: checks 
*** SHOW DOWN ***
Cardsdevil27: shows [Ad 9s] (a pair of Nines)
Jetize: mucks hand 
Cardsdevil27 collected $18.05 from pot
*** SUMMARY ***
Total pot $19 | Rake $0.95 
Board [9h 2c Js Qs 3d]
Seat 1: Cardsdevil27 showed [Ad 9s] and won ($18.05) with a pair of Nines
Seat 2: Fierytycoon folded before Flop (didn't bet)
Seat 3: Jetize mucked
Seat 4: thomaswkm (button) folded before Flop (didn't bet)
Seat 5: DURKADURDUR (small blind) folded before Flop
Seat 6: FrAnWaN (big blind) folded before Flop




PokerStars Game #47185744521:  Hold'em No Limit ($1/$2 USD) - 2010/07/23 23:55:27 ET
Table 'Shajna' 6-max Seat #1 is the button
Seat 1: neni85 ($100 in chips) 
Seat 3: robsolo ($56.05 in chips) 
Seat 4: latebrake ($73.90 in chips) 
Seat 5: jimjam1979 ($30 in chips) 
Seat 6: AillemKall ($43.70 in chips) 
bj2207 will be allowed to play after the button
robsolo: posts small blind $1
latebrake: posts big blind $2
*** HOLE CARDS ***
jimjam1979: raises $2 to $4
AillemKall: folds 
neni85: folds 
robsolo: folds 
latebrake: calls $2
*** FLOP *** [4d Jd 9h]
robsolo leaves the table
latebrake: checks 
jimjam1979: bets $5
latebrake: folds 
Uncalled bet ($5) returned to jimjam1979
jimjam1979 collected $8.55 from pot
jimjam1979: doesn't show hand 
*** SUMMARY ***
Total pot $9 | Rake $0.45 
Board [4d Jd 9h]
Seat 1: neni85 (button) folded before Flop (didn't bet)
Seat 3: robsolo (small blind) folded before Flop
Seat 4: latebrake (big blind) folded on the Flop
Seat 5: jimjam1979 collected ($8.55)
Seat 6: AillemKall folded before Flop (didn't bet)




PokerStars Game #47185742632:  Hold'em No Limit ($1/$2 USD) - 2010/07/23 23:55:22 ET
Table 'Luscinia' 6-max Seat #5 is the button
Seat 1: AillemKall ($35.30 in chips) 
Seat 2: JDVC ($65.95 in chips) 
Seat 3: rodrieliot ($50.25 in chips) 
Seat 4: ILS16L ($78.65 in chips) 
Seat 5: Clabby01 ($96.70 in chips) 
Seat 6: sebass911 ($95 in chips) 
sebass911: posts small blind $1
AillemKall: posts big blind $2
*** HOLE CARDS ***
JDVC: calls $2
rodrieliot: folds 
ILS16L: folds 
Clabby01: folds 
sebass911: raises $4 to $6
AillemKall: folds 
JDVC: calls $4
*** FLOP *** [5d 6h Js]
sebass911: bets $6
JDVC: folds 
Uncalled bet ($6) returned to sebass911
sebass911 collected $13.30 from pot
*** SUMMARY ***
Total pot $14 | Rake $0.70 
Board [5d 6h Js]
Seat 1: AillemKall (big blind) folded before Flop
Seat 2: JDVC folded on the Flop
Seat 3: rodrieliot folded before Flop (didn't bet)
Seat 4: ILS16L folded before Flop (didn't bet)
Seat 5: Clabby01 (button) folded before Flop (didn't bet)
Seat 6: sebass911 (small blind) collected ($13.30)




PokerStars Game #47185693668:  Hold'em No Limit ($1/$2 USD) - 2010/07/23 23:53:27 ET
Table 'Phoenix V' 6-max Seat #3 is the button
Seat 1: MJJ & ADT ($36 in chips) 
Seat 2: tdiddy ($144.05 in chips) 
Seat 3: pike2229 ($139.60 in chips) 
Seat 4: jimjam1979 ($49.20 in chips) 
Seat 6: neni85 ($451.50 in chips) 
jimjam1979: posts small blind $1
WizardOfAhhs: is sitting out 
neni85: posts big blind $2
*** HOLE CARDS ***
WizardOfAhhs leaves the table
MJJ & ADT: folds 
tdiddy: folds 
pike2229: calls $2
jimjam1979: raises $47.20 to $49.20 and is all-in
neni85: folds 
pike2229: calls $47.20
*** FLOP *** [4s 6h Qs]
*** TURN *** [4s 6h Qs] [Js]
*** RIVER *** [4s 6h Qs Js] [2c]
*** SHOW DOWN ***
jimjam1979: shows [8c 8d] (a pair of Eights)
pike2229: shows [Th Jh] (a pair of Jacks)
pike2229 collected $98.40 from pot
*** SUMMARY ***
Total pot $100.40 | Rake $2 
Board [4s 6h Qs Js 2c]
Seat 1: MJJ & ADT folded before Flop (didn't bet)
Seat 2: tdiddy folded before Flop (didn't bet)
Seat 3: pike2229 (button) showed [Th Jh] and won ($98.40) with a pair of Jacks
Seat 4: jimjam1979 (small blind) showed [8c 8d] and lost with a pair of Eights
Seat 6: neni85 (big blind) folded before Flop




PokerStars Game #47185726466:  Hold'em No Limit ($1/$2 USD) - 2010/07/23 23:54:41 ET
Table 'Orthosie II' 6-max Seat #1 is the button
Seat 1: neni85 ($501.45 in chips) 
Seat 2: harujongil ($53.65 in chips) 
Seat 4: spiderfrank ($90.70 in chips) 
Seat 5: LeoFara ($41.40 in chips) 
Seat 6: onitsuaf ($74.05 in chips) 
harujongil: posts small blind $1
WizardOfAhhs: is sitting out 
spiderfrank: posts big blind $2
*** HOLE CARDS ***
WizardOfAhhs leaves the table
LeoFara: folds 
onitsuaf: raises $2 to $4
neni85: folds 
harujongil: folds 
spiderfrank: calls $2
*** FLOP *** [Kc 7c Qd]
spiderfrank: checks 
onitsuaf: checks 
*** TURN *** [Kc 7c Qd] [7h]
spiderfrank: bets $2
onitsuaf: calls $2
*** RIVER *** [Kc 7c Qd 7h] [4h]
spiderfrank: bets $4
onitsuaf: folds 
Uncalled bet ($4) returned to spiderfrank
spiderfrank collected $12.40 from pot
*** SUMMARY ***
Total pot $13 | Rake $0.60 
Board [Kc 7c Qd 7h 4h]
Seat 1: neni85 (button) folded before Flop (didn't bet)
Seat 2: harujongil (small blind) folded before Flop
Seat 4: spiderfrank (big blind) collected ($12.40)
Seat 5: LeoFara folded before Flop (didn't bet)
Seat 6: onitsuaf folded on the River




PokerStars Game #47185724615:  Hold'em No Limit ($1/$2 USD) - 2010/07/23 23:54:37 ET
Table 'Laocoon III' 6-max Seat #5 is the button
Seat 1: 1tormentor ($292.20 in chips) 
Seat 2: angryjamman ($191.85 in chips) 
Seat 3: TODO ADENTR0 ($212.90 in chips) 
Seat 4: Fierytycoon ($200 in chips) 
Seat 5: DURKADURDUR ($200 in chips) 
Seat 6: FrAnWaN ($316.70 in chips) 
FrAnWaN: posts small blind $1
1tormentor: posts big blind $2
*** HOLE CARDS ***
angryjamman: calls $2
TODO ADENTR0: folds 
Fierytycoon: folds 
DURKADURDUR: folds 
FrAnWaN: folds 
1tormentor: raises $6 to $8
angryjamman: calls $6
*** FLOP *** [7s 2c 7h]
1tormentor: checks 
angryjamman: checks 
*** TURN *** [7s 2c 7h] [Qs]
1tormentor: bets $15
angryjamman: folds 
Uncalled bet ($15) returned to 1tormentor
1tormentor collected $16.15 from pot
1tormentor: doesn't show hand 
*** SUMMARY ***
Total pot $17 | Rake $0.85 
Board [7s 2c 7h Qs]
Seat 1: 1tormentor (big blind) collected ($16.15)
Seat 2: angryjamman folded on the Turn
Seat 3: TODO ADENTR0 folded before Flop (didn't bet)
Seat 4: Fierytycoon folded before Flop (didn't bet)
Seat 5: DURKADURDUR (button) folded before Flop (didn't bet)
Seat 6: FrAnWaN (small blind) folded before Flop




PokerStars Game #47185722117:  Hold'em No Limit ($1/$2 USD) - 2010/07/23 23:54:31 ET
Table 'Sibylla II' 6-max Seat #2 is the button
Seat 1: LeoFara ($51.35 in chips) 
Seat 2: AironVega ($21.70 in chips) 
Seat 3: jimjam1979 ($40.85 in chips) 
Seat 4: sp4taxes ($67.35 in chips) 
Seat 5: BlindFlying ($206.30 in chips) 
Seat 6: tradan ($52.80 in chips) 
jimjam1979: posts small blind $1
sp4taxes: posts big blind $2
*** HOLE CARDS ***
BlindFlying: folds 
tradan: calls $2
LeoFara: folds 
AironVega: raises $5.20 to $7.20
jimjam1979: folds 
sp4taxes: folds 
tradan: folds 
Uncalled bet ($5.20) returned to AironVega
AironVega collected $7 from pot
AironVega: doesn't show hand 
*** SUMMARY ***
Total pot $7 | Rake $0 
Seat 1: LeoFara folded before Flop (didn't bet)
Seat 2: AironVega (button) collected ($7)
Seat 3: jimjam1979 (small blind) folded before Flop
Seat 4: sp4taxes (big blind) folded before Flop
Seat 5: BlindFlying folded before Flop (didn't bet)
Seat 6: tradan folded before Flop




PokerStars Game #47185695327:  Hold'em No Limit ($1/$2 USD) - 2010/07/23 23:53:30 ET
Table 'Rafita IV' 6-max Seat #5 is the button
Seat 1: neni85 ($157.10 in chips) 
Seat 2: NewEra760 ($67.85 in chips) 
Seat 3: AillemKall ($57.90 in chips) 
Seat 4: WizardOfAhhs ($112.35 in chips) 
Seat 5: jimjam1979 ($43.15 in chips) 
Seat 6: Ricko7456 ($152 in chips) 
Ricko7456: posts small blind $1
neni85: posts big blind $2
*** HOLE CARDS ***
NewEra760: raises $2 to $4
AillemKall: folds 
WizardOfAhhs: folds 
jimjam1979: folds 
Ricko7456: folds 
neni85: folds 
Uncalled bet ($2) returned to NewEra760
NewEra760 collected $5 from pot
NewEra760: doesn't show hand 
*** SUMMARY ***
Total pot $5 | Rake $0 
Seat 1: neni85 (big blind) folded before Flop
Seat 2: NewEra760 collected ($5)
Seat 3: AillemKall folded before Flop (didn't bet)
Seat 4: WizardOfAhhs folded before Flop (didn't bet)
Seat 5: jimjam1979 (button) folded before Flop (didn't bet)
Seat 6: Ricko7456 (small blind) folded before Flop




PokerStars Game #47185705451:  Hold'em No Limit ($1/$2 USD) - 2010/07/23 23:53:53 ET
Table 'Maia III' 6-max Seat #6 is the button
Seat 1: thomaswkm ($193.35 in chips) 
Seat 2: FrAnWaN ($371.65 in chips) 
Seat 3: dertaylor ($208.25 in chips) 
Seat 4: TODO ADENTR0 ($221 in chips) 
Seat 5: DURKADURDUR ($204.20 in chips) 
Seat 6: hellokittery ($219.40 in chips) 
thomaswkm: posts small blind $1
FrAnWaN: posts big blind $2
*** HOLE CARDS ***
dertaylor: raises $2 to $4
TODO ADENTR0: folds 
DURKADURDUR: folds 
hellokittery: folds 
thomaswkm: folds 
FrAnWaN: folds 
Uncalled bet ($2) returned to dertaylor
dertaylor collected $5 from pot
*** SUMMARY ***
Total pot $5 | Rake $0 
Seat 1: thomaswkm (small blind) folded before Flop
Seat 2: FrAnWaN (big blind) folded before Flop
Seat 3: dertaylor collected ($5)
Seat 4: TODO ADENTR0 folded before Flop (didn't bet)
Seat 5: DURKADURDUR folded before Flop (didn't bet)
Seat 6: hellokittery (button) folded before Flop (didn't bet)




PokerStars Game #47185696680:  Hold'em No Limit ($1/$2 USD) - 2010/07/23 23:53:33 ET
Table 'Vitja' 6-max Seat #1 is the button
Seat 1: WizardOfAhhs ($73.85 in chips) 
Seat 2: Don brujo ($35.90 in chips) 
Seat 3: rodrieliot ($42 in chips) 
Seat 4: emilpetten ($35.25 in chips) 
Seat 5: EKkL ($38.45 in chips) 
Seat 6: LeoFara ($37 in chips) 
Don brujo: posts small blind $1
rodrieliot: posts big blind $2
*** HOLE CARDS ***
emilpetten: folds 
EKkL: folds 
LeoFara: folds 
WizardOfAhhs: raises $2.10 to $4.10
Don brujo: folds 
rodrieliot: folds 
Uncalled bet ($2.10) returned to WizardOfAhhs
WizardOfAhhs collected $5 from pot
WizardOfAhhs: doesn't show hand 
*** SUMMARY ***
Total pot $5 | Rake $0 
Seat 1: WizardOfAhhs (button) collected ($5)
Seat 2: Don brujo (small blind) folded before Flop
Seat 3: rodrieliot (big blind) folded before Flop
Seat 4: emilpetten folded before Flop (didn't bet)
Seat 5: EKkL folded before Flop (didn't bet)
Seat 6: LeoFara folded before Flop (didn't bet)




PokerStars Game #47185751325:  Hold'em No Limit ($1/$2 USD) - 2010/07/23 23:55:48 ET
Table 'Neckar VII' 6-max Seat #5 is the button
Seat 1: Marker275 ($196.10 in chips) 
Seat 2: DURKADURDUR ($284.10 in chips) 
Seat 3: dmyj ($213.60 in chips) 
Seat 4: THEDUTCH4141 ($211.55 in chips) 
Seat 5: imthesky ($211.65 in chips) 
Seat 6: botano ($100 in chips) 
botano: posts small blind $1
Marker275: posts big blind $2
*** HOLE CARDS ***
DURKADURDUR: folds 
dmyj: folds 
THEDUTCH4141: folds 
imthesky: raises $6 to $8
botano: folds 
Marker275: folds 
Uncalled bet ($6) returned to imthesky
imthesky collected $5 from pot
imthesky: doesn't show hand 
*** SUMMARY ***
Total pot $5 | Rake $0 
Seat 1: Marker275 (big blind) folded before Flop
Seat 2: DURKADURDUR folded before Flop (didn't bet)
Seat 3: dmyj folded before Flop (didn't bet)
Seat 4: THEDUTCH4141 folded before Flop (didn't bet)
Seat 5: imthesky (button) collected ($5)
Seat 6: botano (small blind) folded before Flop




PokerStars Game #47185698304:  Hold'em No Limit ($1/$2 USD) - 2010/07/23 23:53:37 ET
Table 'Sibylla II' 6-max Seat #6 is the button
Seat 1: LeoFara ($52.35 in chips) 
Seat 2: AironVega ($24.70 in chips) 
Seat 3: jimjam1979 ($39.85 in chips) 
Seat 4: sp4taxes ($67.35 in chips) 
Seat 5: BlindFlying ($206.30 in chips) 
Seat 6: tradan ($50.05 in chips) 
LeoFara: posts small blind $1
AironVega: posts big blind $2
*** HOLE CARDS ***
jimjam1979: raises $2 to $4
sp4taxes: folds 
BlindFlying: folds 
tradan: folds 
LeoFara: folds 
AironVega: folds 
Uncalled bet ($2) returned to jimjam1979
jimjam1979 collected $5 from pot
jimjam1979: doesn't show hand 
*** SUMMARY ***
Total pot $5 | Rake $0 
Seat 1: LeoFara (small blind) folded before Flop
Seat 2: AironVega (big blind) folded before Flop
Seat 3: jimjam1979 collected ($5)
Seat 4: sp4taxes folded before Flop (didn't bet)
Seat 5: BlindFlying folded before Flop (didn't bet)
Seat 6: tradan (button) folded before Flop (didn't bet)




PokerStars Game #47185744727:  Hold'em No Limit ($1/$2 USD) - 2010/07/23 23:55:28 ET
Table 'Sibylla II' 6-max Seat #4 is the button
Seat 1: LeoFara ($51.35 in chips) 
Seat 2: AironVega ($26.70 in chips) 
Seat 3: jimjam1979 ($39.85 in chips) 
Seat 4: sp4taxes ($64.35 in chips) 
Seat 5: BlindFlying ($207.30 in chips) 
Seat 6: tradan ($50.80 in chips) 
BlindFlying: posts small blind $1
tradan: posts big blind $2
*** HOLE CARDS ***
LeoFara: folds 
AironVega: folds 
jimjam1979: folds 
sp4taxes: raises $4 to $6
BlindFlying: folds 
tradan: folds 
Uncalled bet ($4) returned to sp4taxes
sp4taxes collected $5 from pot
sp4taxes: doesn't show hand 
*** SUMMARY ***
Total pot $5 | Rake $0 
Seat 1: LeoFara folded before Flop (didn't bet)
Seat 2: AironVega folded before Flop (didn't bet)
Seat 3: jimjam1979 folded before Flop (didn't bet)
Seat 4: sp4taxes (button) collected ($5)
Seat 5: BlindFlying (small blind) folded before Flop
Seat 6: tradan (big blind) folded before Flop




PokerStars Game #47185727596:  Hold'em No Limit ($1/$2 USD) - 2010/07/23 23:54:43 ET
Table 'Lonnrot III' 6-max Seat #2 is the button
Seat 1: THEDUTCH4141 ($200 in chips) 
Seat 2: Duke_Moto ($207.95 in chips) 
Seat 3: DURKADURDUR ($212.45 in chips) 
Seat 4: imthesky ($224.30 in chips) 
Seat 5: dajatt13 ($343 in chips) 
Seat 6: FrAnWaN ($277.75 in chips) 
DURKADURDUR: posts small blind $1
imthesky: posts big blind $2
*** HOLE CARDS ***
dajatt13: folds 
FrAnWaN: folds 
THEDUTCH4141: folds 
Duke_Moto: raises $4 to $6
DURKADURDUR: folds 
imthesky: folds 
Uncalled bet ($4) returned to Duke_Moto
Duke_Moto collected $5 from pot
Duke_Moto: doesn't show hand 
*** SUMMARY ***
Total pot $5 | Rake $0 
Seat 1: THEDUTCH4141 folded before Flop (didn't bet)
Seat 2: Duke_Moto (button) collected ($5)
Seat 3: DURKADURDUR (small blind) folded before Flop
Seat 4: imthesky (big blind) folded before Flop
Seat 5: dajatt13 folded before Flop (didn't bet)
Seat 6: FrAnWaN folded before Flop (didn't bet)




PokerStars Game #47185694187:  Hold'em No Limit ($1/$2 USD) - 2010/07/23 23:53:28 ET
Table 'Scutum X' 6-max Seat #5 is the button
Seat 1: jamieunlv017 ($115.90 in chips) 
Seat 2: AillemKall ($34.90 in chips) 
Seat 3: AironVega ($45.90 in chips) 
Seat 4: Mamoo ($25.70 in chips) 
Seat 5: Bruno_F88 ($114.10 in chips) 
Seat 6: mpm135 ($137.15 in chips) 
mpm135: posts small blind $1
jamieunlv017: posts big blind $2
*** HOLE CARDS ***
AillemKall: folds 
AironVega: raises $2.10 to $4.10
Mamoo: folds 
Bruno_F88: folds 
mpm135: folds 
jamieunlv017: folds 
Uncalled bet ($2.10) returned to AironVega
AironVega collected $5 from pot
AironVega: doesn't show hand 
*** SUMMARY ***
Total pot $5 | Rake $0 
Seat 1: jamieunlv017 (big blind) folded before Flop
Seat 2: AillemKall folded before Flop (didn't bet)
Seat 3: AironVega collected ($5)
Seat 4: Mamoo folded before Flop (didn't bet)
Seat 5: Bruno_F88 (button) folded before Flop (didn't bet)
Seat 6: mpm135 (small blind) folded before Flop




PokerStars Game #47185747748:  Hold'em No Limit ($1/$2 USD) - 2010/07/23 23:55:37 ET
Table 'Strenua' 6-max Seat #4 is the button
Seat 1: neni85 ($207.60 in chips) 
Seat 3: jenny12346 ($128.45 in chips) 
Seat 4: tdiddy ($114.15 in chips) 
Seat 5: AillemKall ($44 in chips) 
Seat 6: C6Z06 2GO ($127.65 in chips) 
AillemKall: posts small blind $1
C6Z06 2GO: posts big blind $2
*** HOLE CARDS ***
blackduck11 leaves the table
AironVega joins the table at seat #2 
neni85: folds 
jenny12346: folds 
tdiddy: raises $3 to $5
AillemKall: raises $39 to $44 and is all-in
C6Z06 2GO: folds 
tdiddy: folds 
Uncalled bet ($39) returned to AillemKall
AillemKall collected $12 from pot
AillemKall: doesn't show hand 
*** SUMMARY ***
Total pot $12 | Rake $0 
Seat 1: neni85 folded before Flop (didn't bet)
Seat 3: jenny12346 folded before Flop (didn't bet)
Seat 4: tdiddy (button) folded before Flop
Seat 5: AillemKall (small blind) collected ($12)
Seat 6: C6Z06 2GO (big blind) folded before Flop




PokerStars Game #47185706395:  Hold'em No Limit ($1/$2 USD) - 2010/07/23 23:53:56 ET
Table 'Shajna' 6-max Seat #4 is the button
Seat 1: neni85 ($100 in chips) 
Seat 2: wheels6990 ($89.85 in chips) 
Seat 3: robsolo ($65.05 in chips) 
Seat 4: latebrake ($62.10 in chips) 
Seat 5: jimjam1979 ($28 in chips) 
Seat 6: AillemKall ($46.70 in chips) 
jimjam1979: posts small blind $1
AillemKall: posts big blind $2
*** HOLE CARDS ***
neni85: folds 
wheels6990: folds 
robsolo: folds 
latebrake: folds 
jimjam1979: raises $2 to $4
AillemKall: folds 
Uncalled bet ($2) returned to jimjam1979
jimjam1979 collected $4 from pot
jimjam1979: doesn't show hand 
*** SUMMARY ***
Total pot $4 | Rake $0 
Seat 1: neni85 folded before Flop (didn't bet)
Seat 2: wheels6990 folded before Flop (didn't bet)
Seat 3: robsolo folded before Flop (didn't bet)
Seat 4: latebrake (button) folded before Flop (didn't bet)
Seat 5: jimjam1979 (small blind) collected ($4)
Seat 6: AillemKall (big blind) folded before Flop




PokerStars Game #47185760494:  Hold'em No Limit ($1/$2 USD) - 2010/07/23 23:56:15 ET
Table 'Laodica' 6-max Seat #2 is the button
Seat 2: LeoFara ($40 in chips) 
Seat 3: jimjam1979 ($39 in chips) 
Seat 4: BlindFlying ($96.20 in chips) 
Seat 5: rodrieliot ($57.60 in chips) 
Seat 6: JuStBLaZe908 ($318.70 in chips) 
jimjam1979: posts small blind $1
BlindFlying: posts big blind $2
*** HOLE CARDS ***
rodrieliot: folds 
JuStBLaZe908: raises $4 to $6
LeoFara: folds 
jimjam1979: folds 
BlindFlying: folds 
Uncalled bet ($4) returned to JuStBLaZe908
JuStBLaZe908 collected $5 from pot
*** SUMMARY ***
Total pot $5 | Rake $0 
Seat 2: LeoFara (button) folded before Flop (didn't bet)
Seat 3: jimjam1979 (small blind) folded before Flop
Seat 4: BlindFlying (big blind) folded before Flop
Seat 5: rodrieliot folded before Flop (didn't bet)
Seat 6: JuStBLaZe908 collected ($5)




PokerStars Game #47185712319:  Hold'em No Limit ($1/$2 USD) - 2010/07/23 23:54:09 ET
Table 'Scutum X' 6-max Seat #6 is the button
Seat 1: jamieunlv017 ($113.90 in chips) 
Seat 2: AillemKall ($34.90 in chips) 
Seat 3: AironVega ($48.90 in chips) 
Seat 4: Mamoo ($25.70 in chips) 
Seat 5: Bruno_F88 ($114.10 in chips) 
Seat 6: mpm135 ($136.15 in chips) 
jamieunlv017: posts small blind $1
AillemKall: posts big blind $2
*** HOLE CARDS ***
AironVega: folds 
Mamoo: folds 
Bruno_F88: folds 
mpm135: folds 
jamieunlv017: calls $1
AillemKall: checks 
*** FLOP *** [8c Ac 8h]
jamieunlv017: checks 
AillemKall: bets $2
jamieunlv017: folds 
Uncalled bet ($2) returned to AillemKall
AillemKall collected $3.80 from pot
AillemKall: doesn't show hand 
*** SUMMARY ***
Total pot $4 | Rake $0.20 
Board [8c Ac 8h]
Seat 1: jamieunlv017 (small blind) folded on the Flop
Seat 2: AillemKall (big blind) collected ($3.80)
Seat 3: AironVega folded before Flop (didn't bet)
Seat 4: Mamoo folded before Flop (didn't bet)
Seat 5: Bruno_F88 folded before Flop (didn't bet)
Seat 6: mpm135 (button) folded before Flop (didn't bet)




PokerStars Game #47185699713:  Hold'em No Limit ($1/$2 USD) - 2010/07/23 23:53:40 ET
Table 'Malabar III' 6-max Seat #3 is the button
Seat 1: imthesky ($376 in chips) 
Seat 2: TODO ADENTR0 ($236 in chips) 
Seat 3: leukehond ($200 in chips) 
Seat 4: hellokittery ($200 in chips) 
Seat 5: MooMooTin ($104.30 in chips) 
Seat 6: DURKADURDUR ($385.20 in chips) 
hellokittery: posts small blind $1
MooMooTin: posts big blind $2
*** HOLE CARDS ***
DURKADURDUR has timed out
DURKADURDUR: folds 
imthesky: folds 
TODO ADENTR0: folds 
leukehond: raises $3 to $5
hellokittery: folds 
MooMooTin: calls $3
*** FLOP *** [4h 3s Td]
MooMooTin: checks 
leukehond: bets $5
MooMooTin: raises $5 to $10
leukehond: folds 
Uncalled bet ($5) returned to MooMooTin
MooMooTin collected $20 from pot
*** SUMMARY ***
Total pot $21 | Rake $1 
Board [4h 3s Td]
Seat 1: imthesky folded before Flop (didn't bet)
Seat 2: TODO ADENTR0 folded before Flop (didn't bet)
Seat 3: leukehond (button) folded on the Flop
Seat 4: hellokittery (small blind) folded before Flop
Seat 5: MooMooTin (big blind) collected ($20)
Seat 6: DURKADURDUR folded before Flop (didn't bet)




PokerStars Game #47185717791:  Hold'em No Limit ($1/$2 USD) - 2010/07/23 23:54:21 ET
Table 'Phereclos II' 6-max Seat #1 is the button
Seat 1: mpolice2010 ($57.95 in chips) 
Seat 2: rafa1985 ($78 in chips) 
Seat 3: ILS16L ($52.25 in chips) 
Seat 4: mpm135 ($478.45 in chips) 
Seat 5: TexasSooner2 ($81.55 in chips) 
rafa1985: posts small blind $1
ILS16L: posts big blind $2
*** HOLE CARDS ***
mpm135: folds 
TexasSooner2: folds 
mpolice2010: calls $2
rafa1985: raises $2 to $4
ILS16L: calls $2
mpolice2010: calls $2
*** FLOP *** [8d Ah Kc]
rafa1985: bets $8
ILS16L: folds 
mpolice2010: calls $8
*** TURN *** [8d Ah Kc] [5s]
rafa1985: bets $10
mpolice2010: raises $35.95 to $45.95 and is all-in
rafa1985: folds 
Uncalled bet ($35.95) returned to mpolice2010
mpolice2010 collected $46 from pot
*** SUMMARY ***
Total pot $48 | Rake $2 
Board [8d Ah Kc 5s]
Seat 1: mpolice2010 (button) collected ($46)
Seat 2: rafa1985 (small blind) folded on the Turn
Seat 3: ILS16L (big blind) folded on the Flop
Seat 4: mpm135 folded before Flop (didn't bet)
Seat 5: TexasSooner2 folded before Flop (didn't bet)




PokerStars Game #47185718619:  Hold'em No Limit ($1/$2 USD) - 2010/07/23 23:54:23 ET
Table 'Phoenix V' 6-max Seat #6 is the button
Seat 1: MJJ & ADT ($34 in chips) 
Seat 2: tdiddy ($144.05 in chips) 
Seat 3: pike2229 ($188.80 in chips) 
Seat 4: jimjam1979 ($43 in chips) 
Seat 6: neni85 ($448.50 in chips) 
MJJ & ADT: posts small blind $1
tdiddy: posts big blind $2
*** HOLE CARDS ***
pike2229: folds 
jimjam1979: folds 
neni85: folds 
MJJ & ADT: folds 
Uncalled bet ($1) returned to tdiddy
tdiddy collected $2 from pot
tdiddy: doesn't show hand 
*** SUMMARY ***
Total pot $2 | Rake $0 
Seat 1: MJJ & ADT (small blind) folded before Flop
Seat 2: tdiddy (big blind) collected ($2)
Seat 3: pike2229 folded before Flop (didn't bet)
Seat 4: jimjam1979 folded before Flop (didn't bet)
Seat 6: neni85 (button) folded before Flop (didn't bet)




PokerStars Game #47185703666:  Hold'em No Limit ($1/$2 USD) - 2010/07/23 23:53:49 ET
Table 'Natalie' 6-max Seat #3 is the button
Seat 1: DURKADURDUR ($423.65 in chips) 
Seat 2: TODO ADENTR0 ($206.65 in chips) 
Seat 3: THEDUTCH4141 ($200 in chips) 
Seat 6: leukehond ($220.90 in chips) 
leukehond: posts small blind $1
DURKADURDUR: posts big blind $2
*** HOLE CARDS ***
TODO ADENTR0: folds 
THEDUTCH4141: raises $4 to $6
leukehond: folds 
FastEddie267 joins the table at seat #5 
DURKADURDUR: folds 
Uncalled bet ($4) returned to THEDUTCH4141
THEDUTCH4141 collected $5 from pot
THEDUTCH4141: doesn't show hand 
*** SUMMARY ***
Total pot $5 | Rake $0 
Seat 1: DURKADURDUR (big blind) folded before Flop
Seat 2: TODO ADENTR0 folded before Flop (didn't bet)
Seat 3: THEDUTCH4141 (button) collected ($5)
Seat 6: leukehond (small blind) folded before Flop




PokerStars Game #47185738484:  Hold'em No Limit ($1/$2 USD) - 2010/07/23 23:55:09 ET
Table 'Scutum X' 6-max Seat #2 is the button
Seat 1: jamieunlv017 ($111.90 in chips) 
Seat 2: AillemKall ($35.70 in chips) 
Seat 3: AironVega ($46.90 in chips) 
Seat 4: Mamoo ($28.70 in chips) 
Seat 5: Bruno_F88 ($114.10 in chips) 
Seat 6: mpm135 ($136.15 in chips) 
AironVega: posts small blind $1
Mamoo: posts big blind $2
*** HOLE CARDS ***
Bruno_F88: folds 
mpm135: folds 
jamieunlv017: raises $2 to $4
AillemKall: raises $31.70 to $35.70 and is all-in
AironVega: folds 
Mamoo: folds 
jamieunlv017: calls $31.70
*** FLOP *** [Jc 9c 5d]
*** TURN *** [Jc 9c 5d] [9s]
*** RIVER *** [Jc 9c 5d 9s] [9d]
*** SHOW DOWN ***
jamieunlv017: shows [Kc Qh] (three of a kind, Nines)
AillemKall: shows [8s 8h] (a full house, Nines full of Eights)
AillemKall collected $71.40 from pot
*** SUMMARY ***
Total pot $74.40 | Rake $3 
Board [Jc 9c 5d 9s 9d]
Seat 1: jamieunlv017 showed [Kc Qh] and lost with three of a kind, Nines
Seat 2: AillemKall (button) showed [8s 8h] and won ($71.40) with a full house, Nines full of Eights
Seat 3: AironVega (small blind) folded before Flop
Seat 4: Mamoo (big blind) folded before Flop
Seat 5: Bruno_F88 folded before Flop (didn't bet)
Seat 6: mpm135 folded before Flop (didn't bet)




PokerStars Game #47185664837:  Hold'em No Limit ($1/$2 USD) - 2010/07/23 23:52:21 ET
Table 'Regulus' 6-max Seat #5 is the button
Seat 1: FrAnWaN ($253.05 in chips) 
Seat 2: Fierytycoon ($202.95 in chips) 
Seat 3: TODO ADENTR0 ($384.95 in chips) 
Seat 4: thomaswkm ($268.40 in chips) 
Seat 5: DURKADURDUR ($426.40 in chips) 
Seat 6: Rush51 ($71.75 in chips) 
Rush51: posts small blind $1
FrAnWaN: posts big blind $2
*** HOLE CARDS ***
Fierytycoon: folds 
TODO ADENTR0: folds 
thomaswkm has timed out
thomaswkm: folds 
DURKADURDUR: folds 
Rush51: calls $1
FrAnWaN: checks 
*** FLOP *** [3c 7s 2h]
Rush51: bets $2
FrAnWaN: raises $4 to $6
Rush51: calls $4
*** TURN *** [3c 7s 2h] [Th]
Rush51: bets $2
FrAnWaN: calls $2
*** RIVER *** [3c 7s 2h Th] [Jc]
Rush51: bets $61.75 and is all-in
FrAnWaN: folds 
Uncalled bet ($61.75) returned to Rush51
Rush51 collected $19.05 from pot
Rush51: doesn't show hand 
*** SUMMARY ***
Total pot $20 | Rake $0.95 
Board [3c 7s 2h Th Jc]
Seat 1: FrAnWaN (big blind) folded on the River
Seat 2: Fierytycoon folded before Flop (didn't bet)
Seat 3: TODO ADENTR0 folded before Flop (didn't bet)
Seat 4: thomaswkm folded before Flop (didn't bet)
Seat 5: DURKADURDUR (button) folded before Flop (didn't bet)
Seat 6: Rush51 (small blind) collected ($19.05)



PokerStars Game #47185717780:  Hold'em No Limit ($1/$2 USD) - 2010/07/23 23:54:21 ET
Table 'Menelaus II' 6-max Seat #2 is the button
Seat 1: LeoFara ($47.10 in chips) 
Seat 2: Berg58 ($97 in chips) 
Seat 3: topstich ($32.85 in chips) 
Seat 4: mzosh ($193.30 in chips) 
Seat 5: tdiddy ($163.25 in chips) 
Seat 6: sp4taxes ($63.60 in chips) 
topstich: posts small blind $1
mzosh: posts big blind $2
*** HOLE CARDS ***
tdiddy: folds 
sp4taxes: folds 
LeoFara: raises $2.40 to $4.40
Berg58: calls $4.40
topstich: calls $3.40
mzosh: folds 
*** FLOP *** [Td 7d 8s]
topstich: checks 
LeoFara: checks 
Berg58: checks 
*** TURN *** [Td 7d 8s] [Qs]
topstich: checks 
LeoFara: bets $8.65
Berg58: calls $8.65
topstich: folds 
*** RIVER *** [Td 7d 8s Qs] [9d]
LeoFara: checks 
Berg58: checks 
*** SHOW DOWN ***
LeoFara: shows [7h 7c] (three of a kind, Sevens)
Berg58: mucks hand 
LeoFara collected $30.95 from pot
*** SUMMARY ***
Total pot $32.50 | Rake $1.55 
Board [Td 7d 8s Qs 9d]
Seat 1: LeoFara showed [7h 7c] and won ($30.95) with three of a kind, Sevens
Seat 2: Berg58 (button) mucked
Seat 3: topstich (small blind) folded on the Turn
Seat 4: mzosh (big blind) folded before Flop
Seat 5: tdiddy folded before Flop (didn't bet)
Seat 6: sp4taxes folded before Flop (didn't bet)




PokerStars Game #47185761872:  Hold'em No Limit ($1/$2 USD) - 2010/07/23 23:56:19 ET
Table 'Luscinia' 6-max Seat #1 is the button
Seat 1: AillemKall ($39.30 in chips) 
Seat 2: JDVC ($57.95 in chips) 
Seat 3: rodrieliot ($50.25 in chips) 
Seat 4: ILS16L ($78.65 in chips) 
Seat 5: Clabby01 ($92.70 in chips) 
Seat 6: sebass911 ($102.30 in chips) 
JDVC: posts small blind $1
rodrieliot: posts big blind $2
*** HOLE CARDS ***
ILS16L: folds 
Clabby01: folds 
sebass911: folds 
AillemKall: folds 
JDVC: calls $1
rodrieliot: checks 
*** FLOP *** [9c 4h 3d]
JDVC: checks 
rodrieliot: checks 
*** TURN *** [9c 4h 3d] [5s]
JDVC: checks 
rodrieliot: checks 
*** RIVER *** [9c 4h 3d 5s] [8h]
JDVC: checks 
rodrieliot: checks 
*** SHOW DOWN ***
JDVC: shows [Tc 7s] (high card Ten)
rodrieliot: shows [3h Qs] (a pair of Threes)
rodrieliot collected $3.80 from pot
*** SUMMARY ***
Total pot $4 | Rake $0.20 
Board [9c 4h 3d 5s 8h]
Seat 1: AillemKall (button) folded before Flop (didn't bet)
Seat 2: JDVC (small blind) showed [Tc 7s] and lost with high card Ten
Seat 3: rodrieliot (big blind) showed [3h Qs] and won ($3.80) with a pair of Threes
Seat 4: ILS16L folded before Flop (didn't bet)
Seat 5: Clabby01 folded before Flop (didn't bet)
Seat 6: sebass911 folded before Flop (didn't bet)




PokerStars Game #47185691918:  Hold'em No Limit ($1/$2 USD) - 2010/07/23 23:53:23 ET
Table 'Katanga II' 6-max Seat #4 is the button
Seat 1: beargood ($143.70 in chips) 
Seat 2: generaaltrab ($132.55 in chips) 
Seat 3: BounceSower ($36.70 in chips) 
Seat 4: kaomaaje ($36 in chips) 
Seat 5: Revolucion51 ($197.50 in chips) 
Seat 6: neni85 ($100 in chips) 
Revolucion51: posts small blind $1
neni85: posts big blind $2
*** HOLE CARDS ***
beargood: folds 
generaaltrab: folds 
BounceSower: folds 
kaomaaje: folds 
Revolucion51: calls $1
neni85: checks 
*** FLOP *** [9d Kd 8c]
Revolucion51: checks 
neni85: checks 
*** TURN *** [9d Kd 8c] [9h]
Revolucion51: checks 
neni85: checks 
*** RIVER *** [9d Kd 8c 9h] [7c]
Revolucion51: checks 
neni85: bets $2
Revolucion51: calls $2
*** SHOW DOWN ***
neni85: shows [4s Ks] (two pair, Kings and Nines)
Revolucion51: mucks hand 
neni85 collected $7.65 from pot
*** SUMMARY ***
Total pot $8 | Rake $0.35 
Board [9d Kd 8c 9h 7c]
Seat 1: beargood folded before Flop (didn't bet)
Seat 2: generaaltrab folded before Flop (didn't bet)
Seat 3: BounceSower folded before Flop (didn't bet)
Seat 4: kaomaaje (button) folded before Flop (didn't bet)
Seat 5: Revolucion51 (small blind) mucked
Seat 6: neni85 (big blind) showed [4s Ks] and won ($7.65) with two pair, Kings and Nines




PokerStars Game #47185743734:  Hold'em No Limit ($1/$2 USD) - 2010/07/23 23:55:25 ET
Table 'Orthosie II' 6-max Seat #2 is the button
Seat 1: neni85 ($501.45 in chips) 
Seat 2: harujongil ($92.65 in chips) 
Seat 4: spiderfrank ($97.10 in chips) 
Seat 5: LeoFara ($41.40 in chips) 
Seat 6: onitsuaf ($68.05 in chips) 
spiderfrank: posts small blind $1
LeoFara: posts big blind $2
*** HOLE CARDS ***
onitsuaf: folds 
neni85: raises $3 to $5
harujongil: folds 
spiderfrank: folds 
LeoFara: folds 
Uncalled bet ($3) returned to neni85
neni85 collected $5 from pot
neni85: doesn't show hand 
*** SUMMARY ***
Total pot $5 | Rake $0 
Seat 1: neni85 collected ($5)
Seat 2: harujongil (button) folded before Flop (didn't bet)
Seat 4: spiderfrank (small blind) folded before Flop
Seat 5: LeoFara (big blind) folded before Flop
Seat 6: onitsuaf folded before Flop (didn't bet)




PokerStars Game #47185731087:  Hold'em No Limit ($1/$2 USD) - 2010/07/23 23:54:51 ET
Table 'Ottegebe' 6-max Seat #4 is the button
Seat 1: RdrLuv ($97.85 in chips) 
Seat 2: picasso264 ($52.65 in chips) 
Seat 3: AironVega ($36 in chips) 
Seat 4: DMACM ($124.45 in chips) 
Seat 6: jimjam1979 ($31 in chips) 
jimjam1979: posts small blind $1
RdrLuv: posts big blind $2
*** HOLE CARDS ***
picasso264: folds 
AironVega: folds 
DMACM: folds 
jimjam1979: raises $29 to $31 and is all-in
RdrLuv: folds 
Uncalled bet ($29) returned to jimjam1979
jimjam1979 collected $4 from pot
jimjam1979: doesn't show hand 
*** SUMMARY ***
Total pot $4 | Rake $0 
Seat 1: RdrLuv (big blind) folded before Flop
Seat 2: picasso264 folded before Flop (didn't bet)
Seat 3: AironVega folded before Flop (didn't bet)
Seat 4: DMACM (button) folded before Flop (didn't bet)
Seat 6: jimjam1979 (small blind) collected ($4)




PokerStars Game #47185759020:  Hold'em No Limit ($1/$2 USD) - 2010/07/23 23:56:11 ET
Table 'Rafita IV' 6-max Seat #3 is the button
Seat 1: neni85 ($157.10 in chips) 
Seat 2: NewEra760 ($68.75 in chips) 
Seat 3: AillemKall ($50.80 in chips) 
Seat 5: jimjam1979 ($41.15 in chips) 
Seat 6: Ricko7456 ($159.55 in chips) 
jimjam1979: posts small blind $1
Ricko7456: posts big blind $2
*** HOLE CARDS ***
neni85: raises $3 to $5
NewEra760: folds 
AillemKall: folds 
jimjam1979: folds 
Ricko7456: folds 
Uncalled bet ($3) returned to neni85
neni85 collected $5 from pot
neni85: doesn't show hand 
*** SUMMARY ***
Total pot $5 | Rake $0 
Seat 1: neni85 collected ($5)
Seat 2: NewEra760 folded before Flop (didn't bet)
Seat 3: AillemKall (button) folded before Flop (didn't bet)
Seat 5: jimjam1979 (small blind) folded before Flop
Seat 6: Ricko7456 (big blind) folded before Flop




PokerStars Game #47185749202:  Hold'em No Limit ($1/$2 USD) - 2010/07/23 23:55:41 ET
Table 'Menelaus II' 6-max Seat #4 is the button
Seat 1: LeoFara ($65 in chips) 
Seat 3: topstich ($28.45 in chips) 
Seat 4: mzosh ($190.30 in chips) 
Seat 5: tdiddy ($161.25 in chips) 
Seat 6: sp4taxes ($66.60 in chips) 
tdiddy: posts small blind $1
sp4taxes: posts big blind $2
*** HOLE CARDS ***
LeoFara: raises $2.40 to $4.40
topstich: raises $24.05 to $28.45 and is all-in
mzosh: calls $28.45
tdiddy: folds 
sp4taxes: folds 
LeoFara: folds 
*** FLOP *** [Jh 6h 6s]
*** TURN *** [Jh 6h 6s] [Ts]
*** RIVER *** [Jh 6h 6s Ts] [Qd]
*** SHOW DOWN ***
topstich: shows [5h 5d] (two pair, Sixes and Fives)
mzosh: shows [Td Tc] (a full house, Tens full of Sixes)
mzosh collected $62.30 from pot
*** SUMMARY ***
Total pot $64.30 | Rake $2 
Board [Jh 6h 6s Ts Qd]
Seat 1: LeoFara folded before Flop
Seat 3: topstich showed [5h 5d] and lost with two pair, Sixes and Fives
Seat 4: mzosh (button) showed [Td Tc] and won ($62.30) with a full house, Tens full of Sixes
Seat 5: tdiddy (small blind) folded before Flop
Seat 6: sp4taxes (big blind) folded before Flop




PokerStars Game #47185809291:  Hold'em No Limit ($1/$2 USD) - 2010/07/23 23:58:41 ET
Table 'Vitja' 6-max Seat #6 is the button
Seat 3: rodrieliot ($36 in chips) 
Seat 6: LeoFara ($44.80 in chips) 
LeoFara: posts small blind $1
rodrieliot: posts big blind $2
*** HOLE CARDS ***
LeoFara: folds 
Uncalled bet ($1) returned to rodrieliot
rodrieliot collected $2 from pot
*** SUMMARY ***
Total pot $2 | Rake $0 
Seat 3: rodrieliot (big blind) collected ($2)
Seat 6: LeoFara (button) (small blind) folded before Flop




PokerStars Game #47185793744:  Hold'em No Limit ($1/$2 USD) - 2010/07/23 23:57:55 ET
Table 'Menelaus II' 6-max Seat #4 is the button
Seat 4: mzosh ($222.15 in chips) 
Seat 5: tdiddy ($155.25 in chips) 
mzosh: posts small blind $1
tdiddy: posts big blind $2
*** HOLE CARDS ***
mzosh: folds 
Uncalled bet ($1) returned to tdiddy
tdiddy collected $2 from pot
tdiddy: doesn't show hand 
*** SUMMARY ***
Total pot $2 | Rake $0 
Seat 4: mzosh (button) (small blind) folded before Flop
Seat 5: tdiddy (big blind) collected ($2)




PokerStars Game #47185811549:  Hold'em No Limit ($1/$2 USD) - 2010/07/23 23:58:48 ET
Table 'Menelaus II' 6-max Seat #4 is the button
Seat 4: mzosh ($225.65 in chips) 
Seat 5: tdiddy ($151.25 in chips) 
mzosh: posts small blind $1
tdiddy: posts big blind $2
*** HOLE CARDS ***
mzosh: folds 
Uncalled bet ($1) returned to tdiddy
tdiddy collected $2 from pot
tdiddy: doesn't show hand 
*** SUMMARY ***
Total pot $2 | Rake $0 
Seat 4: mzosh (button) (small blind) folded before Flop
Seat 5: tdiddy (big blind) collected ($2)




PokerStars Game #47185762064:  Hold'em No Limit ($1/$2 USD) - 2010/07/23 23:56:20 ET
Table 'Pala II' 6-max Seat #5 is the button
Seat 1: Fierytycoon ($210.90 in chips) 
Seat 2: thomaswkm ($111.95 in chips) 
Seat 3: TheAwfulDin ($262.95 in chips) 
Seat 5: asseral ($200 in chips) 
Fierytycoon: posts small blind $1
thomaswkm: posts big blind $2
*** HOLE CARDS ***
TheAwfulDin: folds 
asseral: raises $3 to $5
Fierytycoon: folds 
thomaswkm: folds 
Uncalled bet ($3) returned to asseral
asseral collected $5 from pot
asseral: doesn't show hand 
*** SUMMARY ***
Total pot $5 | Rake $0 
Seat 1: Fierytycoon (small blind) folded before Flop
Seat 2: thomaswkm (big blind) folded before Flop
Seat 3: TheAwfulDin folded before Flop (didn't bet)
Seat 5: asseral (button) collected ($5)




PokerStars Game #47185754707:  Hold'em No Limit ($1/$2 USD) - 2010/07/23 23:55:58 ET
Table 'Triton III' 6-max Seat #1 is the button
Seat 1: Cardsdevil27 ($79.85 in chips) 
Seat 2: Fierytycoon ($200 in chips) 
Seat 3: Jetize ($202 in chips) 
Seat 4: thomaswkm ($356.65 in chips) 
Seat 5: DURKADURDUR ($339.30 in chips) 
Seat 6: FrAnWaN ($429.25 in chips) 
Fierytycoon: posts small blind $1
Jetize: posts big blind $2
*** HOLE CARDS ***
thomaswkm: raises $4 to $6
DURKADURDUR: folds 
FrAnWaN: folds 
Cardsdevil27: calls $6
Fierytycoon: folds 
Jetize: folds 
*** FLOP *** [Qs 6c 3c]
thomaswkm: bets $10
Cardsdevil27: calls $10
*** TURN *** [Qs 6c 3c] [9c]
thomaswkm: bets $18
Cardsdevil27: raises $18 to $36
thomaswkm: raises $18 to $54
Cardsdevil27: calls $18
*** RIVER *** [Qs 6c 3c 9c] [9d]
thomaswkm: bets $12
Cardsdevil27: calls $9.85 and is all-in
Uncalled bet ($2.15) returned to thomaswkm
*** SHOW DOWN ***
thomaswkm: shows [Kd Ks] (two pair, Kings and Nines)
Cardsdevil27: shows [Qc Qd] (a full house, Queens full of Nines)
Cardsdevil27 collected $159.70 from pot
*** SUMMARY ***
Total pot $162.70 | Rake $3 
Board [Qs 6c 3c 9c 9d]
Seat 1: Cardsdevil27 (button) showed [Qc Qd] and won ($159.70) with a full house, Queens full of Nines
Seat 2: Fierytycoon (small blind) folded before Flop
Seat 3: Jetize (big blind) folded before Flop
Seat 4: thomaswkm showed [Kd Ks] and lost with two pair, Kings and Nines
Seat 5: DURKADURDUR folded before Flop (didn't bet)
Seat 6: FrAnWaN folded before Flop (didn't bet)




PokerStars Game #47185782371:  Hold'em No Limit ($1/$2 USD) - 2010/07/23 23:57:21 ET
Table 'Pala II' 6-max Seat #2 is the button
Seat 1: Fierytycoon ($209.90 in chips) 
Seat 2: thomaswkm ($108.95 in chips) 
Seat 3: TheAwfulDin ($263.95 in chips) 
Seat 5: asseral ($203 in chips) 
TheAwfulDin: posts small blind $1
asseral: posts big blind $2
*** HOLE CARDS ***
Fierytycoon: folds 
thomaswkm: folds 
TheAwfulDin: folds 
Uncalled bet ($1) returned to asseral
asseral collected $2 from pot
asseral: doesn't show hand 
*** SUMMARY ***
Total pot $2 | Rake $0 
Seat 1: Fierytycoon folded before Flop (didn't bet)
Seat 2: thomaswkm (button) folded before Flop (didn't bet)
Seat 3: TheAwfulDin (small blind) folded before Flop
Seat 5: asseral (big blind) collected ($2)




PokerStars Game #47185778461:  Hold'em No Limit ($1/$2 USD) - 2010/07/23 23:57:09 ET
Table 'Kentaurus IV' 6-max Seat #6 is the button
Seat 1: neni85 ($260.45 in chips) 
Seat 2: DMACM ($94.75 in chips) 
Seat 3: THEDUTCH4141 ($100 in chips) 
Seat 5: LeoFara ($55.80 in chips) 
Seat 6: FlushVirus ($98.70 in chips) 
neni85: posts small blind $1
DMACM: posts big blind $2
*** HOLE CARDS ***
THEDUTCH4141: folds 
LeoFara: folds 
FlushVirus: folds 
neni85: raises $3 to $5
DMACM: folds 
Uncalled bet ($3) returned to neni85
neni85 collected $4 from pot
neni85: doesn't show hand 
*** SUMMARY ***
Total pot $4 | Rake $0 
Seat 1: neni85 (small blind) collected ($4)
Seat 2: DMACM (big blind) folded before Flop
Seat 3: THEDUTCH4141 folded before Flop (didn't bet)
Seat 5: LeoFara folded before Flop (didn't bet)
Seat 6: FlushVirus (button) folded before Flop (didn't bet)




PokerStars Game #47185773030:  Hold'em No Limit ($1/$2 USD) - 2010/07/23 23:56:53 ET
Table 'Menelaus II' 6-max Seat #1 is the button
Seat 1: LeoFara ($61.60 in chips) 
Seat 4: mzosh ($222.15 in chips) 
Seat 5: tdiddy ($160.25 in chips) 
Seat 6: sp4taxes ($65.35 in chips) 
mzosh: posts small blind $1
tdiddy: posts big blind $2
*** HOLE CARDS ***
sp4taxes: raises $2 to $4
LeoFara: folds 
mzosh: folds 
LeoFara leaves the table
tdiddy: calls $2
*** FLOP *** [4d 5c 9s]
tdiddy: checks 
sp4taxes: bets $6
tdiddy: folds 
Uncalled bet ($6) returned to sp4taxes
sp4taxes collected $8.55 from pot
sp4taxes: doesn't show hand 
*** SUMMARY ***
Total pot $9 | Rake $0.45 
Board [4d 5c 9s]
Seat 1: LeoFara (button) folded before Flop (didn't bet)
Seat 4: mzosh (small blind) folded before Flop
Seat 5: tdiddy (big blind) folded on the Flop
Seat 6: sp4taxes collected ($8.55)




PokerStars Game #47185776358:  Hold'em No Limit ($1/$2 USD) - 2010/07/23 23:57:03 ET
Table 'Shajna' 6-max Seat #1 is the button
Seat 1: neni85 ($100 in chips) 
Seat 2: bj2207 ($98 in chips) 
Seat 4: latebrake ($68.90 in chips) 
Seat 5: jimjam1979 ($43.55 in chips) 
Seat 6: AillemKall ($40.70 in chips) 
bj2207: posts small blind $1
latebrake: posts big blind $2
*** HOLE CARDS ***
jimjam1979: folds 
AillemKall: folds 
neni85: raises $3 to $5
bj2207: folds 
latebrake: calls $3
*** FLOP *** [Ks 3s 9h]
latebrake: bets $8
neni85: folds 
Uncalled bet ($8) returned to latebrake
latebrake collected $10.45 from pot
*** SUMMARY ***
Total pot $11 | Rake $0.55 
Board [Ks 3s 9h]
Seat 1: neni85 (button) folded on the Flop
Seat 2: bj2207 (small blind) folded before Flop
Seat 4: latebrake (big blind) collected ($10.45)
Seat 5: jimjam1979 folded before Flop (didn't bet)
Seat 6: AillemKall folded before Flop (didn't bet)




PokerStars Game #47185796074:  Hold'em No Limit ($1/$2 USD) - 2010/07/23 23:58:02 ET
Table 'Menelaus II' 6-max Seat #5 is the button
Seat 4: mzosh ($221.15 in chips) 
Seat 5: tdiddy ($156.25 in chips) 
tdiddy: posts small blind $1
mzosh: posts big blind $2
*** HOLE CARDS ***
JJ888168 joins the table at seat #3 
tdiddy: raises $3 to $5
mzosh: calls $3
*** FLOP *** [Jh 7c Ts]
mzosh: checks 
tdiddy: checks 
*** TURN *** [Jh 7c Ts] [Ah]
mzosh: bets $6
tdiddy: folds 
Uncalled bet ($6) returned to mzosh
mzosh collected $9.50 from pot
mzosh: doesn't show hand 
*** SUMMARY ***
Total pot $10 | Rake $0.50 
Board [Jh 7c Ts Ah]
Seat 4: mzosh (big blind) collected ($9.50)
Seat 5: tdiddy (button) (small blind) folded on the Turn




PokerStars Game #47185765898:  Hold'em No Limit ($1/$2 USD) - 2010/07/23 23:56:32 ET
Table 'Shajna' 6-max Seat #5 is the button
Seat 1: neni85 ($100 in chips) 
Seat 4: latebrake ($65.90 in chips) 
Seat 5: jimjam1979 ($40.55 in chips) 
Seat 6: AillemKall ($41.70 in chips) 
AillemKall: posts small blind $1
neni85: posts big blind $2
bj2207: sits out 
*** HOLE CARDS ***
latebrake: raises $2 to $4
jimjam1979: folds 
AillemKall: folds 
neni85: folds 
Uncalled bet ($2) returned to latebrake
latebrake collected $5 from pot
*** SUMMARY ***
Total pot $5 | Rake $0 
Seat 1: neni85 (big blind) folded before Flop
Seat 4: latebrake collected ($5)
Seat 5: jimjam1979 (button) folded before Flop (didn't bet)
Seat 6: AillemKall (small blind) folded before Flop




PokerStars Game #47185775964:  Hold'em No Limit ($1/$2 USD) - 2010/07/23 23:57:02 ET
Table 'Laodica' 6-max Seat #4 is the button
Seat 2: LeoFara ($40 in chips) 
Seat 3: jimjam1979 ($38 in chips) 
Seat 4: BlindFlying ($93.20 in chips) 
Seat 5: rodrieliot ($58.60 in chips) 
Seat 6: JuStBLaZe908 ($321.70 in chips) 
rodrieliot: posts small blind $1
JuStBLaZe908: posts big blind $2
*** HOLE CARDS ***
LeoFara: folds 
jimjam1979: folds 
BlindFlying: folds 
rodrieliot: folds 
Uncalled bet ($1) returned to JuStBLaZe908
JuStBLaZe908 collected $2 from pot
*** SUMMARY ***
Total pot $2 | Rake $0 
Seat 2: LeoFara folded before Flop (didn't bet)
Seat 3: jimjam1979 folded before Flop (didn't bet)
Seat 4: BlindFlying (button) folded before Flop (didn't bet)
Seat 5: rodrieliot (small blind) folded before Flop
Seat 6: JuStBLaZe908 (big blind) collected ($2)




PokerStars Game #47185808951:  Hold'em No Limit ($1/$2 USD) - 2010/07/23 23:58:40 ET
Table 'Phereclos II' 6-max Seat #3 is the button
Seat 1: mpolice2010 ($51.55 in chips) 
Seat 2: sp4taxes ($69.90 in chips) 
Seat 3: ILS16L ($130.10 in chips) 
Seat 4: mpm135 ($458.45 in chips) 
Seat 5: TexasSooner2 ($99.55 in chips) 
mpm135: posts small blind $1
TexasSooner2: posts big blind $2
beargood: sits out 
sp4taxes: posts big blind $2
*** HOLE CARDS ***
mpolice2010: folds 
sp4taxes: raises $2 to $4
ILS16L: folds 
mpm135: folds 
TexasSooner2: folds 
Uncalled bet ($2) returned to sp4taxes
sp4taxes collected $5 from pot
sp4taxes: doesn't show hand 
*** SUMMARY ***
Total pot $5 | Rake $0 
Seat 1: mpolice2010 folded before Flop (didn't bet)
Seat 2: sp4taxes collected ($5)
Seat 3: ILS16L (button) folded before Flop (didn't bet)
Seat 4: mpm135 (small blind) folded before Flop
Seat 5: TexasSooner2 (big blind) folded before Flop




PokerStars Game #47185753496:  Hold'em No Limit ($1/$2 USD) - 2010/07/23 23:55:54 ET
Table 'Margo II' 6-max Seat #1 is the button
Seat 1: wheels6990 ($40.90 in chips) 
Seat 2: AillemKall ($32 in chips) 
Seat 3: crock41 ($32.10 in chips) 
Seat 4: WizardOfAhhs ($81.35 in chips) 
Seat 5: AironVega ($50.25 in chips) 
Seat 6: JLS1956 ($74.30 in chips) 
AillemKall: posts small blind $1
crock41: posts big blind $2
*** HOLE CARDS ***
WizardOfAhhs: raises $2.10 to $4.10
AironVega: folds 
JLS1956: calls $4.10
wheels6990: folds 
AillemKall: folds 
crock41: calls $2.10
*** FLOP *** [7c 3d 6s]
crock41: checks 
WizardOfAhhs: checks 
JLS1956: checks 
*** TURN *** [7c 3d 6s] [Ad]
crock41: checks 
WizardOfAhhs: bets $6.30
JLS1956: calls $6.30
crock41: folds 
*** RIVER *** [7c 3d 6s Ad] [Th]
WizardOfAhhs: bets $32.70
JLS1956: folds 
Uncalled bet ($32.70) returned to WizardOfAhhs
WizardOfAhhs collected $24.65 from pot
WizardOfAhhs: doesn't show hand 
*** SUMMARY ***
Total pot $25.90 | Rake $1.25 
Board [7c 3d 6s Ad Th]
Seat 1: wheels6990 (button) folded before Flop (didn't bet)
Seat 2: AillemKall (small blind) folded before Flop
Seat 3: crock41 (big blind) folded on the Turn
Seat 4: WizardOfAhhs collected ($24.65)
Seat 5: AironVega folded before Flop (didn't bet)
Seat 6: JLS1956 folded on the River




PokerStars Game #47185737343:  Hold'em No Limit ($1/$2 USD) - 2010/07/23 23:55:06 ET
Table 'Laodica' 6-max Seat #6 is the button
Seat 2: LeoFara ($40 in chips) 
Seat 3: jimjam1979 ($41 in chips) 
Seat 4: BlindFlying ($107.20 in chips) 
Seat 5: rodrieliot ($57.60 in chips) 
Seat 6: JuStBLaZe908 ($267.70 in chips) 
LeoFara: posts small blind $1
jimjam1979: posts big blind $2
*** HOLE CARDS ***
BlindFlying: raises $2 to $4
rodrieliot: folds 
JuStBLaZe908: raises $7 to $11
LeoFara: calls $10
jimjam1979: folds 
BlindFlying: calls $7
*** FLOP *** [3h Jc 5c]
LeoFara: checks 
BlindFlying: checks 
JuStBLaZe908: bets $29
LeoFara: calls $29 and is all-in
BlindFlying: folds 
*** TURN *** [3h Jc 5c] [Qs]
*** RIVER *** [3h Jc 5c Qs] [4h]
*** SHOW DOWN ***
LeoFara: shows [9s 9c] (a pair of Nines)
JuStBLaZe908: shows [Ks Kh] (a pair of Kings)
JuStBLaZe908 collected $91 from pot
*** SUMMARY ***
Total pot $93 | Rake $2 
Board [3h Jc 5c Qs 4h]
Seat 2: LeoFara (small blind) showed [9s 9c] and lost with a pair of Nines
Seat 3: jimjam1979 (big blind) folded before Flop
Seat 4: BlindFlying folded on the Flop
Seat 5: rodrieliot folded before Flop (didn't bet)
Seat 6: JuStBLaZe908 (button) showed [Ks Kh] and won ($91) with a pair of Kings




PokerStars Game #47185814004:  Hold'em No Limit ($1/$2 USD) - 2010/07/23 23:58:55 ET
Table 'Vitja' 6-max Seat #3 is the button
Seat 3: rodrieliot ($37 in chips) 
Seat 6: LeoFara ($43.80 in chips) 
rodrieliot: posts small blind $1
LeoFara: posts big blind $2
*** HOLE CARDS ***
rodrieliot: raises $4 to $6
LeoFara: folds 
Uncalled bet ($4) returned to rodrieliot
rodrieliot collected $4 from pot
emilpetten is connected 
*** SUMMARY ***
Total pot $4 | Rake $0 
Seat 3: rodrieliot (button) (small blind) collected ($4)
Seat 6: LeoFara (big blind) folded before Flop




PokerStars Game #47185796328:  Hold'em No Limit ($1/$2 USD) - 2010/07/23 23:58:02 ET
Table 'Pavo' 6-max Seat #2 is the button
Seat 1: dajatt13 ($285.65 in chips) 
Seat 2: FrAnWaN ($391.90 in chips) 
Seat 3: FastEddie267 ($200 in chips) 
Seat 4: thomaswkm ($119.25 in chips) 
Seat 5: THEDUTCH4141 ($208.25 in chips) 
Seat 6: TheAwfulDin ($231.50 in chips) 
FastEddie267: posts small blind $1
thomaswkm: posts big blind $2
*** HOLE CARDS ***
THEDUTCH4141: folds 
TheAwfulDin: folds 
dajatt13: raises $4 to $6
FrAnWaN: folds 
FastEddie267: folds 
thomaswkm: calls $4
*** FLOP *** [Td Kc 6s]
thomaswkm: checks 
dajatt13: bets $8
thomaswkm: folds 
Uncalled bet ($8) returned to dajatt13
dajatt13 collected $12.35 from pot
dajatt13: doesn't show hand 
*** SUMMARY ***
Total pot $13 | Rake $0.65 
Board [Td Kc 6s]
Seat 1: dajatt13 collected ($12.35)
Seat 2: FrAnWaN (button) folded before Flop (didn't bet)
Seat 3: FastEddie267 (small blind) folded before Flop
Seat 4: thomaswkm (big blind) folded on the Flop
Seat 5: THEDUTCH4141 folded before Flop (didn't bet)
Seat 6: TheAwfulDin folded before Flop (didn't bet)




PokerStars Game #47185740528:  Hold'em No Limit ($1/$2 USD) - 2010/07/23 23:55:15 ET
Table 'Wilhelmina' 6-max Seat #1 is the button
Seat 1: jaeh00d ($200 in chips) 
Seat 2: DMACM ($89 in chips) 
Seat 3: THEDUTCH4141 ($200 in chips) 
Seat 4: richard175 ($73.10 in chips) 
Seat 5: TODO ADENTR0 ($295.30 in chips) 
Seat 6: hellokittery ($216.95 in chips) 
DMACM: posts small blind $1
THEDUTCH4141: posts big blind $2
*** HOLE CARDS ***
richard175: calls $2
TODO ADENTR0: folds 
hellokittery: folds 
jaeh00d: folds 
DMACM: folds 
THEDUTCH4141: checks 
*** FLOP *** [Ac 8s Qh]
THEDUTCH4141: checks 
richard175: checks 
*** TURN *** [Ac 8s Qh] [Tc]
THEDUTCH4141: checks 
richard175: bets $4
THEDUTCH4141: folds 
Uncalled bet ($4) returned to richard175
richard175 collected $4.75 from pot
*** SUMMARY ***
Total pot $5 | Rake $0.25 
Board [Ac 8s Qh Tc]
Seat 1: jaeh00d (button) folded before Flop (didn't bet)
Seat 2: DMACM (small blind) folded before Flop
Seat 3: THEDUTCH4141 (big blind) folded on the Turn
Seat 4: richard175 collected ($4.75)
Seat 5: TODO ADENTR0 folded before Flop (didn't bet)
Seat 6: hellokittery folded before Flop (didn't bet)




PokerStars Game #47185753143:  Hold'em No Limit ($1/$2 USD) - 2010/07/23 23:55:53 ET
Table 'Malabar III' 6-max Seat #5 is the button
Seat 1: imthesky ($376 in chips) 
Seat 2: TODO ADENTR0 ($236 in chips) 
Seat 3: leukehond ($203 in chips) 
Seat 4: hellokittery ($200 in chips) 
Seat 5: MooMooTin ($113.30 in chips) 
Seat 6: DURKADURDUR ($383.20 in chips) 
DURKADURDUR: posts small blind $1
imthesky: posts big blind $2
*** HOLE CARDS ***
TODO ADENTR0: folds 
leukehond: folds 
hellokittery: folds 
MooMooTin: calls $2
DURKADURDUR: folds 
imthesky: checks 
*** FLOP *** [8h Td 8c]
imthesky: checks 
MooMooTin: checks 
*** TURN *** [8h Td 8c] [Jd]
imthesky: folds 
imthesky leaves the table
MooMooTin collected $4.75 from pot
*** SUMMARY ***
Total pot $5 | Rake $0.25 
Board [8h Td 8c Jd]
Seat 1: imthesky (big blind) folded on the Turn
Seat 2: TODO ADENTR0 folded before Flop (didn't bet)
Seat 3: leukehond folded before Flop (didn't bet)
Seat 4: hellokittery folded before Flop (didn't bet)
Seat 5: MooMooTin (button) collected ($4.75)
Seat 6: DURKADURDUR (small blind) folded before Flop




PokerStars Game #47185804036:  Hold'em No Limit ($1/$2 USD) - 2010/07/23 23:58:25 ET
Table 'Sonja' 6-max Seat #3 is the button
Seat 1: leukehond ($201 in chips) 
Seat 2: Cubsfan28 ($200 in chips) 
Seat 3: smartystevel ($198.80 in chips) 
mib443 will be allowed to play after the button
leukehond: posts small blind $1
Cubsfan28: posts big blind $2
*** HOLE CARDS ***
smartystevel: calls $2
leukehond: folds 
Cubsfan28: checks 
*** FLOP *** [8h 6h 7c]
Cubsfan28: bets $4
smartystevel: calls $4
*** TURN *** [8h 6h 7c] [7s]
Cubsfan28: checks 
smartystevel: checks 
*** RIVER *** [8h 6h 7c 7s] [5h]
Cubsfan28: checks 
smartystevel: checks 
*** SHOW DOWN ***
Cubsfan28: shows [3s 3d] (two pair, Sevens and Threes)
smartystevel: shows [5s As] (two pair, Sevens and Fives)
smartystevel collected $12.40 from pot
*** SUMMARY ***
Total pot $13 | Rake $0.60 
Board [8h 6h 7c 7s 5h]
Seat 1: leukehond (small blind) folded before Flop
Seat 2: Cubsfan28 (big blind) showed [3s 3d] and lost with two pair, Sevens and Threes
Seat 3: smartystevel (button) showed [5s As] and won ($12.40) with two pair, Sevens and Fives




PokerStars Game #47185745014:  Hold'em No Limit ($1/$2 USD) - 2010/07/23 23:55:29 ET
Table 'Katanga II' 6-max Seat #6 is the button
Seat 1: beargood ($141.70 in chips) 
Seat 2: generaaltrab ($132.55 in chips) 
Seat 3: BounceSower ($39.70 in chips) 
Seat 4: kaomaaje ($36 in chips) 
Seat 5: Revolucion51 ($193.50 in chips) 
Seat 6: neni85 ($102.65 in chips) 
beargood: posts small blind $1
generaaltrab: posts big blind $2
*** HOLE CARDS ***
BounceSower: folds 
kaomaaje: raises $2 to $4
Revolucion51: folds 
neni85: folds 
beargood: folds 
generaaltrab: calls $2
*** FLOP *** [9c Tc 5h]
generaaltrab: checks 
kaomaaje: bets $32 and is all-in
generaaltrab: folds 
Uncalled bet ($32) returned to kaomaaje
kaomaaje collected $8.55 from pot
*** SUMMARY ***
Total pot $9 | Rake $0.45 
Board [9c Tc 5h]
Seat 1: beargood (small blind) folded before Flop
Seat 2: generaaltrab (big blind) folded on the Flop
Seat 3: BounceSower folded before Flop (didn't bet)
Seat 4: kaomaaje collected ($8.55)
Seat 5: Revolucion51 folded before Flop (didn't bet)
Seat 6: neni85 (button) folded before Flop (didn't bet)




PokerStars Game #47185779512:  Hold'em No Limit ($1/$2 USD) - 2010/07/23 23:57:12 ET
Table 'Laocoon III' 6-max Seat #2 is the button
Seat 1: 1tormentor ($294.35 in chips) 
Seat 2: angryjamman ($162.85 in chips) 
Seat 3: TODO ADENTR0 ($219.90 in chips) 
Seat 4: Fierytycoon ($200 in chips) 
Seat 5: DURKADURDUR ($200 in chips) 
Seat 6: FrAnWaN ($333.45 in chips) 
TODO ADENTR0: posts small blind $1
Fierytycoon: posts big blind $2
*** HOLE CARDS ***
DURKADURDUR: folds 
FrAnWaN: raises $4 to $6
1tormentor: folds 
angryjamman: calls $6
TODO ADENTR0: folds 
Fierytycoon: folds 
*** FLOP *** [2d 5h Qd]
FrAnWaN: bets $10
angryjamman: raises $30 to $40
FrAnWaN: folds 
Uncalled bet ($30) returned to angryjamman
angryjamman collected $33.30 from pot
*** SUMMARY ***
Total pot $35 | Rake $1.70 
Board [2d 5h Qd]
Seat 1: 1tormentor folded before Flop (didn't bet)
Seat 2: angryjamman (button) collected ($33.30)
Seat 3: TODO ADENTR0 (small blind) folded before Flop
Seat 4: Fierytycoon (big blind) folded before Flop
Seat 5: DURKADURDUR folded before Flop (didn't bet)
Seat 6: FrAnWaN folded on the Flop




PokerStars Game #47185745762:  Hold'em No Limit ($1/$2 USD) - 2010/07/23 23:55:31 ET
Table 'Regulus' 6-max Seat #2 is the button
Seat 1: FrAnWaN ($245.05 in chips) 
Seat 2: Fierytycoon ($204.70 in chips) 
Seat 3: TODO ADENTR0 ($382.95 in chips) 
Seat 4: thomaswkm ($268.40 in chips) 
Seat 5: DURKADURDUR ($426.40 in chips) 
Seat 6: Rush51 ($78.80 in chips) 
TODO ADENTR0: posts small blind $1
thomaswkm: posts big blind $2
*** HOLE CARDS ***
DURKADURDUR: folds 
Rush51: calls $2
FrAnWaN: folds 
Fierytycoon: raises $5 to $7
TODO ADENTR0: folds 
thomaswkm: folds 
Rush51: calls $5
*** FLOP *** [8s 4s 8d]
Rush51: checks 
Fierytycoon: bets $12
Rush51: folds 
Uncalled bet ($12) returned to Fierytycoon
Fierytycoon collected $16.15 from pot
Fierytycoon: doesn't show hand 
*** SUMMARY ***
Total pot $17 | Rake $0.85 
Board [8s 4s 8d]
Seat 1: FrAnWaN folded before Flop (didn't bet)
Seat 2: Fierytycoon (button) collected ($16.15)
Seat 3: TODO ADENTR0 (small blind) folded before Flop
Seat 4: thomaswkm (big blind) folded before Flop
Seat 5: DURKADURDUR folded before Flop (didn't bet)
Seat 6: Rush51 folded on the Flop




PokerStars Game #47185767940:  Hold'em No Limit ($1/$2 USD) - 2010/07/23 23:56:38 ET
Table 'Neckar VII' 6-max Seat #1 is the button
Seat 1: Marker275 ($193.10 in chips) 
Seat 2: DURKADURDUR ($285.10 in chips) 
Seat 3: TODO ADENTR0 ($398.25 in chips) 
Seat 4: THEDUTCH4141 ($211.55 in chips) 
Seat 5: imthesky ($214.65 in chips) 
Seat 6: botano ($100 in chips) 
DURKADURDUR: posts small blind $1
TODO ADENTR0: posts big blind $2
*** HOLE CARDS ***
THEDUTCH4141: folds 
imthesky: raises $6 to $8
botano: folds 
Marker275: folds 
DURKADURDUR: folds 
TODO ADENTR0: folds 
Uncalled bet ($6) returned to imthesky
imthesky collected $5 from pot
imthesky: doesn't show hand 
*** SUMMARY ***
Total pot $5 | Rake $0 
Seat 1: Marker275 (button) folded before Flop (didn't bet)
Seat 2: DURKADURDUR (small blind) folded before Flop
Seat 3: TODO ADENTR0 (big blind) folded before Flop
Seat 4: THEDUTCH4141 folded before Flop (didn't bet)
Seat 5: imthesky collected ($5)
Seat 6: botano folded before Flop (didn't bet)




PokerStars Game #47185753996:  Hold'em No Limit ($1/$2 USD) - 2010/07/23 23:55:56 ET
Table 'Luscinia' 6-max Seat #6 is the button
Seat 1: AillemKall ($33.30 in chips) 
Seat 2: JDVC ($59.95 in chips) 
Seat 3: rodrieliot ($50.25 in chips) 
Seat 4: ILS16L ($78.65 in chips) 
Seat 5: Clabby01 ($96.70 in chips) 
Seat 6: sebass911 ($102.30 in chips) 
AillemKall: posts small blind $1
JDVC: posts big blind $2
*** HOLE CARDS ***
rodrieliot: folds 
ILS16L: folds 
Clabby01: raises $2 to $4
sebass911: folds 
AillemKall: raises $29.30 to $33.30 and is all-in
JDVC: folds 
Clabby01: folds 
Uncalled bet ($29.30) returned to AillemKall
AillemKall collected $10 from pot
AillemKall: doesn't show hand 
*** SUMMARY ***
Total pot $10 | Rake $0 
Seat 1: AillemKall (small blind) collected ($10)
Seat 2: JDVC (big blind) folded before Flop
Seat 3: rodrieliot folded before Flop (didn't bet)
Seat 4: ILS16L folded before Flop (didn't bet)
Seat 5: Clabby01 folded before Flop
Seat 6: sebass911 (button) folded before Flop (didn't bet)




PokerStars Game #47185727925:  Hold'em No Limit ($1/$2 USD) - 2010/07/23 23:54:44 ET
Table 'Pala II' 6-max Seat #4 is the button
Seat 1: Fierytycoon ($204.55 in chips) 
Seat 2: thomaswkm ($111.95 in chips) 
Seat 3: TheAwfulDin ($268.95 in chips) 
Seat 4: serj14 ($308.70 in chips) 
Seat 5: asseral ($200 in chips) 
asseral: posts small blind $1
Fierytycoon: posts big blind $2
*** HOLE CARDS ***
thomaswkm: folds 
TheAwfulDin: raises $4 to $6
serj14 has timed out
serj14: folds 
asseral: folds 
Fierytycoon: calls $4
*** FLOP *** [Ts 3c 5s]
Fierytycoon: bets $8
TheAwfulDin: folds 
Uncalled bet ($8) returned to Fierytycoon
Fierytycoon collected $12.35 from pot
Fierytycoon: doesn't show hand 
*** SUMMARY ***
Total pot $13 | Rake $0.65 
Board [Ts 3c 5s]
Seat 1: Fierytycoon (big blind) collected ($12.35)
Seat 2: thomaswkm folded before Flop (didn't bet)
Seat 3: TheAwfulDin folded on the Flop
Seat 4: serj14 (button) folded before Flop (didn't bet)
Seat 5: asseral (small blind) folded before Flop




PokerStars Game #47185742877:  Hold'em No Limit ($1/$2 USD) - 2010/07/23 23:55:22 ET
Table 'Thoas' 6-max Seat #2 is the button
Seat 1: mdeckND ($284.20 in chips) 
Seat 2: DURKADURDUR ($702.25 in chips) 
Seat 4: mojox ($61 in chips) 
Seat 5: FrAnWaN ($322.50 in chips) 
Seat 6: asseral ($235.60 in chips) 
mojox: posts small blind $1
FrAnWaN: posts big blind $2
*** HOLE CARDS ***
asseral: raises $5 to $7
mdeckND: folds 
DURKADURDUR: folds 
mojox: calls $6
Jetize leaves the table
FrAnWaN: folds 
*** FLOP *** [2s Tc Th]
mojox: checks 
asseral: bets $8
mojox: folds 
Uncalled bet ($8) returned to asseral
TODO ADENTR0 joins the table at seat #3 
asseral collected $15.20 from pot
asseral: doesn't show hand 
*** SUMMARY ***
Total pot $16 | Rake $0.80 
Board [2s Tc Th]
Seat 1: mdeckND folded before Flop (didn't bet)
Seat 2: DURKADURDUR (button) folded before Flop (didn't bet)
Seat 4: mojox (small blind) folded on the Flop
Seat 5: FrAnWaN (big blind) folded before Flop
Seat 6: asseral collected ($15.20)




PokerStars Game #47185750020:  Hold'em No Limit ($1/$2 USD) - 2010/07/23 23:55:44 ET
Table 'Lonnrot III' 6-max Seat #4 is the button
Seat 1: THEDUTCH4141 ($203 in chips) 
Seat 2: Duke_Moto ($210.95 in chips) 
Seat 3: DURKADURDUR ($211.45 in chips) 
Seat 4: imthesky ($221.30 in chips) 
Seat 5: dajatt13 ($341 in chips) 
Seat 6: FrAnWaN ($277.75 in chips) 
dajatt13: posts small blind $1
FrAnWaN: posts big blind $2
*** HOLE CARDS ***
THEDUTCH4141: folds 
Duke_Moto: folds 
DURKADURDUR: folds 
imthesky: raises $6 to $8
dajatt13: folds 
FrAnWaN: folds 
Uncalled bet ($6) returned to imthesky
imthesky collected $5 from pot
imthesky: doesn't show hand 
imthesky leaves the table
*** SUMMARY ***
Total pot $5 | Rake $0 
Seat 1: THEDUTCH4141 folded before Flop (didn't bet)
Seat 2: Duke_Moto folded before Flop (didn't bet)
Seat 3: DURKADURDUR folded before Flop (didn't bet)
Seat 4: imthesky (button) collected ($5)
Seat 5: dajatt13 (small blind) folded before Flop
Seat 6: FrAnWaN (big blind) folded before Flop




PokerStars Game #47185758171:  Hold'em No Limit ($1/$2 USD) - 2010/07/23 23:56:08 ET
Table 'Orthosie II' 6-max Seat #5 is the button
Seat 1: neni85 ($504.45 in chips) 
Seat 2: harujongil ($92.65 in chips) 
Seat 4: spiderfrank ($96.10 in chips) 
Seat 5: LeoFara ($43.40 in chips) 
Seat 6: onitsuaf ($63.65 in chips) 
onitsuaf: posts small blind $1
neni85: posts big blind $2
*** HOLE CARDS ***
harujongil: folds 
spiderfrank: folds 
LeoFara: folds 
onitsuaf: raises $2 to $4
neni85: calls $2
*** FLOP *** [4h 2s 4d]
onitsuaf: checks 
neni85: checks 
*** TURN *** [4h 2s 4d] [As]
onitsuaf: bets $4
neni85: calls $4
*** RIVER *** [4h 2s 4d As] [Jc]
onitsuaf: bets $10
neni85: calls $10
*** SHOW DOWN ***
onitsuaf: shows [Jh Ac] (two pair, Aces and Jacks)
neni85: mucks hand 
onitsuaf collected $34.25 from pot
*** SUMMARY ***
Total pot $36 | Rake $1.75 
Board [4h 2s 4d As Jc]
Seat 1: neni85 (big blind) mucked
Seat 2: harujongil folded before Flop (didn't bet)
Seat 4: spiderfrank folded before Flop (didn't bet)
Seat 5: LeoFara (button) folded before Flop (didn't bet)
Seat 6: onitsuaf (small blind) showed [Jh Ac] and won ($34.25) with two pair, Aces and Jacks




PokerStars Game #47185776849:  Hold'em No Limit ($1/$2 USD) - 2010/07/23 23:57:04 ET
Table 'Neckar VII' 6-max Seat #2 is the button
Seat 1: Marker275 ($193.10 in chips) 
Seat 2: DURKADURDUR ($284.10 in chips) 
Seat 3: TODO ADENTR0 ($396.25 in chips) 
Seat 4: THEDUTCH4141 ($211.55 in chips) 
Seat 5: imthesky ($217.65 in chips) 
Seat 6: botano ($100 in chips) 
TODO ADENTR0: posts small blind $1
THEDUTCH4141: posts big blind $2
*** HOLE CARDS ***
imthesky: folds 
imthesky leaves the table
botano: folds 
Marker275: raises $4 to $6
DURKADURDUR: calls $6
TODO ADENTR0: folds 
FastEddie267 joins the table at seat #5 
THEDUTCH4141: folds 
*** FLOP *** [4d 6d 4s]
Marker275: bets $8
DURKADURDUR: folds 
Uncalled bet ($8) returned to Marker275
Marker275 collected $14.25 from pot
Marker275: doesn't show hand 
*** SUMMARY ***
Total pot $15 | Rake $0.75 
Board [4d 6d 4s]
Seat 1: Marker275 collected ($14.25)
Seat 2: DURKADURDUR (button) folded on the Flop
Seat 3: TODO ADENTR0 (small blind) folded before Flop
Seat 4: THEDUTCH4141 (big blind) folded before Flop
Seat 5: imthesky folded before Flop (didn't bet)
Seat 6: botano folded before Flop (didn't bet)




PokerStars Game #47185741738:  Hold'em No Limit ($1/$2 USD) - 2010/07/23 23:55:19 ET
Table 'Ottegebe' 6-max Seat #6 is the button
Seat 2: picasso264 ($52.65 in chips) 
Seat 3: AironVega ($36 in chips) 
Seat 4: DMACM ($124.45 in chips) 
Seat 6: jimjam1979 ($33 in chips) 
picasso264: posts small blind $1
AironVega: posts big blind $2
*** HOLE CARDS ***
DMACM: folds 
jimjam1979: folds 
HT52 joins the table at seat #5 
picasso264: raises $2 to $4
AironVega: calls $2
*** FLOP *** [Kh 3s 8h]
picasso264 has timed out
picasso264: checks 
AironVega: bets $4.70
picasso264: calls $4.70
*** TURN *** [Kh 3s 8h] [4h]
picasso264: bets $4
AironVega: raises $23.30 to $27.30 and is all-in
picasso264: calls $23.30
*** RIVER *** [Kh 3s 8h 4h] [2d]
*** SHOW DOWN ***
picasso264: shows [Qd Ah] (high card Ace)
AironVega: shows [Kc Td] (a pair of Kings)
AironVega collected $70 from pot
*** SUMMARY ***
Total pot $72 | Rake $2 
Board [Kh 3s 8h 4h 2d]
Seat 2: picasso264 (small blind) showed [Qd Ah] and lost with high card Ace
Seat 3: AironVega (big blind) showed [Kc Td] and won ($70) with a pair of Kings
Seat 4: DMACM folded before Flop (didn't bet)
Seat 6: jimjam1979 (button) folded before Flop (didn't bet)




PokerStars Game #47185754341:  Hold'em No Limit ($1/$2 USD) - 2010/07/23 23:55:57 ET
Table 'Sibylla II' 6-max Seat #5 is the button
Seat 1: LeoFara ($51.35 in chips) 
Seat 2: AironVega ($26.70 in chips) 
Seat 3: jimjam1979 ($39.85 in chips) 
Seat 4: sp4taxes ($67.35 in chips) 
Seat 5: BlindFlying ($206.30 in chips) 
Seat 6: tradan ($48.80 in chips) 
tradan: posts small blind $1
LeoFara: posts big blind $2
*** HOLE CARDS ***
AironVega: folds 
jimjam1979: folds 
sp4taxes: calls $2
BlindFlying: folds 
tradan: calls $1
LeoFara: checks 
*** FLOP *** [8d Qh 2s]
tradan: checks 
LeoFara: checks 
sp4taxes: checks 
*** TURN *** [8d Qh 2s] [Jc]
tradan: checks 
LeoFara: checks 
sp4taxes: checks 
*** RIVER *** [8d Qh 2s Jc] [3h]
tradan: bets $4
LeoFara: folds 
sp4taxes: folds 
Uncalled bet ($4) returned to tradan
tradan collected $5.70 from pot
*** SUMMARY ***
Total pot $6 | Rake $0.30 
Board [8d Qh 2s Jc 3h]
Seat 1: LeoFara (big blind) folded on the River
Seat 2: AironVega folded before Flop (didn't bet)
Seat 3: jimjam1979 folded before Flop (didn't bet)
Seat 4: sp4taxes folded on the River
Seat 5: BlindFlying (button) folded before Flop (didn't bet)
Seat 6: tradan (small blind) collected ($5.70)




PokerStars Game #47185805003:  Hold'em No Limit ($1/$2 USD) - 2010/07/23 23:58:28 ET
Table 'Wilhelmina' 6-max Seat #5 is the button
Seat 1: jaeh00d ($216.30 in chips) 
Seat 2: DMACM ($91 in chips) 
Seat 3: THEDUTCH4141 ($200 in chips) 
Seat 4: richard175 ($60.65 in chips) 
Seat 5: TODO ADENTR0 ($292.30 in chips) 
Seat 6: hellokittery ($214.95 in chips) 
hellokittery: posts small blind $1
jaeh00d: posts big blind $2
*** HOLE CARDS ***
DMACM: folds 
THEDUTCH4141: raises $4 to $6
richard175: calls $6
TODO ADENTR0: folds 
hellokittery: folds 
jaeh00d: folds 
*** FLOP *** [7h 8c Ah]
THEDUTCH4141: bets $10
richard175: calls $10
*** TURN *** [7h 8c Ah] [6h]
THEDUTCH4141: bets $24
richard175: folds 
Uncalled bet ($24) returned to THEDUTCH4141
THEDUTCH4141 collected $33.30 from pot
THEDUTCH4141: doesn't show hand 
*** SUMMARY ***
Total pot $35 | Rake $1.70 
Board [7h 8c Ah 6h]
Seat 1: jaeh00d (big blind) folded before Flop
Seat 2: DMACM folded before Flop (didn't bet)
Seat 3: THEDUTCH4141 collected ($33.30)
Seat 4: richard175 folded on the Turn
Seat 5: TODO ADENTR0 (button) folded before Flop (didn't bet)
Seat 6: hellokittery (small blind) folded before Flop




PokerStars Game #47185768752:  Hold'em No Limit ($1/$2 USD) - 2010/07/23 23:56:40 ET
Table 'Pala II' 6-max Seat #1 is the button
Seat 1: Fierytycoon ($209.90 in chips) 
Seat 2: thomaswkm ($109.95 in chips) 
Seat 3: TheAwfulDin ($262.95 in chips) 
Seat 5: asseral ($203 in chips) 
thomaswkm: posts small blind $1
TheAwfulDin: posts big blind $2
*** HOLE CARDS ***
asseral: folds 
Fierytycoon: folds 
thomaswkm: folds 
Uncalled bet ($1) returned to TheAwfulDin
TheAwfulDin collected $2 from pot
TheAwfulDin: doesn't show hand 
*** SUMMARY ***
Total pot $2 | Rake $0 
Seat 1: Fierytycoon (button) folded before Flop (didn't bet)
Seat 2: thomaswkm (small blind) folded before Flop
Seat 3: TheAwfulDin (big blind) collected ($2)
Seat 5: asseral folded before Flop (didn't bet)




PokerStars Game #47185776411:  Hold'em No Limit ($1/$2 USD) - 2010/07/23 23:57:03 ET
Table 'Vitja' 6-max Seat #6 is the button
Seat 2: Don brujo ($32.90 in chips) 
Seat 3: rodrieliot ($39 in chips) 
Seat 4: emilpetten ($35.25 in chips) 
Seat 6: LeoFara ($43.80 in chips) 
Don brujo: posts small blind $1
rodrieliot: posts big blind $2
*** HOLE CARDS ***
emilpetten: raises $4 to $6
LeoFara: folds 
Don brujo: folds 
rodrieliot: folds 
Uncalled bet ($4) returned to emilpetten
emilpetten collected $5 from pot
emilpetten: doesn't show hand 
*** SUMMARY ***
Total pot $5 | Rake $0 
Seat 2: Don brujo (small blind) folded before Flop
Seat 3: rodrieliot (big blind) folded before Flop
Seat 4: emilpetten collected ($5)
Seat 6: LeoFara (button) folded before Flop (didn't bet)




PokerStars Game #47185770415:  Hold'em No Limit ($1/$2 USD) - 2010/07/23 23:56:45 ET
Table 'Shajna' 6-max Seat #6 is the button
Seat 1: neni85 ($100 in chips) 
Seat 2: bj2207 ($100 in chips) 
Seat 4: latebrake ($68.90 in chips) 
Seat 5: jimjam1979 ($40.55 in chips) 
Seat 6: AillemKall ($40.70 in chips) 
neni85: posts small blind $1
bj2207: posts big blind $2
*** HOLE CARDS ***
latebrake: folds 
jimjam1979: raises $2 to $4
AillemKall: folds 
neni85: folds 
bj2207: folds 
Uncalled bet ($2) returned to jimjam1979
jimjam1979 collected $5 from pot
jimjam1979: doesn't show hand 
*** SUMMARY ***
Total pot $5 | Rake $0 
Seat 1: neni85 (small blind) folded before Flop
Seat 2: bj2207 (big blind) folded before Flop
Seat 4: latebrake folded before Flop (didn't bet)
Seat 5: jimjam1979 collected ($5)
Seat 6: AillemKall (button) folded before Flop (didn't bet)




PokerStars Game #47185767662:  Hold'em No Limit ($1/$2 USD) - 2010/07/23 23:56:37 ET
Table 'Rafita IV' 6-max Seat #5 is the button
Seat 1: neni85 ($160.10 in chips) 
Seat 2: NewEra760 ($68.75 in chips) 
Seat 3: AillemKall ($50.80 in chips) 
Seat 5: jimjam1979 ($40.15 in chips) 
Seat 6: Ricko7456 ($157.55 in chips) 
Ricko7456: posts small blind $1
neni85: posts big blind $2
*** HOLE CARDS ***
NewEra760: folds 
AillemKall: folds 
jimjam1979: folds 
Ricko7456: raises $2 to $4
neni85: folds 
Uncalled bet ($2) returned to Ricko7456
Ricko7456 collected $4 from pot
*** SUMMARY ***
Total pot $4 | Rake $0 
Seat 1: neni85 (big blind) folded before Flop
Seat 2: NewEra760 folded before Flop (didn't bet)
Seat 3: AillemKall folded before Flop (didn't bet)
Seat 5: jimjam1979 (button) folded before Flop (didn't bet)
Seat 6: Ricko7456 (small blind) collected ($4)




PokerStars Game #47185771588:  Hold'em No Limit ($1/$2 USD) - 2010/07/23 23:56:49 ET
Table 'Laodica' 6-max Seat #3 is the button
Seat 2: LeoFara ($40 in chips) 
Seat 3: jimjam1979 ($38 in chips) 
Seat 4: BlindFlying ($94.20 in chips) 
Seat 5: rodrieliot ($57.60 in chips) 
Seat 6: JuStBLaZe908 ($321.70 in chips) 
BlindFlying: posts small blind $1
rodrieliot: posts big blind $2
*** HOLE CARDS ***
JuStBLaZe908: folds 
LeoFara: folds 
jimjam1979: folds 
BlindFlying: folds 
Uncalled bet ($1) returned to rodrieliot
rodrieliot collected $2 from pot
*** SUMMARY ***
Total pot $2 | Rake $0 
Seat 2: LeoFara folded before Flop (didn't bet)
Seat 3: jimjam1979 (button) folded before Flop (didn't bet)
Seat 4: BlindFlying (small blind) folded before Flop
Seat 5: rodrieliot (big blind) collected ($2)
Seat 6: JuStBLaZe908 folded before Flop (didn't bet)




PokerStars Game #47185743986:  Hold'em No Limit ($1/$2 USD) - 2010/07/23 23:55:26 ET
Table 'Laocoon III' 6-max Seat #6 is the button
Seat 1: 1tormentor ($300.35 in chips) 
Seat 2: angryjamman ($183.85 in chips) 
Seat 3: TODO ADENTR0 ($212.90 in chips) 
Seat 4: Fierytycoon ($200 in chips) 
Seat 5: DURKADURDUR ($200 in chips) 
Seat 6: FrAnWaN ($315.70 in chips) 
1tormentor: posts small blind $1
angryjamman: posts big blind $2
*** HOLE CARDS ***
TODO ADENTR0: folds 
Fierytycoon: folds 
DURKADURDUR: folds 
FrAnWaN: raises $4 to $6
1tormentor: calls $5
angryjamman: calls $4
*** FLOP *** [Qh Ts 8c]
1tormentor: checks 
angryjamman: checks 
FrAnWaN: bets $14
1tormentor: folds 
angryjamman: calls $14
*** TURN *** [Qh Ts 8c] [7s]
angryjamman: checks 
FrAnWaN: bets $28
angryjamman: folds 
Uncalled bet ($28) returned to FrAnWaN
FrAnWaN collected $43.75 from pot
FrAnWaN: doesn't show hand 
*** SUMMARY ***
Total pot $46 | Rake $2.25 
Board [Qh Ts 8c 7s]
Seat 1: 1tormentor (small blind) folded on the Flop
Seat 2: angryjamman (big blind) folded on the Turn
Seat 3: TODO ADENTR0 folded before Flop (didn't bet)
Seat 4: Fierytycoon folded before Flop (didn't bet)
Seat 5: DURKADURDUR folded before Flop (didn't bet)
Seat 6: FrAnWaN (button) collected ($43.75)




PokerStars Game #47185761865:  Hold'em No Limit ($1/$2 USD) - 2010/07/23 23:56:19 ET
Table 'Phereclos II' 6-max Seat #4 is the button
Seat 1: mpolice2010 ($78.55 in chips) 
Seat 2: rafa1985 ($54 in chips) 
Seat 3: ILS16L ($59.25 in chips) 
Seat 4: mpm135 ($473.45 in chips) 
Seat 5: TexasSooner2 ($79.55 in chips) 
TexasSooner2: posts small blind $1
mpolice2010: posts big blind $2
*** HOLE CARDS ***
rafa1985: calls $2
ILS16L: calls $2
mpm135: raises $6 to $8
TexasSooner2: folds 
mpolice2010: folds 
rafa1985: calls $6
ILS16L: calls $6
*** FLOP *** [5h 3d 5d]
beargood joins the table at seat #6 
rafa1985: bets $10
ILS16L: calls $10
mpm135: folds 
*** TURN *** [5h 3d 5d] [As]
rafa1985: bets $36 and is all-in
ILS16L: calls $36
*** RIVER *** [5h 3d 5d As] [Qc]
*** SHOW DOWN ***
rafa1985: shows [Qs 7h] (two pair, Queens and Fives)
ILS16L: shows [7c 5c] (three of a kind, Fives)
ILS16L collected $117 from pot
*** SUMMARY ***
Total pot $119 | Rake $2 
Board [5h 3d 5d As Qc]
Seat 1: mpolice2010 (big blind) folded before Flop
Seat 2: rafa1985 showed [Qs 7h] and lost with two pair, Queens and Fives
Seat 3: ILS16L showed [7c 5c] and won ($117) with three of a kind, Fives
Seat 4: mpm135 (button) folded on the Flop
Seat 5: TexasSooner2 (small blind) folded before Flop




PokerStars Game #47185782061:  Hold'em No Limit ($1/$2 USD) - 2010/07/23 23:57:20 ET
Table 'Wilhelmina' 6-max Seat #3 is the button
Seat 1: jaeh00d ($216.30 in chips) 
Seat 2: DMACM ($88 in chips) 
Seat 3: THEDUTCH4141 ($200 in chips) 
Seat 4: richard175 ($58.85 in chips) 
Seat 5: TODO ADENTR0 ($295.30 in chips) 
Seat 6: hellokittery ($216.95 in chips) 
richard175: posts small blind $1
TODO ADENTR0: posts big blind $2
*** HOLE CARDS ***
hellokittery: folds 
jaeh00d: folds 
DMACM: folds 
THEDUTCH4141: folds 
richard175: calls $1
TODO ADENTR0: checks 
*** FLOP *** [9c 5c 7d]
richard175: checks 
TODO ADENTR0: checks 
*** TURN *** [9c 5c 7d] [Th]
richard175: checks 
TODO ADENTR0: checks 
*** RIVER *** [9c 5c 7d Th] [5d]
richard175: bets $4
TODO ADENTR0: folds 
Uncalled bet ($4) returned to richard175
richard175 collected $3.80 from pot
*** SUMMARY ***
Total pot $4 | Rake $0.20 
Board [9c 5c 7d Th 5d]
Seat 1: jaeh00d folded before Flop (didn't bet)
Seat 2: DMACM folded before Flop (didn't bet)
Seat 3: THEDUTCH4141 (button) folded before Flop (didn't bet)
Seat 4: richard175 (small blind) collected ($3.80)
Seat 5: TODO ADENTR0 (big blind) folded on the River
Seat 6: hellokittery folded before Flop (didn't bet)




PokerStars Game #47185725087:  Hold'em No Limit ($1/$2 USD) - 2010/07/23 23:54:38 ET
Table 'Maia III' 6-max Seat #1 is the button
Seat 1: thomaswkm ($192.35 in chips) 
Seat 2: FrAnWaN ($369.65 in chips) 
Seat 3: dertaylor ($211.25 in chips) 
Seat 4: TODO ADENTR0 ($221 in chips) 
Seat 5: DURKADURDUR ($204.20 in chips) 
Seat 6: hellokittery ($219.40 in chips) 
FrAnWaN: posts small blind $1
dertaylor: posts big blind $2
*** HOLE CARDS ***
TODO ADENTR0: folds 
DURKADURDUR: raises $4 to $6
hellokittery: folds 
thomaswkm: folds 
FrAnWaN: folds 
dertaylor: calls $4
*** FLOP *** [3h 3c 4s]
dertaylor: checks 
DURKADURDUR: bets $9
dertaylor: calls $9
*** TURN *** [3h 3c 4s] [7h]
dertaylor: checks 
DURKADURDUR: bets $23
dertaylor: calls $23
*** RIVER *** [3h 3c 4s 7h] [8s]
dertaylor: bets $64
DURKADURDUR: folds 
Uncalled bet ($64) returned to dertaylor
dertaylor collected $74 from pot
*** SUMMARY ***
Total pot $77 | Rake $3 
Board [3h 3c 4s 7h 8s]
Seat 1: thomaswkm (button) folded before Flop (didn't bet)
Seat 2: FrAnWaN (small blind) folded before Flop
Seat 3: dertaylor (big blind) collected ($74)
Seat 4: TODO ADENTR0 folded before Flop (didn't bet)
Seat 5: DURKADURDUR folded on the River
Seat 6: hellokittery folded before Flop (didn't bet)




PokerStars Game #47185794623:  Hold'em No Limit ($1/$2 USD) - 2010/07/23 23:57:57 ET
Table 'Triton III' 6-max Seat #2 is the button
Seat 1: Cardsdevil27 ($159.70 in chips) 
Seat 2: Fierytycoon ($200 in chips) 
Seat 3: Jetize ($200 in chips) 
Seat 4: thomaswkm ($276.80 in chips) 
Seat 5: DURKADURDUR ($339.30 in chips) 
Seat 6: FrAnWaN ($429.25 in chips) 
Jetize: posts small blind $1
thomaswkm: posts big blind $2
*** HOLE CARDS ***
DURKADURDUR: folds 
FrAnWaN: folds 
Cardsdevil27: raises $4 to $6
Fierytycoon: folds 
Jetize: folds 
thomaswkm: folds 
Uncalled bet ($4) returned to Cardsdevil27
Cardsdevil27 collected $5 from pot
Cardsdevil27: doesn't show hand 
*** SUMMARY ***
Total pot $5 | Rake $0 
Seat 1: Cardsdevil27 collected ($5)
Seat 2: Fierytycoon (button) folded before Flop (didn't bet)
Seat 3: Jetize (small blind) folded before Flop
Seat 4: thomaswkm (big blind) folded before Flop
Seat 5: DURKADURDUR folded before Flop (didn't bet)
Seat 6: FrAnWaN folded before Flop (didn't bet)




PokerStars Game #47185768193:  Hold'em No Limit ($1/$2 USD) - 2010/07/23 23:56:39 ET
Table 'Regulus' 6-max Seat #3 is the button
Seat 1: FrAnWaN ($245.05 in chips) 
Seat 2: Fierytycoon ($213.85 in chips) 
Seat 3: TODO ADENTR0 ($381.95 in chips) 
Seat 4: thomaswkm ($266.40 in chips) 
Seat 5: DURKADURDUR ($426.40 in chips) 
Seat 6: Rush51 ($71.80 in chips) 
thomaswkm: posts small blind $1
DURKADURDUR: posts big blind $2
*** HOLE CARDS ***
Rush51: folds 
FrAnWaN: folds 
Fierytycoon: raises $4 to $6
TODO ADENTR0: folds 
thomaswkm: folds 
DURKADURDUR: folds 
Uncalled bet ($4) returned to Fierytycoon
Fierytycoon collected $5 from pot
Fierytycoon: doesn't show hand 
*** SUMMARY ***
Total pot $5 | Rake $0 
Seat 1: FrAnWaN folded before Flop (didn't bet)
Seat 2: Fierytycoon collected ($5)
Seat 3: TODO ADENTR0 (button) folded before Flop (didn't bet)
Seat 4: thomaswkm (small blind) folded before Flop
Seat 5: DURKADURDUR (big blind) folded before Flop
Seat 6: Rush51 folded before Flop (didn't bet)




PokerStars Game #47185801261:  Hold'em No Limit ($1/$2 USD) - 2010/07/23 23:58:17 ET
Table 'Regulus' 6-max Seat #5 is the button
Seat 1: FrAnWaN ($245.05 in chips) 
Seat 2: Fierytycoon ($216.85 in chips) 
Seat 3: TODO ADENTR0 ($381.95 in chips) 
Seat 4: thomaswkm ($265.40 in chips) 
Seat 5: DURKADURDUR ($423.40 in chips) 
Seat 6: Rush51 ($72.80 in chips) 
Rush51: posts small blind $1
FrAnWaN: posts big blind $2
*** HOLE CARDS ***
Fierytycoon: folds 
TODO ADENTR0: raises $4 to $6
thomaswkm: folds 
DURKADURDUR: folds 
Rush51: folds 
FrAnWaN: folds 
Uncalled bet ($4) returned to TODO ADENTR0
TODO ADENTR0 collected $5 from pot
TODO ADENTR0: doesn't show hand 
*** SUMMARY ***
Total pot $5 | Rake $0 
Seat 1: FrAnWaN (big blind) folded before Flop
Seat 2: Fierytycoon folded before Flop (didn't bet)
Seat 3: TODO ADENTR0 collected ($5)
Seat 4: thomaswkm folded before Flop (didn't bet)
Seat 5: DURKADURDUR (button) folded before Flop (didn't bet)
Seat 6: Rush51 (small blind) folded before Flop




PokerStars Game #47185786948:  Hold'em No Limit ($1/$2 USD) - 2010/07/23 23:57:35 ET
Table 'Pavo' 6-max Seat #1 is the button
Seat 1: dajatt13 ($282.65 in chips) 
Seat 2: FrAnWaN ($392.90 in chips) 
Seat 3: FastEddie267 ($200 in chips) 
Seat 4: thomaswkm ($119.25 in chips) 
Seat 5: THEDUTCH4141 ($208.25 in chips) 
Seat 6: TheAwfulDin ($231.50 in chips) 
FrAnWaN: posts small blind $1
FastEddie267: posts big blind $2
*** HOLE CARDS ***
thomaswkm: folds 
THEDUTCH4141: folds 
TheAwfulDin: folds 
dajatt13: raises $4 to $6
FrAnWaN: folds 
FastEddie267: folds 
Uncalled bet ($4) returned to dajatt13
dajatt13 collected $5 from pot
dajatt13: doesn't show hand 
*** SUMMARY ***
Total pot $5 | Rake $0 
Seat 1: dajatt13 (button) collected ($5)
Seat 2: FrAnWaN (small blind) folded before Flop
Seat 3: FastEddie267 (big blind) folded before Flop
Seat 4: thomaswkm folded before Flop (didn't bet)
Seat 5: THEDUTCH4141 folded before Flop (didn't bet)
Seat 6: TheAwfulDin folded before Flop (didn't bet)




PokerStars Game #47185812898:  Hold'em No Limit ($1/$2 USD) - 2010/07/23 23:58:52 ET
Table 'Shajna' 6-max Seat #5 is the button
Seat 1: neni85 ($103 in chips) 
Seat 2: bj2207 ($106.10 in chips) 
Seat 4: latebrake ($66.35 in chips) 
Seat 5: jimjam1979 ($40.55 in chips) 
Seat 6: AillemKall ($38.70 in chips) 
AillemKall: posts small blind $1
neni85: posts big blind $2
*** HOLE CARDS ***
bj2207: raises $6 to $8
latebrake: folds 
jimjam1979: folds 
AillemKall: folds 
neni85: folds 
Uncalled bet ($6) returned to bj2207
bj2207 collected $5 from pot
*** SUMMARY ***
Total pot $5 | Rake $0 
Seat 1: neni85 (big blind) folded before Flop
Seat 2: bj2207 collected ($5)
Seat 4: latebrake folded before Flop (didn't bet)
Seat 5: jimjam1979 (button) folded before Flop (didn't bet)
Seat 6: AillemKall (small blind) folded before Flop




PokerStars Game #47185805645:  Hold'em No Limit ($1/$2 USD) - 2010/07/23 23:58:30 ET
Table 'Shajna' 6-max Seat #4 is the button
Seat 1: neni85 ($100 in chips) 
Seat 2: bj2207 ($106.10 in chips) 
Seat 4: latebrake ($66.35 in chips) 
Seat 5: jimjam1979 ($41.55 in chips) 
Seat 6: AillemKall ($40.70 in chips) 
jimjam1979: posts small blind $1
AillemKall: posts big blind $2
*** HOLE CARDS ***
neni85: raises $3 to $5
bj2207: folds 
latebrake: folds 
jimjam1979: folds 
AillemKall: folds 
Uncalled bet ($3) returned to neni85
neni85 collected $5 from pot
neni85: doesn't show hand 
*** SUMMARY ***
Total pot $5 | Rake $0 
Seat 1: neni85 collected ($5)
Seat 2: bj2207 folded before Flop (didn't bet)
Seat 4: latebrake (button) folded before Flop (didn't bet)
Seat 5: jimjam1979 (small blind) folded before Flop
Seat 6: AillemKall (big blind) folded before Flop




PokerStars Game #47185771323:  Hold'em No Limit ($1/$2 USD) - 2010/07/23 23:56:48 ET
Table 'Kentaurus IV' 6-max Seat #5 is the button
Seat 1: neni85 ($262.45 in chips) 
Seat 2: DMACM ($94.75 in chips) 
Seat 3: THEDUTCH4141 ($100 in chips) 
Seat 5: LeoFara ($55.80 in chips) 
Seat 6: FlushVirus ($96.70 in chips) 
FlushVirus: posts small blind $1
neni85: posts big blind $2
*** HOLE CARDS ***
DMACM: folds 
THEDUTCH4141: folds 
LeoFara: folds 
FlushVirus: raises $4 to $6
neni85: folds 
Uncalled bet ($4) returned to FlushVirus
FlushVirus collected $4 from pot
*** SUMMARY ***
Total pot $4 | Rake $0 
Seat 1: neni85 (big blind) folded before Flop
Seat 2: DMACM folded before Flop (didn't bet)
Seat 3: THEDUTCH4141 folded before Flop (didn't bet)
Seat 5: LeoFara (button) folded before Flop (didn't bet)
Seat 6: FlushVirus (small blind) collected ($4)




PokerStars Game #47185750843:  Hold'em No Limit ($1/$2 USD) - 2010/07/23 23:55:46 ET
Table 'Natalie' 6-max Seat #5 is the button
Seat 1: DURKADURDUR ($426.65 in chips) 
Seat 3: THEDUTCH4141 ($200 in chips) 
Seat 5: FastEddie267 ($212.60 in chips) 
Seat 6: leukehond ($220.90 in chips) 
leukehond: posts small blind $1
DURKADURDUR: posts big blind $2
*** HOLE CARDS ***
THEDUTCH4141: folds 
FastEddie267: folds 
leukehond: raises $3 to $5
DURKADURDUR has timed out
DURKADURDUR: folds 
Uncalled bet ($3) returned to leukehond
leukehond collected $4 from pot
leukehond: doesn't show hand 
*** SUMMARY ***
Total pot $4 | Rake $0 
Seat 1: DURKADURDUR (big blind) folded before Flop
Seat 3: THEDUTCH4141 folded before Flop (didn't bet)
Seat 5: FastEddie267 (button) folded before Flop (didn't bet)
Seat 6: leukehond (small blind) collected ($4)




PokerStars Game #47185776067:  Hold'em No Limit ($1/$2 USD) - 2010/07/23 23:57:02 ET
Table 'Selene' 6-max Seat #1 is the button
Seat 1: beargood ($106.35 in chips) 
Seat 2: Rocco35 ($73.15 in chips) 
Seat 3: Mamoo ($126.40 in chips) 
Seat 4: HUMBLED1 ($229 in chips) 
Seat 5: DMACM ($86.35 in chips) 
Seat 6: BlindFlying ($158 in chips) 
Rocco35: posts small blind $1
Mamoo: posts big blind $2
*** HOLE CARDS ***
HUMBLED1: folds 
DMACM: folds 
BlindFlying: folds 
beargood: folds 
Rocco35: folds 
Uncalled bet ($1) returned to Mamoo
Mamoo collected $2 from pot
*** SUMMARY ***
Total pot $2 | Rake $0 
Seat 1: beargood (button) folded before Flop (didn't bet)
Seat 2: Rocco35 (small blind) folded before Flop
Seat 3: Mamoo (big blind) collected ($2)
Seat 4: HUMBLED1 folded before Flop (didn't bet)
Seat 5: DMACM folded before Flop (didn't bet)
Seat 6: BlindFlying folded before Flop (didn't bet)




PokerStars Game #47185786049:  Hold'em No Limit ($1/$2 USD) - 2010/07/23 23:57:32 ET
Table 'Vitja' 6-max Seat #2 is the button
Seat 2: Don brujo ($31.90 in chips) 
Seat 3: rodrieliot ($37 in chips) 
Seat 4: emilpetten ($38.25 in chips) 
Seat 6: LeoFara ($43.80 in chips) 
rodrieliot: posts small blind $1
emilpetten: posts big blind $2
*** HOLE CARDS ***
LeoFara: folds 
Don brujo: raises $29.90 to $31.90 and is all-in
rodrieliot: folds 
emilpetten: folds 
Uncalled bet ($29.90) returned to Don brujo
Don brujo collected $5 from pot
*** SUMMARY ***
Total pot $5 | Rake $0 
Seat 2: Don brujo (button) collected ($5)
Seat 3: rodrieliot (small blind) folded before Flop
Seat 4: emilpetten (big blind) folded before Flop
Seat 6: LeoFara folded before Flop (didn't bet)




PokerStars Game #47185793966:  Hold'em No Limit ($1/$2 USD) - 2010/07/23 23:57:55 ET
Table 'Luscinia' 6-max Seat #3 is the button
Seat 1: AillemKall ($35.20 in chips) 
Seat 2: JDVC ($62.50 in chips) 
Seat 3: rodrieliot ($51.05 in chips) 
Seat 4: ILS16L ($76.65 in chips) 
Seat 5: Clabby01 ($92.70 in chips) 
Seat 6: sebass911 ($102.30 in chips) 
ILS16L: posts small blind $1
Clabby01: posts big blind $2
*** HOLE CARDS ***
sebass911: raises $4 to $6
AillemKall: folds 
JDVC: folds 
rodrieliot: folds 
ILS16L: folds 
Clabby01: folds 
Uncalled bet ($4) returned to sebass911
sebass911 collected $5 from pot
*** SUMMARY ***
Total pot $5 | Rake $0 
Seat 1: AillemKall folded before Flop (didn't bet)
Seat 2: JDVC folded before Flop (didn't bet)
Seat 3: rodrieliot (button) folded before Flop (didn't bet)
Seat 4: ILS16L (small blind) folded before Flop
Seat 5: Clabby01 (big blind) folded before Flop
Seat 6: sebass911 collected ($5)




PokerStars Game #47185791647:  Hold'em No Limit ($1/$2 USD) - 2010/07/23 23:57:49 ET
Table 'Sonja' 6-max Seat #3 is the button
Seat 1: leukehond ($203 in chips) 
Seat 3: smartystevel ($197 in chips) 
smartystevel: posts small blind $1
leukehond: posts big blind $2
*** HOLE CARDS ***
mib443 joins the table at seat #6 
smartystevel: calls $1
leukehond: checks 
*** FLOP *** [Jc 5d Kh]
leukehond: checks 
smartystevel: checks 
*** TURN *** [Jc 5d Kh] [2s]
leukehond: checks 
smartystevel: checks 
*** RIVER *** [Jc 5d Kh 2s] [3s]
leukehond: checks 
smartystevel: checks 
*** SHOW DOWN ***
leukehond: shows [8c 4d] (high card King)
smartystevel: shows [2d As] (a pair of Deuces)
smartystevel collected $3.80 from pot
*** SUMMARY ***
Total pot $4 | Rake $0.20 
Board [Jc 5d Kh 2s 3s]
Seat 1: leukehond (big blind) showed [8c 4d] and lost with high card King
Seat 3: smartystevel (button) (small blind) showed [2d As] and won ($3.80) with a pair of Deuces




PokerStars Game #47185795086:  Hold'em No Limit ($1/$2 USD) - 2010/07/23 23:57:59 ET
Table 'Selene' 6-max Seat #3 is the button
Seat 1: beargood ($118.40 in chips) 
Seat 2: Rocco35 ($66.15 in chips) 
Seat 3: Mamoo ($126.40 in chips) 
Seat 4: HUMBLED1 ($223 in chips) 
Seat 5: DMACM ($86.35 in chips) 
Seat 6: BlindFlying ($158 in chips) 
HUMBLED1: posts small blind $1
DMACM: posts big blind $2
*** HOLE CARDS ***
BlindFlying: folds 
beargood: folds 
Rocco35: folds 
Mamoo: folds 
HUMBLED1: raises $6 to $8
DMACM: folds 
Uncalled bet ($6) returned to HUMBLED1
HUMBLED1 collected $4 from pot
HUMBLED1: doesn't show hand 
*** SUMMARY ***
Total pot $4 | Rake $0 
Seat 1: beargood folded before Flop (didn't bet)
Seat 2: Rocco35 folded before Flop (didn't bet)
Seat 3: Mamoo (button) folded before Flop (didn't bet)
Seat 4: HUMBLED1 (small blind) collected ($4)
Seat 5: DMACM (big blind) folded before Flop
Seat 6: BlindFlying folded before Flop (didn't bet)




PokerStars Game #47185759644:  Hold'em No Limit ($1/$2 USD) - 2010/07/23 23:56:13 ET
Table 'Selene' 6-max Seat #5 is the button
Seat 1: beargood ($106.35 in chips) 
Seat 2: Rocco35 ($72.15 in chips) 
Seat 3: Mamoo ($126.40 in chips) 
Seat 4: HUMBLED1 ($229 in chips) 
Seat 5: DMACM ($86.35 in chips) 
Seat 6: BlindFlying ($159 in chips) 
BlindFlying: posts small blind $1
beargood: posts big blind $2
*** HOLE CARDS ***
Rocco35: folds 
Mamoo: folds 
HUMBLED1: folds 
DMACM: folds 
BlindFlying: folds 
Uncalled bet ($1) returned to beargood
beargood collected $2 from pot
beargood: doesn't show hand 
*** SUMMARY ***
Total pot $2 | Rake $0 
Seat 1: beargood (big blind) collected ($2)
Seat 2: Rocco35 folded before Flop (didn't bet)
Seat 3: Mamoo folded before Flop (didn't bet)
Seat 4: HUMBLED1 folded before Flop (didn't bet)
Seat 5: DMACM (button) folded before Flop (didn't bet)
Seat 6: BlindFlying (small blind) folded before Flop




PokerStars Game #47185817135:  Hold'em No Limit ($1/$2 USD) - 2010/07/23 23:59:05 ET
Table 'Lonnrot III' 6-max Seat #1 is the button
Seat 1: THEDUTCH4141 ($224 in chips) 
Seat 2: Duke_Moto ($188.35 in chips) 
Seat 3: DURKADURDUR ($211.45 in chips) 
Seat 5: dajatt13 ($340 in chips) 
Seat 6: FrAnWaN ($274.75 in chips) 
Duke_Moto: posts small blind $1
DURKADURDUR: posts big blind $2
FastEddie267: sits out 
*** HOLE CARDS ***
dajatt13: folds 
FrAnWaN: folds 
THEDUTCH4141: folds 
Duke_Moto: folds 
Uncalled bet ($1) returned to DURKADURDUR
DURKADURDUR collected $2 from pot
DURKADURDUR: doesn't show hand 
*** SUMMARY ***
Total pot $2 | Rake $0 
Seat 1: THEDUTCH4141 (button) folded before Flop (didn't bet)
Seat 2: Duke_Moto (small blind) folded before Flop
Seat 3: DURKADURDUR (big blind) collected ($2)
Seat 5: dajatt13 folded before Flop (didn't bet)
Seat 6: FrAnWaN folded before Flop (didn't bet)




PokerStars Game #47185806505:  Hold'em No Limit ($1/$2 USD) - 2010/07/23 23:58:33 ET
Table 'Phoenix V' 6-max Seat #4 is the button
Seat 1: Steevah ($64 in chips) 
Seat 2: tdiddy ($211.80 in chips) 
Seat 3: pike2229 ($150.75 in chips) 
Seat 4: jimjam1979 ($41 in chips) 
Seat 6: neni85 ($456.65 in chips) 
neni85: posts small blind $1
Steevah: posts big blind $2
*** HOLE CARDS ***
tdiddy: folds 
pike2229: folds 
jimjam1979: raises $2 to $4
neni85: folds 
Steevah: raises $4 to $8
Jetize joins the table at seat #5 
jimjam1979: folds 
Uncalled bet ($4) returned to Steevah
Steevah collected $9 from pot
Steevah: doesn't show hand 
*** SUMMARY ***
Total pot $9 | Rake $0 
Seat 1: Steevah (big blind) collected ($9)
Seat 2: tdiddy folded before Flop (didn't bet)
Seat 3: pike2229 folded before Flop (didn't bet)
Seat 4: jimjam1979 (button) folded before Flop
Seat 6: neni85 (small blind) folded before Flop




PokerStars Game #47185764199:  Hold'em No Limit ($1/$2 USD) - 2010/07/23 23:56:26 ET
Table 'Kentaurus IV' 6-max Seat #3 is the button
Seat 1: neni85 ($262.45 in chips) 
Seat 2: DMACM ($94.75 in chips) 
Seat 3: THEDUTCH4141 ($100 in chips) 
Seat 5: LeoFara ($56.80 in chips) 
Seat 6: FlushVirus ($95.70 in chips) 
LeoFara: posts small blind $1
FlushVirus: posts big blind $2
*** HOLE CARDS ***
neni85: folds 
DMACM: folds 
THEDUTCH4141: folds 
LeoFara: folds 
Uncalled bet ($1) returned to FlushVirus
FlushVirus collected $2 from pot
*** SUMMARY ***
Total pot $2 | Rake $0 
Seat 1: neni85 folded before Flop (didn't bet)
Seat 2: DMACM folded before Flop (didn't bet)
Seat 3: THEDUTCH4141 (button) folded before Flop (didn't bet)
Seat 5: LeoFara (small blind) folded before Flop
Seat 6: FlushVirus (big blind) collected ($2)




PokerStars Game #47185794093:  Hold'em No Limit ($1/$2 USD) - 2010/07/23 23:57:56 ET
Table 'Phoenix V' 6-max Seat #2 is the button
Seat 2: tdiddy ($211.80 in chips) 
Seat 3: pike2229 ($152.75 in chips) 
Seat 4: jimjam1979 ($40 in chips) 
Seat 6: neni85 ($455.65 in chips) 
pike2229: posts small blind $1
jimjam1979: posts big blind $2
*** HOLE CARDS ***
neni85: folds 
tdiddy: folds 
pike2229: calls $1
jimjam1979: raises $38 to $40 and is all-in
pike2229: folds 
Uncalled bet ($38) returned to jimjam1979
jimjam1979 collected $4 from pot
jimjam1979: doesn't show hand 
*** SUMMARY ***
Total pot $4 | Rake $0 
Seat 2: tdiddy (button) folded before Flop (didn't bet)
Seat 3: pike2229 (small blind) folded before Flop
Seat 4: jimjam1979 (big blind) collected ($4)
Seat 6: neni85 folded before Flop (didn't bet)




PokerStars Game #47185796750:  Hold'em No Limit ($1/$2 USD) - 2010/07/23 23:58:04 ET
Table 'Kentaurus IV' 6-max Seat #2 is the button
Seat 1: neni85 ($265.45 in chips) 
Seat 2: DMACM ($91.75 in chips) 
Seat 3: THEDUTCH4141 ($100 in chips) 
Seat 5: LeoFara ($55.80 in chips) 
Seat 6: FlushVirus ($98.70 in chips) 
THEDUTCH4141: posts small blind $1
LeoFara: posts big blind $2
*** HOLE CARDS ***
FlushVirus: folds 
neni85: folds 
DMACM: folds 
THEDUTCH4141: folds 
Uncalled bet ($1) returned to LeoFara
LeoFara collected $2 from pot
*** SUMMARY ***
Total pot $2 | Rake $0 
Seat 1: neni85 folded before Flop (didn't bet)
Seat 2: DMACM (button) folded before Flop (didn't bet)
Seat 3: THEDUTCH4141 (small blind) folded before Flop
Seat 5: LeoFara (big blind) collected ($2)
Seat 6: FlushVirus folded before Flop (didn't bet)




PokerStars Game #47185793040:  Hold'em No Limit ($1/$2 USD) - 2010/07/23 23:57:53 ET
Table 'Vitja' 6-max Seat #3 is the button
Seat 2: Don brujo ($34.90 in chips) 
Seat 3: rodrieliot ($36 in chips) 
Seat 4: emilpetten ($36.25 in chips) 
Seat 6: LeoFara ($43.80 in chips) 
emilpetten: posts small blind $1
LeoFara: posts big blind $2
*** HOLE CARDS ***
Don brujo: folds 
rodrieliot: folds 
Don brujo leaves the table
emilpetten is disconnected 
emilpetten has timed out while disconnected
emilpetten: folds 
Uncalled bet ($1) returned to LeoFara
LeoFara collected $2 from pot
*** SUMMARY ***
Total pot $2 | Rake $0 
Seat 2: Don brujo folded before Flop (didn't bet)
Seat 3: rodrieliot (button) folded before Flop (didn't bet)
Seat 4: emilpetten (small blind) folded before Flop
Seat 6: LeoFara (big blind) collected ($2)




PokerStars Game #47185763557:  Hold'em No Limit ($1/$2 USD) - 2010/07/23 23:56:24 ET
Table 'Menelaus II' 6-max Seat #6 is the button
Seat 1: LeoFara ($62.60 in chips) 
Seat 4: mzosh ($224.15 in chips) 
Seat 5: tdiddy ($160.25 in chips) 
Seat 6: sp4taxes ($62.60 in chips) 
LeoFara: posts small blind $1
mzosh: posts big blind $2
*** HOLE CARDS ***
tdiddy: folds 
sp4taxes: calls $2
LeoFara: folds 
mzosh: checks 
*** FLOP *** [8c As 2s]
mzosh: checks 
sp4taxes: bets $4
mzosh: folds 
Uncalled bet ($4) returned to sp4taxes
sp4taxes collected $4.75 from pot
sp4taxes: doesn't show hand 
*** SUMMARY ***
Total pot $5 | Rake $0.25 
Board [8c As 2s]
Seat 1: LeoFara (small blind) folded before Flop
Seat 4: mzosh (big blind) folded on the Flop
Seat 5: tdiddy folded before Flop (didn't bet)
Seat 6: sp4taxes (button) collected ($4.75)




PokerStars Game #47185764014:  Hold'em No Limit ($1/$2 USD) - 2010/07/23 23:56:26 ET
Table 'Wilhelmina' 6-max Seat #2 is the button
Seat 1: jaeh00d ($200 in chips) 
Seat 2: DMACM ($88 in chips) 
Seat 3: THEDUTCH4141 ($200 in chips) 
Seat 4: richard175 ($75.85 in chips) 
Seat 5: TODO ADENTR0 ($295.30 in chips) 
Seat 6: hellokittery ($216.95 in chips) 
THEDUTCH4141: posts small blind $1
richard175: posts big blind $2
*** HOLE CARDS ***
TODO ADENTR0: folds 
hellokittery: folds 
jaeh00d: raises $4 to $6
DMACM: folds 
THEDUTCH4141: folds 
richard175: calls $4
*** FLOP *** [Jd Ad Kd]
richard175: checks 
jaeh00d: checks 
*** TURN *** [Jd Ad Kd] [Ac]
richard175: checks 
jaeh00d: bets $11
richard175: calls $11
*** RIVER *** [Jd Ad Kd Ac] [8h]
richard175: checks 
jaeh00d: bets $16
richard175: folds 
Uncalled bet ($16) returned to jaeh00d
jaeh00d collected $33.30 from pot
jaeh00d: doesn't show hand 
*** SUMMARY ***
Total pot $35 | Rake $1.70 
Board [Jd Ad Kd Ac 8h]
Seat 1: jaeh00d collected ($33.30)
Seat 2: DMACM (button) folded before Flop (didn't bet)
Seat 3: THEDUTCH4141 (small blind) folded before Flop
Seat 4: richard175 (big blind) folded on the River
Seat 5: TODO ADENTR0 folded before Flop (didn't bet)
Seat 6: hellokittery folded before Flop (didn't bet)




PokerStars Game #47185780829:  Hold'em No Limit ($1/$2 USD) - 2010/07/23 23:57:16 ET
Table 'Rafita IV' 6-max Seat #1 is the button
Seat 1: neni85 ($157.10 in chips) 
Seat 2: NewEra760 ($66.75 in chips) 
Seat 3: AillemKall ($50.80 in chips) 
Seat 5: jimjam1979 ($40.15 in chips) 
Seat 6: Ricko7456 ($162.55 in chips) 
NewEra760: posts small blind $1
AillemKall: posts big blind $2
*** HOLE CARDS ***
jimjam1979: folds 
Ricko7456: folds 
neni85: folds 
NewEra760: calls $1
AillemKall: checks 
*** FLOP *** [Kd Ad Jh]
NewEra760: checks 
AillemKall: checks 
*** TURN *** [Kd Ad Jh] [Qs]
NewEra760: bets $2
AillemKall: folds 
Uncalled bet ($2) returned to NewEra760
NewEra760 collected $3.80 from pot
NewEra760: doesn't show hand 
*** SUMMARY ***
Total pot $4 | Rake $0.20 
Board [Kd Ad Jh Qs]
Seat 1: neni85 (button) folded before Flop (didn't bet)
Seat 2: NewEra760 (small blind) collected ($3.80)
Seat 3: AillemKall (big blind) folded on the Turn
Seat 5: jimjam1979 folded before Flop (didn't bet)
Seat 6: Ricko7456 folded before Flop (didn't bet)




PokerStars Game #47185780690:  Hold'em No Limit ($1/$2 USD) - 2010/07/23 23:57:16 ET
Table 'Scutum X' 6-max Seat #4 is the button
Seat 1: jamieunlv017 ($76.20 in chips) 
Seat 2: AillemKall ($71.40 in chips) 
Seat 3: AironVega ($45.90 in chips) 
Seat 4: Mamoo ($22.70 in chips) 
Seat 5: Bruno_F88 ($117.75 in chips) 
Seat 6: mpm135 ($136.15 in chips) 
Bruno_F88: posts small blind $1
mpm135: posts big blind $2
*** HOLE CARDS ***
jamieunlv017: folds 
AillemKall: folds 
AironVega: folds 
Mamoo: raises $4 to $6
Bruno_F88: calls $5
mpm135: folds 
*** FLOP *** [6c Ah Td]
Bruno_F88: checks 
Mamoo: bets $8
Bruno_F88: folds 
Uncalled bet ($8) returned to Mamoo
Mamoo collected $13.30 from pot
*** SUMMARY ***
Total pot $14 | Rake $0.70 
Board [6c Ah Td]
Seat 1: jamieunlv017 folded before Flop (didn't bet)
Seat 2: AillemKall folded before Flop (didn't bet)
Seat 3: AironVega folded before Flop (didn't bet)
Seat 4: Mamoo (button) collected ($13.30)
Seat 5: Bruno_F88 (small blind) folded on the Flop
Seat 6: mpm135 (big blind) folded before Flop




PokerStars Game #47185782816:  Hold'em No Limit ($1/$2 USD) - 2010/07/23 23:57:22 ET
Table 'Selene' 6-max Seat #2 is the button
Seat 1: beargood ($106.35 in chips) 
Seat 2: Rocco35 ($72.15 in chips) 
Seat 3: Mamoo ($127.40 in chips) 
Seat 4: HUMBLED1 ($229 in chips) 
Seat 5: DMACM ($86.35 in chips) 
Seat 6: BlindFlying ($158 in chips) 
Mamoo: posts small blind $1
HUMBLED1: posts big blind $2
*** HOLE CARDS ***
DMACM: folds 
BlindFlying: folds 
beargood: raises $4 to $6
Rocco35: calls $6
Mamoo: folds 
HUMBLED1: calls $4
*** FLOP *** [3s 8d Jd]
HUMBLED1: checks 
beargood: bets $14
Rocco35: folds 
HUMBLED1: folds 
Uncalled bet ($14) returned to beargood
beargood collected $18.05 from pot
beargood: doesn't show hand 
*** SUMMARY ***
Total pot $19 | Rake $0.95 
Board [3s 8d Jd]
Seat 1: beargood collected ($18.05)
Seat 2: Rocco35 (button) folded on the Flop
Seat 3: Mamoo (small blind) folded before Flop
Seat 4: HUMBLED1 (big blind) folded on the Flop
Seat 5: DMACM folded before Flop (didn't bet)
Seat 6: BlindFlying folded before Flop (didn't bet)




PokerStars Game #47185802234:  Hold'em No Limit ($1/$2 USD) - 2010/07/23 23:58:20 ET
Table 'Lonnrot III' 6-max Seat #6 is the button
Seat 1: THEDUTCH4141 ($230 in chips) 
Seat 2: Duke_Moto ($182.95 in chips) 
Seat 3: DURKADURDUR ($211.45 in chips) 
Seat 5: dajatt13 ($340 in chips) 
Seat 6: FrAnWaN ($274.75 in chips) 
THEDUTCH4141: posts small blind $1
Duke_Moto: posts big blind $2
FastEddie267: sits out 
*** HOLE CARDS ***
DURKADURDUR: folds 
dajatt13: folds 
FrAnWaN: folds 
THEDUTCH4141: raises $4 to $6
Duke_Moto: calls $4
*** FLOP *** [6h 5c 8h]
THEDUTCH4141: checks 
Duke_Moto: bets $6
THEDUTCH4141: folds 
Uncalled bet ($6) returned to Duke_Moto
Duke_Moto collected $11.40 from pot
Duke_Moto: doesn't show hand 
*** SUMMARY ***
Total pot $12 | Rake $0.60 
Board [6h 5c 8h]
Seat 1: THEDUTCH4141 (small blind) folded on the Flop
Seat 2: Duke_Moto (big blind) collected ($11.40)
Seat 3: DURKADURDUR folded before Flop (didn't bet)
Seat 5: dajatt13 folded before Flop (didn't bet)
Seat 6: FrAnWaN (button) folded before Flop (didn't bet)




PokerStars Game #47185762333:  Hold'em No Limit ($1/$2 USD) - 2010/07/23 23:56:21 ET
Table 'Vitja' 6-max Seat #5 is the button
Seat 2: Don brujo ($34.90 in chips) 
Seat 3: rodrieliot ($39 in chips) 
Seat 4: emilpetten ($35.25 in chips) 
Seat 5: EKkL ($49.80 in chips) 
Seat 6: LeoFara ($41.80 in chips) 
LeoFara: posts small blind $1
WizardOfAhhs: is sitting out 
WizardOfAhhs leaves the table
Don brujo: posts big blind $2
*** HOLE CARDS ***
rodrieliot: folds 
emilpetten: folds 
EKkL: folds 
LeoFara: raises $2.40 to $4.40
Don brujo: folds 
Uncalled bet ($2.40) returned to LeoFara
LeoFara collected $4 from pot
*** SUMMARY ***
Total pot $4 | Rake $0 
Seat 2: Don brujo (big blind) folded before Flop
Seat 3: rodrieliot folded before Flop (didn't bet)
Seat 4: emilpetten folded before Flop (didn't bet)
Seat 5: EKkL (button) folded before Flop (didn't bet)
Seat 6: LeoFara (small blind) collected ($4)




PokerStars Game #47185795709:  Hold'em No Limit ($1/$2 USD) - 2010/07/23 23:58:01 ET
Table 'Rafita IV' 6-max Seat #2 is the button
Seat 1: neni85 ($157.10 in chips) 
Seat 2: NewEra760 ($68.55 in chips) 
Seat 3: AillemKall ($48.80 in chips) 
Seat 5: jimjam1979 ($40.15 in chips) 
Seat 6: Ricko7456 ($162.55 in chips) 
AillemKall: posts small blind $1
jimjam1979: posts big blind $2
*** HOLE CARDS ***
erwa joins the table at seat #4 
Ricko7456: calls $2
neni85: folds 
NewEra760: calls $2
AillemKall: folds 
jimjam1979: checks 
*** FLOP *** [Ah 4s 2d]
jimjam1979: checks 
Ricko7456: checks 
NewEra760: bets $4
jimjam1979: folds 
Ricko7456: folds 
Uncalled bet ($4) returned to NewEra760
NewEra760 collected $6.65 from pot
NewEra760: doesn't show hand 
*** SUMMARY ***
Total pot $7 | Rake $0.35 
Board [Ah 4s 2d]
Seat 1: neni85 folded before Flop (didn't bet)
Seat 2: NewEra760 (button) collected ($6.65)
Seat 3: AillemKall (small blind) folded before Flop
Seat 5: jimjam1979 (big blind) folded on the Flop
Seat 6: Ricko7456 folded on the Flop




PokerStars Game #47185775852:  Hold'em No Limit ($1/$2 USD) - 2010/07/23 23:57:01 ET
Table 'Luscinia' 6-max Seat #2 is the button
Seat 1: AillemKall ($39.30 in chips) 
Seat 2: JDVC ($55.95 in chips) 
Seat 3: rodrieliot ($52.05 in chips) 
Seat 4: ILS16L ($78.65 in chips) 
Seat 5: Clabby01 ($92.70 in chips) 
Seat 6: sebass911 ($102.30 in chips) 
rodrieliot: posts small blind $1
ILS16L: posts big blind $2
*** HOLE CARDS ***
Clabby01: folds 
sebass911: folds 
AillemKall: raises $2.10 to $4.10
JDVC: calls $4.10
rodrieliot: folds 
ILS16L: folds 
*** FLOP *** [4d 2s Jd]
AillemKall: checks 
JDVC: bets $4
AillemKall: folds 
Uncalled bet ($4) returned to JDVC
JDVC collected $10.65 from pot
JDVC: doesn't show hand 
*** SUMMARY ***
Total pot $11.20 | Rake $0.55 
Board [4d 2s Jd]
Seat 1: AillemKall folded on the Flop
Seat 2: JDVC (button) collected ($10.65)
Seat 3: rodrieliot (small blind) folded before Flop
Seat 4: ILS16L (big blind) folded before Flop
Seat 5: Clabby01 folded before Flop (didn't bet)
Seat 6: sebass911 folded before Flop (didn't bet)




PokerStars Game #47185795594:  Hold'em No Limit ($1/$2 USD) - 2010/07/23 23:58:00 ET
Table 'Laocoon III' 6-max Seat #3 is the button
Seat 1: 1tormentor ($294.35 in chips) 
Seat 2: angryjamman ($180.15 in chips) 
Seat 3: TODO ADENTR0 ($218.90 in chips) 
Seat 4: Fierytycoon ($200 in chips) 
Seat 5: DURKADURDUR ($200 in chips) 
Seat 6: FrAnWaN ($317.45 in chips) 
Fierytycoon: posts small blind $1
DURKADURDUR: posts big blind $2
*** HOLE CARDS ***
FrAnWaN: folds 
1tormentor: folds 
angryjamman: folds 
TODO ADENTR0: raises $3 to $5
Fierytycoon: folds 
DURKADURDUR: folds 
Uncalled bet ($3) returned to TODO ADENTR0
TODO ADENTR0 collected $5 from pot
TODO ADENTR0: doesn't show hand 
*** SUMMARY ***
Total pot $5 | Rake $0 
Seat 1: 1tormentor folded before Flop (didn't bet)
Seat 2: angryjamman folded before Flop (didn't bet)
Seat 3: TODO ADENTR0 (button) collected ($5)
Seat 4: Fierytycoon (small blind) folded before Flop
Seat 5: DURKADURDUR (big blind) folded before Flop
Seat 6: FrAnWaN folded before Flop (didn't bet)




PokerStars Game #47185786903:  Hold'em No Limit ($1/$2 USD) - 2010/07/23 23:57:35 ET
Table 'Shajna' 6-max Seat #2 is the button
Seat 1: neni85 ($100 in chips) 
Seat 2: bj2207 ($97 in chips) 
Seat 4: latebrake ($74.35 in chips) 
Seat 5: jimjam1979 ($43.55 in chips) 
Seat 6: AillemKall ($40.70 in chips) 
latebrake: posts small blind $1
jimjam1979: posts big blind $2
*** HOLE CARDS ***
AillemKall: folds 
neni85: folds 
bj2207: raises $6 to $8
latebrake: calls $7
jimjam1979: folds 
*** FLOP *** [Jh Qc Kh]
latebrake: checks 
bj2207: bets $16
latebrake: folds 
Uncalled bet ($16) returned to bj2207
bj2207 collected $17.10 from pot
*** SUMMARY ***
Total pot $18 | Rake $0.90 
Board [Jh Qc Kh]
Seat 1: neni85 folded before Flop (didn't bet)
Seat 2: bj2207 (button) collected ($17.10)
Seat 4: latebrake (small blind) folded on the Flop
Seat 5: jimjam1979 (big blind) folded before Flop
Seat 6: AillemKall folded before Flop (didn't bet)




PokerStars Game #47185815180:  Hold'em No Limit ($1/$2 USD) - 2010/07/23 23:58:59 ET
Table 'Laodica' 6-max Seat #3 is the button
Seat 2: LeoFara ($43 in chips) 
Seat 3: jimjam1979 ($35 in chips) 
Seat 4: BlindFlying ($98 in chips) 
Seat 5: rodrieliot ($57.60 in chips) 
Seat 6: JuStBLaZe908 ($324.50 in chips) 
BlindFlying: posts small blind $1
rodrieliot: posts big blind $2
*** HOLE CARDS ***
JuStBLaZe908: raises $4 to $6
LeoFara: folds 
jimjam1979: folds 
BlindFlying: folds 
rodrieliot: folds 
Uncalled bet ($4) returned to JuStBLaZe908
JuStBLaZe908 collected $5 from pot
*** SUMMARY ***
Total pot $5 | Rake $0 
Seat 2: LeoFara folded before Flop (didn't bet)
Seat 3: jimjam1979 (button) folded before Flop (didn't bet)
Seat 4: BlindFlying (small blind) folded before Flop
Seat 5: rodrieliot (big blind) folded before Flop
Seat 6: JuStBLaZe908 collected ($5)




PokerStars Game #47185817068:  Hold'em No Limit ($1/$2 USD) - 2010/07/23 23:59:04 ET
Table 'Natalie' 6-max Seat #6 is the button
Seat 2: himself609 ($118.75 in chips) 
Seat 3: THEDUTCH4141 ($259 in chips) 
Seat 5: FastEddie267 ($203.60 in chips) 
Seat 6: leukehond ($210.90 in chips) 
himself609: posts small blind $1
THEDUTCH4141: posts big blind $2
Jetize: sits out 
*** HOLE CARDS ***
FastEddie267: folds 
leukehond: folds 
himself609: calls $1
THEDUTCH4141: checks 
*** FLOP *** [Qh 2s 6s]
himself609: bets $6
THEDUTCH4141: folds 
Uncalled bet ($6) returned to himself609
himself609 collected $3.80 from pot
*** SUMMARY ***
Total pot $4 | Rake $0.20 
Board [Qh 2s 6s]
Seat 2: himself609 (small blind) collected ($3.80)
Seat 3: THEDUTCH4141 (big blind) folded on the Flop
Seat 5: FastEddie267 folded before Flop (didn't bet)
Seat 6: leukehond (button) folded before Flop (didn't bet)




PokerStars Game #47185775510:  Hold'em No Limit ($1/$2 USD) - 2010/07/23 23:57:00 ET
Table 'Ottegebe' 6-max Seat #2 is the button
Seat 2: picasso264 ($16.65 in chips) 
Seat 3: AironVega ($70 in chips) 
Seat 4: DMACM ($124.45 in chips) 
Seat 6: jimjam1979 ($33 in chips) 
AironVega: posts small blind $1
DMACM: posts big blind $2
HT52: sits out 
*** HOLE CARDS ***
jimjam1979: folds 
picasso264: raises $2 to $4
AironVega: folds 
DMACM: raises $12 to $16
picasso264: raises $0.65 to $16.65 and is all-in
DMACM: calls $0.65
*** FLOP *** [3c Kd 4s]
*** TURN *** [3c Kd 4s] [Kc]
*** RIVER *** [3c Kd 4s Kc] [5c]
*** SHOW DOWN ***
DMACM: shows [6s As] (a pair of Kings)
picasso264: shows [Kh 7d] (three of a kind, Kings)
picasso264 collected $32.60 from pot
*** SUMMARY ***
Total pot $34.30 | Rake $1.70 
Board [3c Kd 4s Kc 5c]
Seat 2: picasso264 (button) showed [Kh 7d] and won ($32.60) with three of a kind, Kings
Seat 3: AironVega (small blind) folded before Flop
Seat 4: DMACM (big blind) showed [6s As] and lost with a pair of Kings
Seat 6: jimjam1979 folded before Flop (didn't bet)




PokerStars Game #47185765072:  Hold'em No Limit ($1/$2 USD) - 2010/07/23 23:56:29 ET
Table 'Strenua' 6-max Seat #6 is the button
Seat 1: neni85 ($209.60 in chips) 
Seat 2: AironVega ($40 in chips) 
Seat 3: jenny12346 ($128.45 in chips) 
Seat 4: tdiddy ($109.15 in chips) 
Seat 5: AillemKall ($51 in chips) 
Seat 6: C6Z06 2GO ($123.65 in chips) 
neni85: posts small blind $1
AironVega: posts big blind $2
*** HOLE CARDS ***
jenny12346: folds 
tdiddy: raises $3 to $5
AillemKall: folds 
C6Z06 2GO: folds 
neni85: raises $11 to $16
AironVega: folds 
tdiddy: calls $11
*** FLOP *** [Ah 7h 5h]
neni85: bets $22
tdiddy: folds 
Uncalled bet ($22) returned to neni85
neni85 collected $32.30 from pot
neni85: doesn't show hand 
*** SUMMARY ***
Total pot $34 | Rake $1.70 
Board [Ah 7h 5h]
Seat 1: neni85 (small blind) collected ($32.30)
Seat 2: AironVega (big blind) folded before Flop
Seat 3: jenny12346 folded before Flop (didn't bet)
Seat 4: tdiddy folded on the Flop
Seat 5: AillemKall folded before Flop (didn't bet)
Seat 6: C6Z06 2GO (button) folded before Flop (didn't bet)




PokerStars Game #47185770073:  Hold'em No Limit ($1/$2 USD) - 2010/07/23 23:56:44 ET
Table 'Maia III' 6-max Seat #2 is the button
Seat 1: thomaswkm ($192.35 in chips) 
Seat 2: FrAnWaN ($368.65 in chips) 
Seat 3: dertaylor ($247.25 in chips) 
Seat 4: TODO ADENTR0 ($221 in chips) 
Seat 5: DURKADURDUR ($200 in chips) 
Seat 6: hellokittery ($219.40 in chips) 
dertaylor: posts small blind $1
TODO ADENTR0: posts big blind $2
*** HOLE CARDS ***
DURKADURDUR: raises $4 to $6
hellokittery: raises $12 to $18
thomaswkm: folds 
FrAnWaN: folds 
dertaylor: folds 
TODO ADENTR0: folds 
DURKADURDUR: folds 
Uncalled bet ($12) returned to hellokittery
hellokittery collected $15 from pot
hellokittery: doesn't show hand 
*** SUMMARY ***
Total pot $15 | Rake $0 
Seat 1: thomaswkm folded before Flop (didn't bet)
Seat 2: FrAnWaN (button) folded before Flop (didn't bet)
Seat 3: dertaylor (small blind) folded before Flop
Seat 4: TODO ADENTR0 (big blind) folded before Flop
Seat 5: DURKADURDUR folded before Flop
Seat 6: hellokittery collected ($15)




PokerStars Game #47185798511:  Hold'em No Limit ($1/$2 USD) - 2010/07/23 23:58:09 ET
Table 'Natalie' 6-max Seat #5 is the button
Seat 2: himself609 ($104 in chips) 
Seat 3: THEDUTCH4141 ($259 in chips) 
Seat 5: FastEddie267 ($209.60 in chips) 
Seat 6: leukehond ($220.90 in chips) 
leukehond: posts small blind $1
himself609: posts big blind $2
*** HOLE CARDS ***
THEDUTCH4141: folds 
FastEddie267: raises $4 to $6
leukehond: calls $5
himself609: calls $4
*** FLOP *** [2d 3d Ts]
leukehond: checks 
himself609: bets $4
FastEddie267: folds 
Jetize joins the table at seat #4 
leukehond: calls $4
*** TURN *** [2d 3d Ts] [8c]
leukehond: checks 
himself609: bets $8
leukehond: folds 
Uncalled bet ($8) returned to himself609
himself609 collected $24.75 from pot
*** SUMMARY ***
Total pot $26 | Rake $1.25 
Board [2d 3d Ts 8c]
Seat 2: himself609 (big blind) collected ($24.75)
Seat 3: THEDUTCH4141 folded before Flop (didn't bet)
Seat 5: FastEddie267 (button) folded on the Flop
Seat 6: leukehond (small blind) folded on the Turn




PokerStars Game #47185791088:  Hold'em No Limit ($1/$2 USD) - 2010/07/23 23:57:47 ET
Table 'Neckar VII' 6-max Seat #3 is the button
Seat 1: Marker275 ($201.35 in chips) 
Seat 2: DURKADURDUR ($278.10 in chips) 
Seat 3: TODO ADENTR0 ($395.25 in chips) 
Seat 4: THEDUTCH4141 ($209.55 in chips) 
Seat 5: FastEddie267 ($242 in chips) 
Seat 6: botano ($100 in chips) 
THEDUTCH4141: posts small blind $1
FastEddie267: posts big blind $2
*** HOLE CARDS ***
botano: folds 
Marker275: raises $4 to $6
DURKADURDUR: folds 
TODO ADENTR0: folds 
THEDUTCH4141: raises $16 to $22
FastEddie267: folds 
Marker275: folds 
Uncalled bet ($16) returned to THEDUTCH4141
THEDUTCH4141 collected $14 from pot
THEDUTCH4141: doesn't show hand 
*** SUMMARY ***
Total pot $14 | Rake $0 
Seat 1: Marker275 folded before Flop
Seat 2: DURKADURDUR folded before Flop (didn't bet)
Seat 3: TODO ADENTR0 (button) folded before Flop (didn't bet)
Seat 4: THEDUTCH4141 (small blind) collected ($14)
Seat 5: FastEddie267 (big blind) folded before Flop
Seat 6: botano folded before Flop (didn't bet)




PokerStars Game #47185761348:  Hold'em No Limit ($1/$2 USD) - 2010/07/23 23:56:18 ET
Table 'Katanga II' 6-max Seat #1 is the button
Seat 1: beargood ($140.70 in chips) 
Seat 2: generaaltrab ($128.55 in chips) 
Seat 3: BounceSower ($39.70 in chips) 
Seat 4: kaomaaje ($40.55 in chips) 
Seat 5: Revolucion51 ($193.50 in chips) 
Seat 6: neni85 ($102.65 in chips) 
generaaltrab: posts small blind $1
BounceSower: posts big blind $2
*** HOLE CARDS ***
kaomaaje: raises $2 to $4
Revolucion51: folds 
neni85: folds 
beargood: folds 
generaaltrab: folds 
BounceSower: calls $2
*** FLOP *** [6s 6c Ac]
BounceSower: bets $4
kaomaaje: folds 
Uncalled bet ($4) returned to BounceSower
BounceSower collected $8.55 from pot
*** SUMMARY ***
Total pot $9 | Rake $0.45 
Board [6s 6c Ac]
Seat 1: beargood (button) folded before Flop (didn't bet)
Seat 2: generaaltrab (small blind) folded before Flop
Seat 3: BounceSower (big blind) collected ($8.55)
Seat 4: kaomaaje folded on the Flop
Seat 5: Revolucion51 folded before Flop (didn't bet)
Seat 6: neni85 folded before Flop (didn't bet)




PokerStars Game #47185813638:  Hold'em No Limit ($1/$2 USD) - 2010/07/23 23:58:54 ET
Table 'Menelaus II' 6-max Seat #4 is the button
Seat 3: JJ888168 ($42 in chips) 
Seat 4: mzosh ($224.65 in chips) 
Seat 5: tdiddy ($152.25 in chips) 
tdiddy: posts small blind $1
JJ888168: posts big blind $2
*** HOLE CARDS ***
mzosh: raises $2 to $4
tdiddy: folds 
JJ888168: calls $2
*** FLOP *** [Ad Qh 9h]
JJ888168: checks 
mzosh: checks 
*** TURN *** [Ad Qh 9h] [Tc]
JJ888168: checks 
mzosh: bets $6
JJ888168: calls $6
*** RIVER *** [Ad Qh 9h Tc] [Ac]
JJ888168: checks 
mzosh: checks 
*** SHOW DOWN ***
JJ888168: shows [3d Qd] (two pair, Aces and Queens)
mzosh: shows [2c Qc] (two pair, Aces and Queens)
JJ888168 collected $10 from pot
mzosh collected $10 from pot
*** SUMMARY ***
Total pot $21 | Rake $1 
Board [Ad Qh 9h Tc Ac]
Seat 3: JJ888168 (big blind) showed [3d Qd] and won ($10) with two pair, Aces and Queens
Seat 4: mzosh (button) showed [2c Qc] and won ($10) with two pair, Aces and Queens
Seat 5: tdiddy (small blind) folded before Flop




PokerStars Game #47185791341:  Hold'em No Limit ($1/$2 USD) - 2010/07/23 23:57:48 ET
Table 'Orthosie II' 6-max Seat #2 is the button
Seat 1: neni85 ($490.45 in chips) 
Seat 2: harujongil ($89.65 in chips) 
Seat 3: mpm135 ($40 in chips) 
Seat 4: spiderfrank ($94.10 in chips) 
Seat 5: LeoFara ($46.40 in chips) 
Seat 6: onitsuaf ($79.90 in chips) 
mpm135: posts small blind $1
spiderfrank: posts big blind $2
*** HOLE CARDS ***
LeoFara: folds 
onitsuaf: raises $4 to $6
neni85: folds 
harujongil: calls $6
mpm135: folds 
spiderfrank: folds 
*** FLOP *** [3c 4d Jd]
onitsuaf: checks 
harujongil: bets $9
onitsuaf: calls $9
*** TURN *** [3c 4d Jd] [Tc]
onitsuaf: checks 
harujongil: bets $20
onitsuaf: calls $20
*** RIVER *** [3c 4d Jd Tc] [2h]
onitsuaf: checks 
harujongil: checks 
*** SHOW DOWN ***
onitsuaf: shows [Qs Qc] (a pair of Queens)
harujongil: mucks hand 
onitsuaf collected $70 from pot
*** SUMMARY ***
Total pot $73 | Rake $3 
Board [3c 4d Jd Tc 2h]
Seat 1: neni85 folded before Flop (didn't bet)
Seat 2: harujongil (button) mucked
Seat 3: mpm135 (small blind) folded before Flop
Seat 4: spiderfrank (big blind) folded before Flop
Seat 5: LeoFara folded before Flop (didn't bet)
Seat 6: onitsuaf showed [Qs Qc] and won ($70) with a pair of Queens




PokerStars Game #47185766821:  Hold'em No Limit ($1/$2 USD) - 2010/07/23 23:56:34 ET
Table 'Laocoon III' 6-max Seat #1 is the button
Seat 1: 1tormentor ($294.35 in chips) 
Seat 2: angryjamman ($163.85 in chips) 
Seat 3: TODO ADENTR0 ($212.90 in chips) 
Seat 4: Fierytycoon ($200 in chips) 
Seat 5: DURKADURDUR ($200 in chips) 
Seat 6: FrAnWaN ($339.45 in chips) 
angryjamman: posts small blind $1
TODO ADENTR0: posts big blind $2
*** HOLE CARDS ***
Fierytycoon: folds 
DURKADURDUR: folds 
FrAnWaN: raises $4 to $6
1tormentor: folds 
angryjamman: folds 
TODO ADENTR0: raises $14 to $20
FrAnWaN: folds 
Uncalled bet ($14) returned to TODO ADENTR0
TODO ADENTR0 collected $13 from pot
TODO ADENTR0: doesn't show hand 
*** SUMMARY ***
Total pot $13 | Rake $0 
Seat 1: 1tormentor (button) folded before Flop (didn't bet)
Seat 2: angryjamman (small blind) folded before Flop
Seat 3: TODO ADENTR0 (big blind) collected ($13)
Seat 4: Fierytycoon folded before Flop (didn't bet)
Seat 5: DURKADURDUR folded before Flop (didn't bet)
Seat 6: FrAnWaN folded before Flop




PokerStars Game #47185809049:  Hold'em No Limit ($1/$2 USD) - 2010/07/23 23:58:40 ET
Table 'Laocoon III' 6-max Seat #4 is the button
Seat 1: 1tormentor ($294.35 in chips) 
Seat 2: angryjamman ($180.15 in chips) 
Seat 3: TODO ADENTR0 ($221.90 in chips) 
Seat 4: Fierytycoon ($200 in chips) 
Seat 5: DURKADURDUR ($200 in chips) 
Seat 6: FrAnWaN ($317.45 in chips) 
DURKADURDUR: posts small blind $1
FrAnWaN: posts big blind $2
*** HOLE CARDS ***
1tormentor: folds 
angryjamman: calls $2
TODO ADENTR0: folds 
Fierytycoon: raises $6 to $8
DURKADURDUR: folds 
FrAnWaN: folds 
angryjamman: folds 
Uncalled bet ($6) returned to Fierytycoon
Fierytycoon collected $7 from pot
Fierytycoon: doesn't show hand 
*** SUMMARY ***
Total pot $7 | Rake $0 
Seat 1: 1tormentor folded before Flop (didn't bet)
Seat 2: angryjamman folded before Flop
Seat 3: TODO ADENTR0 folded before Flop (didn't bet)
Seat 4: Fierytycoon (button) collected ($7)
Seat 5: DURKADURDUR (small blind) folded before Flop
Seat 6: FrAnWaN (big blind) folded before Flop




PokerStars Game #47185770018:  Hold'em No Limit ($1/$2 USD) - 2010/07/23 23:56:44 ET
Table 'Natalie' 6-max Seat #6 is the button
Seat 3: THEDUTCH4141 ($200 in chips) 
Seat 5: FastEddie267 ($212.60 in chips) 
Seat 6: leukehond ($222.90 in chips) 
THEDUTCH4141: posts small blind $1
FastEddie267: posts big blind $2
*** HOLE CARDS ***
leukehond: folds 
himself609 joins the table at seat #2 
THEDUTCH4141: raises $4 to $6
FastEddie267: folds 
Uncalled bet ($4) returned to THEDUTCH4141
THEDUTCH4141 collected $4 from pot
THEDUTCH4141: doesn't show hand 
*** SUMMARY ***
Total pot $4 | Rake $0 
Seat 3: THEDUTCH4141 (small blind) collected ($4)
Seat 5: FastEddie267 (big blind) folded before Flop
Seat 6: leukehond (button) folded before Flop (didn't bet)




PokerStars Game #47185790836:  Hold'em No Limit ($1/$2 USD) - 2010/07/23 23:57:46 ET
Table 'Menelaus II' 6-max Seat #5 is the button
Seat 4: mzosh ($221.15 in chips) 
Seat 5: tdiddy ($156.25 in chips) 
tdiddy: posts small blind $1
sp4taxes: is sitting out 
mzosh: posts big blind $2
*** HOLE CARDS ***
sp4taxes leaves the table
tdiddy: folds 
Uncalled bet ($1) returned to mzosh
mzosh collected $2 from pot
mzosh: doesn't show hand 
*** SUMMARY ***
Total pot $2 | Rake $0 
Seat 4: mzosh (big blind) collected ($2)
Seat 5: tdiddy (button) (small blind) folded before Flop




