PokerStars Hand #157346128518:  Hold'em No Limit ($0.05/$0.10 USD) - 2016/08/24 19:39:16 ET
Table 'Pallas' 6-max Seat #2 is the button
Seat 2: lefty0130 ($10.73 in chips)
Seat 4: jerseydanny ($9.62 in chips)
Seat 5: tapouttazz9 ($13.70 in chips)
Seat 6: jbay97 ($13.89 in chips)
dougwid will be allowed to play after the button
jerseydanny: posts small blind $0.05
tapouttazz9: posts big blind $0.10
bethere1923: sits out
*** HOLE CARDS ***
Dealt to tapouttazz9 [7d Td]
jbay97: folds
lefty0130: folds
jerseydanny: folds
Uncalled bet ($0.05) returned to tapouttazz9
tapouttazz9 collected $0.10 from pot
*** SUMMARY ***
Total pot $0.10 | Rake $0
Seat 2: lefty0130 (button) folded before Flop (didn't bet)
Seat 4: jerseydanny (small blind) folded before Flop
Seat 5: tapouttazz9 (big blind) collected ($0.10)
Seat 6: jbay97 folded before Flop (didn't bet)


PokerStars Hand #157346128566:  Hold'em No Limit ($0.05/$0.10 USD) - 2016/08/24 19:39:25 ET
Table 'Pallas' 6-max Seat #4 is the button
Seat 2: lefty0130 ($10.73 in chips)
Seat 3: dougwid ($10 in chips)
Seat 4: jerseydanny ($9.57 in chips)
Seat 5: tapouttazz9 ($13.75 in chips)
Seat 6: jbay97 ($13.89 in chips)
tapouttazz9: posts small blind $0.05
jbay97: posts big blind $0.10
bethere1923: sits out
dougwid: posts big blind $0.10
*** HOLE CARDS ***
Dealt to tapouttazz9 [3s 4d]
lefty0130: calls $0.10
dougwid: checks
jerseydanny: folds
tapouttazz9: folds
jbay97: checks
*** FLOP *** [Jc 4h Th]
jbay97: checks
lefty0130: bets $0.33
dougwid: folds
jbay97: calls $0.33
*** TURN *** [Jc 4h Th] [7d]
jbay97: checks
lefty0130: checks
*** RIVER *** [Jc 4h Th 7d] [5c]
jbay97: bets $0.30
lefty0130: calls $0.30
*** SHOW DOWN ***
jbay97: shows [6d Jh] (a pair of Jacks)
lefty0130: mucks hand
jbay97 collected $1.53 from pot
*** SUMMARY ***
Total pot $1.61 | Rake $0.08
Board [Jc 4h Th 7d 5c]
Seat 2: lefty0130 mucked [9s Ts]
Seat 3: dougwid folded on the Flop
Seat 4: jerseydanny (button) folded before Flop (didn't bet)
Seat 5: tapouttazz9 (small blind) folded before Flop
Seat 6: jbay97 (big blind) showed [6d Jh] and won ($1.53) with a pair of Jacks


PokerStars Hand #157346128811:  Hold'em No Limit ($0.05/$0.10 USD) - 2016/08/24 19:40:13 ET
Table 'Pallas' 6-max Seat #5 is the button
Seat 1: bethere1923 ($10 in chips)
Seat 2: lefty0130 ($10 in chips)
Seat 3: dougwid ($9.90 in chips)
Seat 4: jerseydanny ($9.57 in chips)
Seat 5: tapouttazz9 ($13.70 in chips)
Seat 6: jbay97 ($14.69 in chips)
jbay97: posts small blind $0.05
bethere1923: posts big blind $0.10
*** HOLE CARDS ***
Dealt to tapouttazz9 [6c Jh]
lefty0130: folds
dougwid: folds
jerseydanny: folds
tapouttazz9: folds
jbay97: calls $0.05
bethere1923: checks
*** FLOP *** [Th 4s Ts]
jbay97: checks
bethere1923: checks
*** TURN *** [Th 4s Ts] [9d]
jbay97: checks
bethere1923: bets $0.20
jbay97: folds
Uncalled bet ($0.20) returned to bethere1923
bethere1923 collected $0.19 from pot
*** SUMMARY ***
Total pot $0.20 | Rake $0.01
Board [Th 4s Ts 9d]
Seat 1: bethere1923 (big blind) collected ($0.19)
Seat 2: lefty0130 folded before Flop (didn't bet)
Seat 3: dougwid folded before Flop (didn't bet)
Seat 4: jerseydanny folded before Flop (didn't bet)
Seat 5: tapouttazz9 (button) folded before Flop (didn't bet)
Seat 6: jbay97 (small blind) folded on the Turn


PokerStars Hand #157346129034:  Hold'em No Limit ($0.05/$0.10 USD) - 2016/08/24 19:40:57 ET
Table 'Pallas' 6-max Seat #6 is the button
Seat 1: bethere1923 ($10.09 in chips)
Seat 2: lefty0130 ($10 in chips)
Seat 3: dougwid ($9.90 in chips)
Seat 4: jerseydanny ($9.57 in chips)
Seat 5: tapouttazz9 ($13.70 in chips)
Seat 6: jbay97 ($14.59 in chips)
bethere1923: posts small blind $0.05
lefty0130: posts big blind $0.10
*** HOLE CARDS ***
Dealt to tapouttazz9 [Jc 7c]
dougwid: folds
jerseydanny: folds
tapouttazz9: folds
jbay97: raises $0.10 to $0.20
bethere1923: folds
lefty0130: calls $0.10
*** FLOP *** [Qc 6s 2h]
lefty0130: checks
jbay97: checks
*** TURN *** [Qc 6s 2h] [7h]
lefty0130: checks
jbay97: checks
*** RIVER *** [Qc 6s 2h 7h] [4d]
lefty0130: checks
jbay97: checks
*** SHOW DOWN ***
lefty0130: shows [Kh As] (high card Ace)
jbay97: mucks hand
lefty0130 collected $0.43 from pot
*** SUMMARY ***
Total pot $0.45 | Rake $0.02
Board [Qc 6s 2h 7h 4d]
Seat 1: bethere1923 (small blind) folded before Flop
Seat 2: lefty0130 (big blind) showed [Kh As] and won ($0.43) with high card Ace
Seat 3: dougwid folded before Flop (didn't bet)
Seat 4: jerseydanny folded before Flop (didn't bet)
Seat 5: tapouttazz9 folded before Flop (didn't bet)
Seat 6: jbay97 (button) mucked [9h Js]


PokerStars Hand #157346129191:  Hold'em No Limit ($0.05/$0.10 USD) - 2016/08/24 19:41:29 ET
Table 'Pallas' 6-max Seat #1 is the button
Seat 1: bethere1923 ($10.04 in chips)
Seat 2: lefty0130 ($10.23 in chips)
Seat 3: dougwid ($9.90 in chips)
Seat 4: jerseydanny ($9.57 in chips)
Seat 5: tapouttazz9 ($13.70 in chips)
Seat 6: jbay97 ($14.39 in chips)
lefty0130: posts small blind $0.05
dougwid: posts big blind $0.10
*** HOLE CARDS ***
Dealt to tapouttazz9 [Ah 2d]
jerseydanny: folds
tapouttazz9: folds
jbay97: folds
bethere1923: folds
lefty0130: calls $0.05
dougwid: raises $0.20 to $0.30
lefty0130: folds
Uncalled bet ($0.20) returned to dougwid
dougwid collected $0.20 from pot
dougwid: doesn't show hand
*** SUMMARY ***
Total pot $0.20 | Rake $0
Seat 1: bethere1923 (button) folded before Flop (didn't bet)
Seat 2: lefty0130 (small blind) folded before Flop
Seat 3: dougwid (big blind) collected ($0.20)
Seat 4: jerseydanny folded before Flop (didn't bet)
Seat 5: tapouttazz9 folded before Flop (didn't bet)
Seat 6: jbay97 folded before Flop (didn't bet)


PokerStars Hand #157346129413:  Hold'em No Limit ($0.05/$0.10 USD) - 2016/08/24 19:42:10 ET
Table 'Pallas' 6-max Seat #2 is the button
Seat 1: bethere1923 ($10.04 in chips)
Seat 2: lefty0130 ($10.13 in chips)
Seat 3: dougwid ($10 in chips)
Seat 4: jerseydanny ($9.57 in chips)
Seat 5: tapouttazz9 ($13.70 in chips)
Seat 6: jbay97 ($14.39 in chips)
dougwid: posts small blind $0.05
jerseydanny: posts big blind $0.10
*** HOLE CARDS ***
Dealt to tapouttazz9 [6s 4d]
tapouttazz9: folds
jbay97: folds
bethere1923: folds
lefty0130: folds
dougwid: folds
Uncalled bet ($0.05) returned to jerseydanny
jerseydanny collected $0.10 from pot
jerseydanny: doesn't show hand
*** SUMMARY ***
Total pot $0.10 | Rake $0
Seat 1: bethere1923 folded before Flop (didn't bet)
Seat 2: lefty0130 (button) folded before Flop (didn't bet)
Seat 3: dougwid (small blind) folded before Flop
Seat 4: jerseydanny (big blind) collected ($0.10)
Seat 5: tapouttazz9 folded before Flop (didn't bet)
Seat 6: jbay97 folded before Flop (didn't bet)


PokerStars Hand #157346129454:  Hold'em No Limit ($0.05/$0.10 USD) - 2016/08/24 19:42:19 ET
Table 'Pallas' 6-max Seat #3 is the button
Seat 1: bethere1923 ($10.04 in chips)
Seat 2: lefty0130 ($10.13 in chips)
Seat 3: dougwid ($9.95 in chips)
Seat 4: jerseydanny ($9.62 in chips)
Seat 5: tapouttazz9 ($13.70 in chips)
Seat 6: jbay97 ($14.39 in chips)
jerseydanny: posts small blind $0.05
tapouttazz9: posts big blind $0.10
*** HOLE CARDS ***
Dealt to tapouttazz9 [8h Th]
jbay97: folds
bethere1923: folds
lefty0130: calls $0.10
dougwid: folds
jerseydanny: calls $0.05
tapouttazz9: checks
*** FLOP *** [8s 2c 5c]
jerseydanny: checks
tapouttazz9: checks
lefty0130: checks
*** TURN *** [8s 2c 5c] [Kh]
jerseydanny: checks
tapouttazz9: checks
lefty0130: bets $0.28
jerseydanny: folds
tapouttazz9: folds
Uncalled bet ($0.28) returned to lefty0130
lefty0130 collected $0.28 from pot
lefty0130: doesn't show hand
*** SUMMARY ***
Total pot $0.30 | Rake $0.02
Board [8s 2c 5c Kh]
Seat 1: bethere1923 folded before Flop (didn't bet)
Seat 2: lefty0130 collected ($0.28)
Seat 3: dougwid (button) folded before Flop (didn't bet)
Seat 4: jerseydanny (small blind) folded on the Turn
Seat 5: tapouttazz9 (big blind) folded on the Turn
Seat 6: jbay97 folded before Flop (didn't bet)


PokerStars Hand #157346129782:  Hold'em No Limit ($0.05/$0.10 USD) - 2016/08/24 19:43:26 ET
Table 'Pallas' 6-max Seat #4 is the button
Seat 1: bethere1923 ($10.04 in chips)
Seat 2: lefty0130 ($10.31 in chips)
Seat 3: dougwid ($9.95 in chips)
Seat 4: jerseydanny ($9.52 in chips)
Seat 5: tapouttazz9 ($13.60 in chips)
Seat 6: jbay97 ($14.39 in chips)
tapouttazz9: posts small blind $0.05
jbay97: posts big blind $0.10
*** HOLE CARDS ***
Dealt to tapouttazz9 [2d 4h]
bethere1923: folds
lefty0130: folds
dougwid: folds
jerseydanny: raises $0.25 to $0.35
tapouttazz9: folds
jbay97: folds
Uncalled bet ($0.25) returned to jerseydanny
jerseydanny collected $0.25 from pot
jerseydanny: doesn't show hand
*** SUMMARY ***
Total pot $0.25 | Rake $0
Seat 1: bethere1923 folded before Flop (didn't bet)
Seat 2: lefty0130 folded before Flop (didn't bet)
Seat 3: dougwid folded before Flop (didn't bet)
Seat 4: jerseydanny (button) collected ($0.25)
Seat 5: tapouttazz9 (small blind) folded before Flop
Seat 6: jbay97 (big blind) folded before Flop


PokerStars Hand #157346129856:  Hold'em No Limit ($0.05/$0.10 USD) - 2016/08/24 19:43:40 ET
Table 'Pallas' 6-max Seat #5 is the button
Seat 1: bethere1923 ($10.04 in chips)
Seat 2: lefty0130 ($10.31 in chips)
Seat 3: dougwid ($9.95 in chips)
Seat 4: jerseydanny ($9.67 in chips)
Seat 5: tapouttazz9 ($13.55 in chips)
Seat 6: jbay97 ($14.29 in chips)
jbay97: posts small blind $0.05
bethere1923: posts big blind $0.10
*** HOLE CARDS ***
Dealt to tapouttazz9 [Js 7s]
lefty0130: folds
dougwid: folds
jerseydanny: folds
tapouttazz9: raises $0.20 to $0.30
jbay97: folds
bethere1923: folds
Uncalled bet ($0.20) returned to tapouttazz9
tapouttazz9 collected $0.25 from pot
*** SUMMARY ***
Total pot $0.25 | Rake $0
Seat 1: bethere1923 (big blind) folded before Flop
Seat 2: lefty0130 folded before Flop (didn't bet)
Seat 3: dougwid folded before Flop (didn't bet)
Seat 4: jerseydanny folded before Flop (didn't bet)
Seat 5: tapouttazz9 (button) collected ($0.25)
Seat 6: jbay97 (small blind) folded before Flop


PokerStars Hand #157346129980:  Hold'em No Limit ($0.05/$0.10 USD) - 2016/08/24 19:44:07 ET
Table 'Pallas' 6-max Seat #6 is the button
Seat 1: bethere1923 ($9.94 in chips)
Seat 2: lefty0130 ($10.31 in chips)
Seat 3: dougwid ($9.95 in chips)
Seat 4: jerseydanny ($9.67 in chips)
Seat 5: tapouttazz9 ($13.70 in chips)
Seat 6: jbay97 ($14.24 in chips)
bethere1923: posts small blind $0.05
lefty0130: posts big blind $0.10
*** HOLE CARDS ***
Dealt to tapouttazz9 [Tc 5s]
dougwid: folds
jerseydanny: folds
tapouttazz9: folds
jbay97: raises $0.10 to $0.20
bethere1923: folds
lefty0130: calls $0.10
*** FLOP *** [7s 4d 3d]
lefty0130: checks
jbay97: checks
*** TURN *** [7s 4d 3d] [Js]
lefty0130: checks
jbay97: bets $0.21
lefty0130: calls $0.21
*** RIVER *** [7s 4d 3d Js] [6h]
lefty0130: checks
jbay97: checks
*** SHOW DOWN ***
lefty0130: shows [8c Kc] (high card King)
jbay97: shows [Qc Kh] (high card King - Queen kicker)
jbay97 collected $0.83 from pot
*** SUMMARY ***
Total pot $0.87 | Rake $0.04
Board [7s 4d 3d Js 6h]
Seat 1: bethere1923 (small blind) folded before Flop
Seat 2: lefty0130 (big blind) showed [8c Kc] and lost with high card King
Seat 3: dougwid folded before Flop (didn't bet)
Seat 4: jerseydanny folded before Flop (didn't bet)
Seat 5: tapouttazz9 folded before Flop (didn't bet)
Seat 6: jbay97 (button) showed [Qc Kh] and won ($0.83) with high card King


PokerStars Hand #157347404177:  Hold'em No Limit ($0.05/$0.10 USD) - 2016/08/24 19:44:44 ET
Table 'Pallas' 6-max Seat #1 is the button
Seat 1: bethere1923 ($9.89 in chips)
Seat 2: lefty0130 ($9.90 in chips)
Seat 3: dougwid ($9.95 in chips)
Seat 4: jerseydanny ($9.67 in chips)
Seat 5: tapouttazz9 ($13.70 in chips)
Seat 6: jbay97 ($14.66 in chips)
lefty0130: posts small blind $0.05
dougwid: posts big blind $0.10
*** HOLE CARDS ***
Dealt to tapouttazz9 [3c 5h]
jerseydanny: folds
tapouttazz9: folds
jbay97: folds
bethere1923: raises $0.20 to $0.30
jerseydanny leaves the table
lefty0130: calls $0.25
AbstractS0ul joins the table at seat #4
dougwid: folds
*** FLOP *** [Jd 2c 5c]
lefty0130: checks
bethere1923: bets $0.40
lefty0130: calls $0.40
*** TURN *** [Jd 2c 5c] [4c]
lefty0130: checks
bethere1923: checks
*** RIVER *** [Jd 2c 5c 4c] [Qc]
lefty0130: checks
bethere1923: bets $1.10
lefty0130: folds
Uncalled bet ($1.10) returned to bethere1923
bethere1923 collected $1.42 from pot
*** SUMMARY ***
Total pot $1.50 | Rake $0.08
Board [Jd 2c 5c 4c Qc]
Seat 1: bethere1923 (button) collected ($1.42)
Seat 2: lefty0130 (small blind) folded on the River
Seat 3: dougwid (big blind) folded before Flop
Seat 4: jerseydanny folded before Flop (didn't bet)
Seat 5: tapouttazz9 folded before Flop (didn't bet)
Seat 6: jbay97 folded before Flop (didn't bet)


PokerStars Hand #157347404486:  Hold'em No Limit ($0.05/$0.10 USD) - 2016/08/24 19:45:41 ET
Table 'Pallas' 6-max Seat #2 is the button
Seat 1: bethere1923 ($10.61 in chips)
Seat 2: lefty0130 ($9.20 in chips)
Seat 3: dougwid ($9.85 in chips)
Seat 4: AbstractS0ul ($10 in chips)
Seat 5: tapouttazz9 ($13.70 in chips)
Seat 6: jbay97 ($14.66 in chips)
dougwid: posts small blind $0.05
AbstractS0ul: posts big blind $0.10
*** HOLE CARDS ***
Dealt to tapouttazz9 [2c Td]
tapouttazz9: folds
jbay97: raises $0.10 to $0.20
bethere1923: raises $0.40 to $0.60
lefty0130: folds
dougwid: folds
AbstractS0ul: folds
jbay97: folds
Uncalled bet ($0.40) returned to bethere1923
bethere1923 collected $0.55 from pot
*** SUMMARY ***
Total pot $0.55 | Rake $0
Seat 1: bethere1923 collected ($0.55)
Seat 2: lefty0130 (button) folded before Flop (didn't bet)
Seat 3: dougwid (small blind) folded before Flop
Seat 4: AbstractS0ul (big blind) folded before Flop
Seat 5: tapouttazz9 folded before Flop (didn't bet)
Seat 6: jbay97 folded before Flop


PokerStars Hand #157347404618:  Hold'em No Limit ($0.05/$0.10 USD) - 2016/08/24 19:46:05 ET
Table 'Pallas' 6-max Seat #3 is the button
Seat 1: bethere1923 ($10.96 in chips)
Seat 2: lefty0130 ($10 in chips)
Seat 3: dougwid ($9.80 in chips)
Seat 4: AbstractS0ul ($10 in chips)
Seat 5: tapouttazz9 ($13.70 in chips)
Seat 6: jbay97 ($14.46 in chips)
AbstractS0ul: posts small blind $0.05
tapouttazz9: posts big blind $0.10
*** HOLE CARDS ***
Dealt to tapouttazz9 [9c 6c]
jbay97: folds
bethere1923: folds
lefty0130: folds
dougwid: folds
AbstractS0ul: folds
Uncalled bet ($0.05) returned to tapouttazz9
tapouttazz9 collected $0.10 from pot
*** SUMMARY ***
Total pot $0.10 | Rake $0
Seat 1: bethere1923 folded before Flop (didn't bet)
Seat 2: lefty0130 folded before Flop (didn't bet)
Seat 3: dougwid (button) folded before Flop (didn't bet)
Seat 4: AbstractS0ul (small blind) folded before Flop
Seat 5: tapouttazz9 (big blind) collected ($0.10)
Seat 6: jbay97 folded before Flop (didn't bet)


PokerStars Hand #157347404730:  Hold'em No Limit ($0.05/$0.10 USD) - 2016/08/24 19:46:27 ET
Table 'Pallas' 6-max Seat #4 is the button
Seat 1: bethere1923 ($10.96 in chips)
Seat 2: lefty0130 ($10 in chips)
Seat 3: dougwid ($9.80 in chips)
Seat 4: AbstractS0ul ($10 in chips)
Seat 5: tapouttazz9 ($13.75 in chips)
Seat 6: jbay97 ($14.46 in chips)
tapouttazz9: posts small blind $0.05
jbay97: posts big blind $0.10
*** HOLE CARDS ***
Dealt to tapouttazz9 [6s As]
bethere1923: folds
lefty0130: calls $0.10
dougwid: raises $0.35 to $0.45
AbstractS0ul: folds
tapouttazz9: calls $0.40
jbay97: folds
lefty0130: calls $0.35
*** FLOP *** [7h 9d Ks]
tapouttazz9: checks
lefty0130: checks
dougwid: bets $1.38
tapouttazz9: folds
lefty0130: folds
Uncalled bet ($1.38) returned to dougwid
dougwid collected $1.38 from pot
dougwid: doesn't show hand
*** SUMMARY ***
Total pot $1.45 | Rake $0.07
Board [7h 9d Ks]
Seat 1: bethere1923 folded before Flop (didn't bet)
Seat 2: lefty0130 folded on the Flop
Seat 3: dougwid collected ($1.38)
Seat 4: AbstractS0ul (button) folded before Flop (didn't bet)
Seat 5: tapouttazz9 (small blind) folded on the Flop
Seat 6: jbay97 (big blind) folded before Flop


PokerStars Hand #157347405002:  Hold'em No Limit ($0.05/$0.10 USD) - 2016/08/24 19:47:22 ET
Table 'Pallas' 6-max Seat #5 is the button
Seat 1: bethere1923 ($10.96 in chips)
Seat 2: lefty0130 ($9.55 in chips)
Seat 3: dougwid ($10.73 in chips)
Seat 4: AbstractS0ul ($10 in chips)
Seat 5: tapouttazz9 ($13.30 in chips)
Seat 6: jbay97 ($14.36 in chips)
jbay97: posts small blind $0.05
bethere1923: posts big blind $0.10
*** HOLE CARDS ***
Dealt to tapouttazz9 [Js 6h]
lefty0130: folds
dougwid: folds
AbstractS0ul: folds
tapouttazz9: folds
jbay97: folds
Uncalled bet ($0.05) returned to bethere1923
bethere1923 collected $0.10 from pot
*** SUMMARY ***
Total pot $0.10 | Rake $0
Seat 1: bethere1923 (big blind) collected ($0.10)
Seat 2: lefty0130 folded before Flop (didn't bet)
Seat 3: dougwid folded before Flop (didn't bet)
Seat 4: AbstractS0ul folded before Flop (didn't bet)
Seat 5: tapouttazz9 (button) folded before Flop (didn't bet)
Seat 6: jbay97 (small blind) folded before Flop


PokerStars Hand #157347405091:  Hold'em No Limit ($0.05/$0.10 USD) - 2016/08/24 19:47:41 ET
Table 'Pallas' 6-max Seat #6 is the button
Seat 1: bethere1923 ($11.01 in chips)
Seat 2: lefty0130 ($10 in chips)
Seat 3: dougwid ($10.73 in chips)
Seat 4: AbstractS0ul ($10 in chips)
Seat 5: tapouttazz9 ($13.30 in chips)
Seat 6: jbay97 ($14.31 in chips)
bethere1923: posts small blind $0.05
lefty0130: posts big blind $0.10
*** HOLE CARDS ***
Dealt to tapouttazz9 [8s Kc]
dougwid: folds
AbstractS0ul: folds
tapouttazz9: folds
jbay97: raises $0.10 to $0.20
bethere1923: folds
lefty0130: calls $0.10
*** FLOP *** [3d 9c 3c]
lefty0130: bets $0.43
jbay97: folds
Uncalled bet ($0.43) returned to lefty0130
lefty0130 collected $0.43 from pot
lefty0130: doesn't show hand
*** SUMMARY ***
Total pot $0.45 | Rake $0.02
Board [3d 9c 3c]
Seat 1: bethere1923 (small blind) folded before Flop
Seat 2: lefty0130 (big blind) collected ($0.43)
Seat 3: dougwid folded before Flop (didn't bet)
Seat 4: AbstractS0ul folded before Flop (didn't bet)
Seat 5: tapouttazz9 folded before Flop (didn't bet)
Seat 6: jbay97 (button) folded on the Flop


PokerStars Hand #157347405267:  Hold'em No Limit ($0.05/$0.10 USD) - 2016/08/24 19:48:20 ET
Table 'Pallas' 6-max Seat #1 is the button
Seat 1: bethere1923 ($10.96 in chips)
Seat 2: lefty0130 ($10.23 in chips)
Seat 3: dougwid ($10.73 in chips)
Seat 4: AbstractS0ul ($10 in chips)
Seat 5: tapouttazz9 ($13.30 in chips)
Seat 6: jbay97 ($14.11 in chips)
lefty0130: posts small blind $0.05
dougwid: posts big blind $0.10
*** HOLE CARDS ***
Dealt to tapouttazz9 [Qs 5s]
AbstractS0ul: folds
tapouttazz9: folds
jbay97: folds
bethere1923: folds
lefty0130: calls $0.05
dougwid: raises $0.20 to $0.30
lefty0130: folds
Uncalled bet ($0.20) returned to dougwid
dougwid collected $0.20 from pot
dougwid: doesn't show hand
*** SUMMARY ***
Total pot $0.20 | Rake $0
Seat 1: bethere1923 (button) folded before Flop (didn't bet)
Seat 2: lefty0130 (small blind) folded before Flop
Seat 3: dougwid (big blind) collected ($0.20)
Seat 4: AbstractS0ul folded before Flop (didn't bet)
Seat 5: tapouttazz9 folded before Flop (didn't bet)
Seat 6: jbay97 folded before Flop (didn't bet)


PokerStars Hand #157347405421:  Hold'em No Limit ($0.05/$0.10 USD) - 2016/08/24 19:48:52 ET
Table 'Pallas' 6-max Seat #2 is the button
Seat 1: bethere1923 ($10.96 in chips)
Seat 2: lefty0130 ($10.13 in chips)
Seat 3: dougwid ($10.83 in chips)
Seat 4: AbstractS0ul ($10 in chips)
Seat 5: tapouttazz9 ($13.30 in chips)
Seat 6: jbay97 ($14.11 in chips)
dougwid: posts small blind $0.05
AbstractS0ul: posts big blind $0.10
*** HOLE CARDS ***
Dealt to tapouttazz9 [7s 5h]
tapouttazz9: folds
jbay97: folds
bethere1923: folds
lefty0130: folds
dougwid: folds
Uncalled bet ($0.05) returned to AbstractS0ul
AbstractS0ul collected $0.10 from pot
*** SUMMARY ***
Total pot $0.10 | Rake $0
Seat 1: bethere1923 folded before Flop (didn't bet)
Seat 2: lefty0130 (button) folded before Flop (didn't bet)
Seat 3: dougwid (small blind) folded before Flop
Seat 4: AbstractS0ul (big blind) collected ($0.10)
Seat 5: tapouttazz9 folded before Flop (didn't bet)
Seat 6: jbay97 folded before Flop (didn't bet)


PokerStars Hand #157347405491:  Hold'em No Limit ($0.05/$0.10 USD) - 2016/08/24 19:49:07 ET
Table 'Pallas' 6-max Seat #3 is the button
Seat 1: bethere1923 ($10.96 in chips)
Seat 2: lefty0130 ($10.13 in chips)
Seat 3: dougwid ($10.78 in chips)
Seat 4: AbstractS0ul ($10.05 in chips)
Seat 5: tapouttazz9 ($13.30 in chips)
Seat 6: jbay97 ($14.11 in chips)
AbstractS0ul: posts small blind $0.05
tapouttazz9: posts big blind $0.10
*** HOLE CARDS ***
Dealt to tapouttazz9 [Td 9s]
jbay97: folds
bethere1923: raises $0.20 to $0.30
lefty0130: folds
dougwid: folds
AbstractS0ul: calls $0.25
tapouttazz9: calls $0.20
*** FLOP *** [Kh 2c 5h]
AbstractS0ul: checks
tapouttazz9: checks
bethere1923: checks
*** TURN *** [Kh 2c 5h] [Qc]
AbstractS0ul: checks
tapouttazz9: checks
bethere1923: bets $0.40
AbstractS0ul: folds
tapouttazz9: folds
Uncalled bet ($0.40) returned to bethere1923
bethere1923 collected $0.86 from pot
*** SUMMARY ***
Total pot $0.90 | Rake $0.04
Board [Kh 2c 5h Qc]
Seat 1: bethere1923 collected ($0.86)
Seat 2: lefty0130 folded before Flop (didn't bet)
Seat 3: dougwid (button) folded before Flop (didn't bet)
Seat 4: AbstractS0ul (small blind) folded on the Turn
Seat 5: tapouttazz9 (big blind) folded on the Turn
Seat 6: jbay97 folded before Flop (didn't bet)


PokerStars Hand #157347405736:  Hold'em No Limit ($0.05/$0.10 USD) - 2016/08/24 19:49:53 ET
Table 'Pallas' 6-max Seat #4 is the button
Seat 1: bethere1923 ($11.52 in chips)
Seat 2: lefty0130 ($10.13 in chips)
Seat 3: dougwid ($10.78 in chips)
Seat 4: AbstractS0ul ($10 in chips)
Seat 5: tapouttazz9 ($13 in chips)
Seat 6: jbay97 ($14.11 in chips)
tapouttazz9: posts small blind $0.05
jbay97: posts big blind $0.10
*** HOLE CARDS ***
Dealt to tapouttazz9 [8c As]
bethere1923: folds
lefty0130: folds
dougwid: folds
AbstractS0ul: raises $0.15 to $0.25
tapouttazz9: calls $0.20
jbay97: calls $0.15
*** FLOP *** [Th Td Qs]
tapouttazz9: checks
jbay97: checks
AbstractS0ul: checks
*** TURN *** [Th Td Qs] [5d]
tapouttazz9: checks
jbay97: bets $0.35
AbstractS0ul: calls $0.35
tapouttazz9: folds
*** RIVER *** [Th Td Qs 5d] [Jh]
jbay97: checks
AbstractS0ul: bets $0.69
jbay97: calls $0.69
*** SHOW DOWN ***
AbstractS0ul: shows [Kd Qc] (two pair, Queens and Tens)
jbay97: mucks hand
AbstractS0ul collected $2.69 from pot
*** SUMMARY ***
Total pot $2.83 | Rake $0.14
Board [Th Td Qs 5d Jh]
Seat 1: bethere1923 folded before Flop (didn't bet)
Seat 2: lefty0130 folded before Flop (didn't bet)
Seat 3: dougwid folded before Flop (didn't bet)
Seat 4: AbstractS0ul (button) showed [Kd Qc] and won ($2.69) with two pair, Queens and Tens
Seat 5: tapouttazz9 (small blind) folded on the Turn
Seat 6: jbay97 (big blind) mucked [6c 5h]


PokerStars Hand #157347406019:  Hold'em No Limit ($0.05/$0.10 USD) - 2016/08/24 19:50:48 ET
Table 'Pallas' 6-max Seat #5 is the button
Seat 1: bethere1923 ($11.52 in chips)
Seat 2: lefty0130 ($10.13 in chips)
Seat 3: dougwid ($10.78 in chips)
Seat 4: AbstractS0ul ($11.40 in chips)
Seat 5: tapouttazz9 ($12.75 in chips)
Seat 6: jbay97 ($12.82 in chips)
jbay97: posts small blind $0.05
bethere1923: posts big blind $0.10
*** HOLE CARDS ***
Dealt to tapouttazz9 [4s Kc]
lefty0130: calls $0.10
dougwid: folds
AbstractS0ul: folds
tapouttazz9: folds
jbay97: calls $0.05
bethere1923: checks
*** FLOP *** [8c Ac Kd]
jbay97: checks
bethere1923: checks
lefty0130: checks
*** TURN *** [8c Ac Kd] [5d]
jbay97: checks
bethere1923: bets $0.13
lefty0130: calls $0.13
jbay97: calls $0.13
*** RIVER *** [8c Ac Kd 5d] [2s]
jbay97: checks
bethere1923: bets $0.40
lefty0130: folds
jbay97: folds
Uncalled bet ($0.40) returned to bethere1923
bethere1923 collected $0.66 from pot
*** SUMMARY ***
Total pot $0.69 | Rake $0.03
Board [8c Ac Kd 5d 2s]
Seat 1: bethere1923 (big blind) collected ($0.66)
Seat 2: lefty0130 folded on the River
Seat 3: dougwid folded before Flop (didn't bet)
Seat 4: AbstractS0ul folded before Flop (didn't bet)
Seat 5: tapouttazz9 (button) folded before Flop (didn't bet)
Seat 6: jbay97 (small blind) folded on the River


PokerStars Hand #157347406421:  Hold'em No Limit ($0.05/$0.10 USD) - 2016/08/24 19:52:00 ET
Table 'Pallas' 6-max Seat #6 is the button
Seat 1: bethere1923 ($11.95 in chips)
Seat 3: dougwid ($10.78 in chips)
Seat 4: AbstractS0ul ($11.40 in chips)
Seat 5: tapouttazz9 ($12.75 in chips)
Seat 6: jbay97 ($12.59 in chips)
bethere1923: posts small blind $0.05
lefty0130: is sitting out
dougwid: posts big blind $0.10
*** HOLE CARDS ***
Dealt to tapouttazz9 [Js Ah]
AbstractS0ul: raises $0.15 to $0.25
tapouttazz9: calls $0.25
jbay97: folds
lefty0130 leaves the table
bethere1923: calls $0.20
dougwid: folds
*** FLOP *** [3h 9s Jd]
bethere1923: checks
AbstractS0ul: bets $0.53
tapouttazz9: raises $1.07 to $1.60
john08757 joins the table at seat #2
bethere1923: calls $1.60
AbstractS0ul: folds
*** TURN *** [3h 9s Jd] [8c]
bethere1923: checks
tapouttazz9: checks
*** RIVER *** [3h 9s Jd 8c] [6d]
bethere1923: checks
tapouttazz9: checks
*** SHOW DOWN ***
bethere1923: shows [Jh Ad] (a pair of Jacks)
tapouttazz9: shows [Js Ah] (a pair of Jacks)
bethere1923 collected $2.18 from pot
tapouttazz9 collected $2.17 from pot
*** SUMMARY ***
Total pot $4.58 | Rake $0.23
Board [3h 9s Jd 8c 6d]
Seat 1: bethere1923 (small blind) showed [Jh Ad] and won ($2.18) with a pair of Jacks
Seat 3: dougwid (big blind) folded before Flop
Seat 4: AbstractS0ul folded on the Flop
Seat 5: tapouttazz9 showed [Js Ah] and won ($2.17) with a pair of Jacks
Seat 6: jbay97 (button) folded before Flop (didn't bet)


PokerStars Hand #157347406850:  Hold'em No Limit ($0.05/$0.10 USD) - 2016/08/24 19:53:23 ET
Table 'Pallas' 6-max Seat #1 is the button
Seat 1: bethere1923 ($12.28 in chips)
Seat 3: dougwid ($10.68 in chips)
Seat 4: AbstractS0ul ($10.62 in chips)
Seat 5: tapouttazz9 ($13.07 in chips)
Seat 6: jbay97 ($12.59 in chips)
john08757 will be allowed to play after the button
dougwid: posts small blind $0.05
AbstractS0ul: posts big blind $0.10
*** HOLE CARDS ***
Dealt to tapouttazz9 [Ks Tc]
tapouttazz9: folds
jbay97: raises $0.10 to $0.20
bethere1923: folds
dougwid: folds
AbstractS0ul: folds
Uncalled bet ($0.10) returned to jbay97
jbay97 collected $0.25 from pot
jbay97: doesn't show hand
*** SUMMARY ***
Total pot $0.25 | Rake $0
Seat 1: bethere1923 (button) folded before Flop (didn't bet)
Seat 3: dougwid (small blind) folded before Flop
Seat 4: AbstractS0ul (big blind) folded before Flop
Seat 5: tapouttazz9 folded before Flop (didn't bet)
Seat 6: jbay97 collected ($0.25)


PokerStars Hand #157347406923:  Hold'em No Limit ($0.05/$0.10 USD) - 2016/08/24 19:53:36 ET
Table 'Pallas' 6-max Seat #3 is the button
Seat 1: bethere1923 ($12.28 in chips)
Seat 2: john08757 ($4 in chips)
Seat 3: dougwid ($10.63 in chips)
Seat 4: AbstractS0ul ($10.52 in chips)
Seat 5: tapouttazz9 ($13.07 in chips)
Seat 6: jbay97 ($12.74 in chips)
AbstractS0ul: posts small blind $0.05
tapouttazz9: posts big blind $0.10
john08757: posts big blind $0.10
*** HOLE CARDS ***
Dealt to tapouttazz9 [Ad Qh]
jbay97: folds
bethere1923: folds
john08757: checks
dougwid: folds
AbstractS0ul: folds
tapouttazz9: checks
*** FLOP *** [Kh Js 3h]
tapouttazz9: checks
john08757: checks
*** TURN *** [Kh Js 3h] [8h]
tapouttazz9: checks
john08757: checks
*** RIVER *** [Kh Js 3h 8h] [6h]
tapouttazz9: bets $0.30
john08757: folds
Uncalled bet ($0.30) returned to tapouttazz9
tapouttazz9 collected $0.24 from pot
*** SUMMARY ***
Total pot $0.25 | Rake $0.01
Board [Kh Js 3h 8h 6h]
Seat 1: bethere1923 folded before Flop (didn't bet)
Seat 2: john08757 folded on the River
Seat 3: dougwid (button) folded before Flop (didn't bet)
Seat 4: AbstractS0ul (small blind) folded before Flop
Seat 5: tapouttazz9 (big blind) collected ($0.24)
Seat 6: jbay97 folded before Flop (didn't bet)


PokerStars Hand #157347407214:  Hold'em No Limit ($0.05/$0.10 USD) - 2016/08/24 19:54:28 ET
Table 'Pallas' 6-max Seat #4 is the button
Seat 1: bethere1923 ($12.28 in chips)
Seat 2: john08757 ($3.90 in chips)
Seat 3: dougwid ($10.63 in chips)
Seat 4: AbstractS0ul ($10.47 in chips)
Seat 5: tapouttazz9 ($13.21 in chips)
Seat 6: jbay97 ($12.74 in chips)
tapouttazz9: posts small blind $0.05
jbay97: posts big blind $0.10
*** HOLE CARDS ***
Dealt to tapouttazz9 [Ks 9d]
bethere1923: folds
john08757: raises $0.25 to $0.35
dougwid: folds
AbstractS0ul: folds
tapouttazz9: folds
jbay97: folds
Uncalled bet ($0.25) returned to john08757
john08757 collected $0.25 from pot
john08757: doesn't show hand
*** SUMMARY ***
Total pot $0.25 | Rake $0
Seat 1: bethere1923 folded before Flop (didn't bet)
Seat 2: john08757 collected ($0.25)
Seat 3: dougwid folded before Flop (didn't bet)
Seat 4: AbstractS0ul (button) folded before Flop (didn't bet)
Seat 5: tapouttazz9 (small blind) folded before Flop
Seat 6: jbay97 (big blind) folded before Flop


PokerStars Hand #157347407416:  Hold'em No Limit ($0.05/$0.10 USD) - 2016/08/24 19:55:04 ET
Table 'Pallas' 6-max Seat #5 is the button
Seat 1: bethere1923 ($12.28 in chips)
Seat 2: john08757 ($4.05 in chips)
Seat 3: dougwid ($10.63 in chips)
Seat 4: AbstractS0ul ($10.47 in chips)
Seat 5: tapouttazz9 ($13.16 in chips)
Seat 6: jbay97 ($12.64 in chips)
jbay97: posts small blind $0.05
bethere1923: posts big blind $0.10
*** HOLE CARDS ***
Dealt to tapouttazz9 [Jh 2c]
john08757: raises $0.25 to $0.35
dougwid: folds
AbstractS0ul: folds
tapouttazz9: folds
jbay97: folds
bethere1923: folds
Uncalled bet ($0.25) returned to john08757
john08757 collected $0.25 from pot
john08757: doesn't show hand
*** SUMMARY ***
Total pot $0.25 | Rake $0
Seat 1: bethere1923 (big blind) folded before Flop
Seat 2: john08757 collected ($0.25)
Seat 3: dougwid folded before Flop (didn't bet)
Seat 4: AbstractS0ul folded before Flop (didn't bet)
Seat 5: tapouttazz9 (button) folded before Flop (didn't bet)
Seat 6: jbay97 (small blind) folded before Flop


PokerStars Hand #157347407497:  Hold'em No Limit ($0.05/$0.10 USD) - 2016/08/24 19:55:19 ET
Table 'Pallas' 6-max Seat #6 is the button
Seat 1: bethere1923 ($12.18 in chips)
Seat 2: john08757 ($4.20 in chips)
Seat 3: dougwid ($10.63 in chips)
Seat 4: AbstractS0ul ($10.47 in chips)
Seat 5: tapouttazz9 ($13.16 in chips)
Seat 6: jbay97 ($12.59 in chips)
bethere1923: posts small blind $0.05
john08757: posts big blind $0.10
*** HOLE CARDS ***
Dealt to tapouttazz9 [8d 3h]
dougwid: folds
AbstractS0ul: folds
tapouttazz9: folds
jbay97: folds
bethere1923: calls $0.05
john08757: checks
*** FLOP *** [7d Qs Qc]
bethere1923: checks
john08757: checks
*** TURN *** [7d Qs Qc] [9d]
bethere1923: checks
john08757: checks
*** RIVER *** [7d Qs Qc 9d] [Ad]
bethere1923: bets $0.10
john08757: folds
Uncalled bet ($0.10) returned to bethere1923
bethere1923 collected $0.19 from pot
*** SUMMARY ***
Total pot $0.20 | Rake $0.01
Board [7d Qs Qc 9d Ad]
Seat 1: bethere1923 (small blind) collected ($0.19)
Seat 2: john08757 (big blind) folded on the River
Seat 3: dougwid folded before Flop (didn't bet)
Seat 4: AbstractS0ul folded before Flop (didn't bet)
Seat 5: tapouttazz9 folded before Flop (didn't bet)
Seat 6: jbay97 (button) folded before Flop (didn't bet)


PokerStars Hand #157347407758:  Hold'em No Limit ($0.05/$0.10 USD) - 2016/08/24 19:56:11 ET
Table 'Pallas' 6-max Seat #1 is the button
Seat 1: bethere1923 ($12.27 in chips)
Seat 2: john08757 ($4.10 in chips)
Seat 3: dougwid ($10.63 in chips)
Seat 4: AbstractS0ul ($10.47 in chips)
Seat 5: tapouttazz9 ($13.16 in chips)
Seat 6: jbay97 ($12.59 in chips)
john08757: posts small blind $0.05
dougwid: posts big blind $0.10
*** HOLE CARDS ***
Dealt to tapouttazz9 [Ks 5c]
AbstractS0ul: folds
tapouttazz9: folds
jbay97: folds
bethere1923: folds
john08757: raises $0.20 to $0.30
dougwid: folds
Uncalled bet ($0.20) returned to john08757
john08757 collected $0.20 from pot
john08757: doesn't show hand
*** SUMMARY ***
Total pot $0.20 | Rake $0
Seat 1: bethere1923 (button) folded before Flop (didn't bet)
Seat 2: john08757 (small blind) collected ($0.20)
Seat 3: dougwid (big blind) folded before Flop
Seat 4: AbstractS0ul folded before Flop (didn't bet)
Seat 5: tapouttazz9 folded before Flop (didn't bet)
Seat 6: jbay97 folded before Flop (didn't bet)


PokerStars Hand #157347407841:  Hold'em No Limit ($0.05/$0.10 USD) - 2016/08/24 19:56:27 ET
Table 'Pallas' 6-max Seat #2 is the button
Seat 1: bethere1923 ($12.27 in chips)
Seat 2: john08757 ($4.20 in chips)
Seat 3: dougwid ($10.53 in chips)
Seat 4: AbstractS0ul ($10.47 in chips)
Seat 5: tapouttazz9 ($13.16 in chips)
Seat 6: jbay97 ($12.59 in chips)
dougwid: posts small blind $0.05
AbstractS0ul: posts big blind $0.10
*** HOLE CARDS ***
Dealt to tapouttazz9 [5s Qh]
tapouttazz9: folds
jbay97: folds
bethere1923: folds
john08757: folds
dougwid: folds
Uncalled bet ($0.05) returned to AbstractS0ul
AbstractS0ul collected $0.10 from pot
*** SUMMARY ***
Total pot $0.10 | Rake $0
Seat 1: bethere1923 folded before Flop (didn't bet)
Seat 2: john08757 (button) folded before Flop (didn't bet)
Seat 3: dougwid (small blind) folded before Flop
Seat 4: AbstractS0ul (big blind) collected ($0.10)
Seat 5: tapouttazz9 folded before Flop (didn't bet)
Seat 6: jbay97 folded before Flop (didn't bet)


PokerStars Hand #157347407914:  Hold'em No Limit ($0.05/$0.10 USD) - 2016/08/24 19:56:41 ET
Table 'Pallas' 6-max Seat #3 is the button
Seat 1: bethere1923 ($12.27 in chips)
Seat 2: john08757 ($4.20 in chips)
Seat 3: dougwid ($10.48 in chips)
Seat 4: AbstractS0ul ($10.52 in chips)
Seat 5: tapouttazz9 ($13.16 in chips)
Seat 6: jbay97 ($12.59 in chips)
AbstractS0ul: posts small blind $0.05
tapouttazz9: posts big blind $0.10
*** HOLE CARDS ***
Dealt to tapouttazz9 [6s 7d]
jbay97: folds
bethere1923: folds
john08757: raises $0.10 to $0.20
dougwid: calls $0.20
AbstractS0ul: folds
tapouttazz9: folds
*** FLOP *** [5h 4s 4h]
john08757: checks
dougwid: bets $0.52
john08757: folds
Uncalled bet ($0.52) returned to dougwid
dougwid collected $0.52 from pot
dougwid: doesn't show hand
*** SUMMARY ***
Total pot $0.55 | Rake $0.03
Board [5h 4s 4h]
Seat 1: bethere1923 folded before Flop (didn't bet)
Seat 2: john08757 folded on the Flop
Seat 3: dougwid (button) collected ($0.52)
Seat 4: AbstractS0ul (small blind) folded before Flop
Seat 5: tapouttazz9 (big blind) folded before Flop
Seat 6: jbay97 folded before Flop (didn't bet)


PokerStars Hand #157347408087:  Hold'em No Limit ($0.05/$0.10 USD) - 2016/08/24 19:57:13 ET
Table 'Pallas' 6-max Seat #4 is the button
Seat 1: bethere1923 ($12.27 in chips)
Seat 2: john08757 ($4 in chips)
Seat 3: dougwid ($10.80 in chips)
Seat 4: AbstractS0ul ($10.47 in chips)
Seat 5: tapouttazz9 ($13.06 in chips)
tapouttazz9: posts small blind $0.05
jbay97: is sitting out
bethere1923: posts big blind $0.10
*** HOLE CARDS ***
Dealt to tapouttazz9 [7h Th]
john08757: folds
dougwid: folds
AbstractS0ul: folds
tapouttazz9: folds
Uncalled bet ($0.05) returned to bethere1923
bethere1923 collected $0.10 from pot
*** SUMMARY ***
Total pot $0.10 | Rake $0
Seat 1: bethere1923 (big blind) collected ($0.10)
Seat 2: john08757 folded before Flop (didn't bet)
Seat 3: dougwid folded before Flop (didn't bet)
Seat 4: AbstractS0ul (button) folded before Flop (didn't bet)
Seat 5: tapouttazz9 (small blind) folded before Flop


PokerStars Hand #157347408132:  Hold'em No Limit ($0.05/$0.10 USD) - 2016/08/24 19:57:24 ET
Table 'Pallas' 6-max Seat #5 is the button
Seat 1: bethere1923 ($12.32 in chips)
Seat 2: john08757 ($4 in chips)
Seat 3: dougwid ($10.80 in chips)
Seat 4: AbstractS0ul ($10.47 in chips)
Seat 5: tapouttazz9 ($13.01 in chips)
bethere1923: posts small blind $0.05
john08757: posts big blind $0.10
*** HOLE CARDS ***
Dealt to tapouttazz9 [Qs 4c]
dougwid: folds
AbstractS0ul: folds
tapouttazz9: folds
bethere1923: calls $0.05
john08757: raises $0.20 to $0.30
bethere1923: folds
Uncalled bet ($0.20) returned to john08757
john08757 collected $0.20 from pot
john08757: doesn't show hand
*** SUMMARY ***
Total pot $0.20 | Rake $0
Seat 1: bethere1923 (small blind) folded before Flop
Seat 2: john08757 (big blind) collected ($0.20)
Seat 3: dougwid folded before Flop (didn't bet)
Seat 4: AbstractS0ul folded before Flop (didn't bet)
Seat 5: tapouttazz9 (button) folded before Flop (didn't bet)


PokerStars Hand #157347408223:  Hold'em No Limit ($0.05/$0.10 USD) - 2016/08/24 19:57:43 ET
Table 'Pallas' 6-max Seat #1 is the button
Seat 1: bethere1923 ($12.22 in chips)
Seat 2: john08757 ($4.10 in chips)
Seat 3: dougwid ($10.80 in chips)
Seat 4: AbstractS0ul ($10.47 in chips)
Seat 5: tapouttazz9 ($13.01 in chips)
john08757: posts small blind $0.05
dougwid: posts big blind $0.10
*** HOLE CARDS ***
Dealt to tapouttazz9 [4s Jc]
AbstractS0ul: folds
tapouttazz9: folds
bethere1923: folds
john08757: folds
Uncalled bet ($0.05) returned to dougwid
dougwid collected $0.10 from pot
dougwid: doesn't show hand
*** SUMMARY ***
Total pot $0.10 | Rake $0
Seat 1: bethere1923 (button) folded before Flop (didn't bet)
Seat 2: john08757 (small blind) folded before Flop
Seat 3: dougwid (big blind) collected ($0.10)
Seat 4: AbstractS0ul folded before Flop (didn't bet)
Seat 5: tapouttazz9 folded before Flop (didn't bet)


PokerStars Hand #157347408299:  Hold'em No Limit ($0.05/$0.10 USD) - 2016/08/24 19:58:00 ET
Table 'Pallas' 6-max Seat #2 is the button
Seat 1: bethere1923 ($12.22 in chips)
Seat 2: john08757 ($4.05 in chips)
Seat 3: dougwid ($10.85 in chips)
Seat 4: AbstractS0ul ($10.47 in chips)
Seat 5: tapouttazz9 ($13.01 in chips)
dougwid: posts small blind $0.05
AbstractS0ul: posts big blind $0.10
*** HOLE CARDS ***
Dealt to tapouttazz9 [Tc 9c]
tapouttazz9: raises $0.20 to $0.30
bethere1923: folds
john08757: folds
dougwid: calls $0.25
AbstractS0ul: folds
*** FLOP *** [8s Qd 5c]
dougwid: checks
tapouttazz9: checks
*** TURN *** [8s Qd 5c] [7d]
dougwid: bets $0.66
tapouttazz9: calls $0.66
*** RIVER *** [8s Qd 5c 7d] [Jd]
dougwid: checks
tapouttazz9: bets $1.92
dougwid: folds
Uncalled bet ($1.92) returned to tapouttazz9
tapouttazz9 collected $1.92 from pot
*** SUMMARY ***
Total pot $2.02 | Rake $0.10
Board [8s Qd 5c 7d Jd]
Seat 1: bethere1923 folded before Flop (didn't bet)
Seat 2: john08757 (button) folded before Flop (didn't bet)
Seat 3: dougwid (small blind) folded on the River
Seat 4: AbstractS0ul (big blind) folded before Flop
Seat 5: tapouttazz9 collected ($1.92)


PokerStars Hand #157347408516:  Hold'em No Limit ($0.05/$0.10 USD) - 2016/08/24 19:58:50 ET
Table 'Pallas' 6-max Seat #3 is the button
Seat 1: bethere1923 ($12.22 in chips)
Seat 2: john08757 ($4.05 in chips)
Seat 3: dougwid ($9.89 in chips)
Seat 4: AbstractS0ul ($10.37 in chips)
Seat 5: tapouttazz9 ($13.97 in chips)
AbstractS0ul: posts small blind $0.05
tapouttazz9: posts big blind $0.10
jbay97: sits out
*** HOLE CARDS ***
Dealt to tapouttazz9 [7c 9c]
bethere1923: folds
john08757: folds
dougwid: folds
AbstractS0ul has timed out
AbstractS0ul: folds
Uncalled bet ($0.05) returned to tapouttazz9
tapouttazz9 collected $0.10 from pot
*** SUMMARY ***
Total pot $0.10 | Rake $0
Seat 1: bethere1923 folded before Flop (didn't bet)
Seat 2: john08757 folded before Flop (didn't bet)
Seat 3: dougwid (button) folded before Flop (didn't bet)
Seat 4: AbstractS0ul (small blind) folded before Flop
Seat 5: tapouttazz9 (big blind) collected ($0.10)


PokerStars Hand #157347408815:  Hold'em No Limit ($0.05/$0.10 USD) - 2016/08/24 19:59:59 ET
Table 'Pallas' 6-max Seat #4 is the button
Seat 1: bethere1923 ($12.22 in chips)
Seat 2: john08757 ($4.05 in chips)
Seat 3: dougwid ($10 in chips)
Seat 4: AbstractS0ul ($10.32 in chips)
Seat 5: tapouttazz9 ($14.02 in chips)
Seat 6: jbay97 ($12.59 in chips)
tapouttazz9: posts small blind $0.05
jbay97: posts big blind $0.10
*** HOLE CARDS ***
Dealt to tapouttazz9 [3h 9h]
bethere1923: folds
john08757: folds
dougwid: raises $0.25 to $0.35
AbstractS0ul: folds
tapouttazz9: folds
jbay97: folds
Uncalled bet ($0.25) returned to dougwid
dougwid collected $0.25 from pot
dougwid: doesn't show hand
*** SUMMARY ***
Total pot $0.25 | Rake $0
Seat 1: bethere1923 folded before Flop (didn't bet)
Seat 2: john08757 folded before Flop (didn't bet)
Seat 3: dougwid collected ($0.25)
Seat 4: AbstractS0ul (button) folded before Flop (didn't bet)
Seat 5: tapouttazz9 (small blind) folded before Flop
Seat 6: jbay97 (big blind) folded before Flop


PokerStars Hand #157347408926:  Hold'em No Limit ($0.05/$0.10 USD) - 2016/08/24 20:00:22 ET
Table 'Pallas' 6-max Seat #5 is the button
Seat 1: bethere1923 ($12.22 in chips)
Seat 2: john08757 ($4.05 in chips)
Seat 3: dougwid ($10.15 in chips)
Seat 4: AbstractS0ul ($10.32 in chips)
Seat 5: tapouttazz9 ($13.97 in chips)
Seat 6: jbay97 ($12.49 in chips)
jbay97: posts small blind $0.05
bethere1923: posts big blind $0.10
*** HOLE CARDS ***
Dealt to tapouttazz9 [8s 4d]
john08757: raises $0.25 to $0.35
dougwid: folds
AbstractS0ul: folds
tapouttazz9: folds
jbay97: folds
bethere1923: folds
Uncalled bet ($0.25) returned to john08757
john08757 collected $0.25 from pot
john08757: doesn't show hand
*** SUMMARY ***
Total pot $0.25 | Rake $0
Seat 1: bethere1923 (big blind) folded before Flop
Seat 2: john08757 collected ($0.25)
Seat 3: dougwid folded before Flop (didn't bet)
Seat 4: AbstractS0ul folded before Flop (didn't bet)
Seat 5: tapouttazz9 (button) folded before Flop (didn't bet)
Seat 6: jbay97 (small blind) folded before Flop


PokerStars Hand #157347408996:  Hold'em No Limit ($0.05/$0.10 USD) - 2016/08/24 20:00:39 ET
Table 'Pallas' 6-max Seat #6 is the button
Seat 1: bethere1923 ($12.12 in chips)
Seat 2: john08757 ($4.20 in chips)
Seat 3: dougwid ($10.15 in chips)
Seat 4: AbstractS0ul ($10.32 in chips)
Seat 5: tapouttazz9 ($13.97 in chips)
Seat 6: jbay97 ($12.44 in chips)
bethere1923: posts small blind $0.05
john08757: posts big blind $0.10
*** HOLE CARDS ***
Dealt to tapouttazz9 [2s Jd]
dougwid: raises $0.25 to $0.35
AbstractS0ul: folds
tapouttazz9: folds
jbay97: folds
bethere1923: folds
john08757: folds
Uncalled bet ($0.25) returned to dougwid
dougwid collected $0.25 from pot
dougwid: doesn't show hand
*** SUMMARY ***
Total pot $0.25 | Rake $0
Seat 1: bethere1923 (small blind) folded before Flop
Seat 2: john08757 (big blind) folded before Flop
Seat 3: dougwid collected ($0.25)
Seat 4: AbstractS0ul folded before Flop (didn't bet)
Seat 5: tapouttazz9 folded before Flop (didn't bet)
Seat 6: jbay97 (button) folded before Flop (didn't bet)


PokerStars Hand #157347409107:  Hold'em No Limit ($0.05/$0.10 USD) - 2016/08/24 20:01:00 ET
Table 'Pallas' 6-max Seat #1 is the button
Seat 1: bethere1923 ($12.07 in chips)
Seat 2: john08757 ($4.10 in chips)
Seat 3: dougwid ($10.30 in chips)
Seat 4: AbstractS0ul ($10.32 in chips)
Seat 5: tapouttazz9 ($13.97 in chips)
Seat 6: jbay97 ($12.44 in chips)
john08757: posts small blind $0.05
dougwid: posts big blind $0.10
*** HOLE CARDS ***
Dealt to tapouttazz9 [3h Qs]
AbstractS0ul: folds
tapouttazz9: folds
jbay97: folds
bethere1923: folds
john08757: raises $0.10 to $0.20
dougwid: folds
Uncalled bet ($0.10) returned to john08757
john08757 collected $0.20 from pot
john08757: doesn't show hand
*** SUMMARY ***
Total pot $0.20 | Rake $0
Seat 1: bethere1923 (button) folded before Flop (didn't bet)
Seat 2: john08757 (small blind) collected ($0.20)
Seat 3: dougwid (big blind) folded before Flop
Seat 4: AbstractS0ul folded before Flop (didn't bet)
Seat 5: tapouttazz9 folded before Flop (didn't bet)
Seat 6: jbay97 folded before Flop (didn't bet)


PokerStars Hand #157347409197:  Hold'em No Limit ($0.05/$0.10 USD) - 2016/08/24 20:01:19 ET
Table 'Pallas' 6-max Seat #2 is the button
Seat 1: bethere1923 ($12.07 in chips)
Seat 2: john08757 ($4.20 in chips)
Seat 3: dougwid ($10.20 in chips)
Seat 4: AbstractS0ul ($10.32 in chips)
Seat 5: tapouttazz9 ($13.97 in chips)
Seat 6: jbay97 ($12.44 in chips)
dougwid: posts small blind $0.05
AbstractS0ul: posts big blind $0.10
*** HOLE CARDS ***
Dealt to tapouttazz9 [2s 6s]
tapouttazz9: folds
jbay97: folds
bethere1923: folds
john08757: raises $0.25 to $0.35
dougwid: folds
AbstractS0ul: folds
Uncalled bet ($0.25) returned to john08757
john08757 collected $0.25 from pot
john08757: doesn't show hand
*** SUMMARY ***
Total pot $0.25 | Rake $0
Seat 1: bethere1923 folded before Flop (didn't bet)
Seat 2: john08757 (button) collected ($0.25)
Seat 3: dougwid (small blind) folded before Flop
Seat 4: AbstractS0ul (big blind) folded before Flop
Seat 5: tapouttazz9 folded before Flop (didn't bet)
Seat 6: jbay97 folded before Flop (didn't bet)


PokerStars Hand #157347409268:  Hold'em No Limit ($0.05/$0.10 USD) - 2016/08/24 20:01:33 ET
Table 'Pallas' 6-max Seat #3 is the button
Seat 1: bethere1923 ($12.07 in chips)
Seat 2: john08757 ($4.35 in chips)
Seat 3: dougwid ($10.15 in chips)
Seat 4: AbstractS0ul ($10.22 in chips)
Seat 5: tapouttazz9 ($13.97 in chips)
Seat 6: jbay97 ($12.44 in chips)
AbstractS0ul: posts small blind $0.05
tapouttazz9: posts big blind $0.10
*** HOLE CARDS ***
Dealt to tapouttazz9 [Tc Ks]
jbay97: folds
bethere1923: folds
john08757: folds
dougwid: folds
AbstractS0ul: folds
Uncalled bet ($0.05) returned to tapouttazz9
tapouttazz9 collected $0.10 from pot
*** SUMMARY ***
Total pot $0.10 | Rake $0
Seat 1: bethere1923 folded before Flop (didn't bet)
Seat 2: john08757 folded before Flop (didn't bet)
Seat 3: dougwid (button) folded before Flop (didn't bet)
Seat 4: AbstractS0ul (small blind) folded before Flop
Seat 5: tapouttazz9 (big blind) collected ($0.10)
Seat 6: jbay97 folded before Flop (didn't bet)


PokerStars Hand #157347409338:  Hold'em No Limit ($0.05/$0.10 USD) - 2016/08/24 20:01:49 ET
Table 'Pallas' 6-max Seat #4 is the button
Seat 1: bethere1923 ($12.07 in chips)
Seat 2: john08757 ($4.35 in chips)
Seat 3: dougwid ($10.15 in chips)
Seat 4: AbstractS0ul ($10.17 in chips)
Seat 5: tapouttazz9 ($14.02 in chips)
Seat 6: jbay97 ($12.44 in chips)
tapouttazz9: posts small blind $0.05
jbay97: posts big blind $0.10
*** HOLE CARDS ***
Dealt to tapouttazz9 [8h Js]
bethere1923: folds
john08757: folds
dougwid: folds
AbstractS0ul: raises $0.15 to $0.25
tapouttazz9: folds
jbay97: calls $0.15
*** FLOP *** [Jh Ac As]
jbay97: checks
AbstractS0ul: checks
*** TURN *** [Jh Ac As] [Ks]
jbay97: bets $0.26
AbstractS0ul: calls $0.26
*** RIVER *** [Jh Ac As Ks] [6c]
jbay97: bets $0.40
AbstractS0ul: raises $0.91 to $1.31
jbay97: calls $0.91
*** SHOW DOWN ***
AbstractS0ul: shows [Th Qs] (a straight, Ten to Ace)
jbay97: mucks hand
AbstractS0ul collected $3.51 from pot
*** SUMMARY ***
Total pot $3.69 | Rake $0.18
Board [Jh Ac As Ks 6c]
Seat 1: bethere1923 folded before Flop (didn't bet)
Seat 2: john08757 folded before Flop (didn't bet)
Seat 3: dougwid folded before Flop (didn't bet)
Seat 4: AbstractS0ul (button) showed [Th Qs] and won ($3.51) with a straight, Ten to Ace
Seat 5: tapouttazz9 (small blind) folded before Flop
Seat 6: jbay97 (big blind) mucked [4c 6s]


PokerStars Hand #157347409590:  Hold'em No Limit ($0.05/$0.10 USD) - 2016/08/24 20:02:40 ET
Table 'Pallas' 6-max Seat #5 is the button
Seat 1: bethere1923 ($12.07 in chips)
Seat 2: john08757 ($4.35 in chips)
Seat 3: dougwid ($10.15 in chips)
Seat 4: AbstractS0ul ($11.86 in chips)
Seat 5: tapouttazz9 ($13.97 in chips)
Seat 6: jbay97 ($10.62 in chips)
jbay97: posts small blind $0.05
bethere1923: posts big blind $0.10
*** HOLE CARDS ***
Dealt to tapouttazz9 [Qc Ts]
john08757: raises $0.10 to $0.20
dougwid: folds
AbstractS0ul: folds
tapouttazz9: calls $0.20
jbay97: folds
bethere1923: folds
*** FLOP *** [Qs 9c 3c]
john08757: checks
tapouttazz9: checks
*** TURN *** [Qs 9c 3c] [Kh]
john08757: checks
tapouttazz9: checks
*** RIVER *** [Qs 9c 3c Kh] [Ac]
john08757: checks
tapouttazz9: checks
*** SHOW DOWN ***
john08757: shows [4s 4d] (a pair of Fours)
tapouttazz9: shows [Qc Ts] (a pair of Queens)
tapouttazz9 collected $0.52 from pot
*** SUMMARY ***
Total pot $0.55 | Rake $0.03
Board [Qs 9c 3c Kh Ac]
Seat 1: bethere1923 (big blind) folded before Flop
Seat 2: john08757 showed [4s 4d] and lost with a pair of Fours
Seat 3: dougwid folded before Flop (didn't bet)
Seat 4: AbstractS0ul folded before Flop (didn't bet)
Seat 5: tapouttazz9 (button) showed [Qc Ts] and won ($0.52) with a pair of Queens
Seat 6: jbay97 (small blind) folded before Flop


PokerStars Hand #157347409760:  Hold'em No Limit ($0.05/$0.10 USD) - 2016/08/24 20:03:11 ET
Table 'Pallas' 6-max Seat #6 is the button
Seat 1: bethere1923 ($11.97 in chips)
Seat 2: john08757 ($4.15 in chips)
Seat 3: dougwid ($10.15 in chips)
Seat 4: AbstractS0ul ($11.86 in chips)
Seat 5: tapouttazz9 ($14.29 in chips)
Seat 6: jbay97 ($10.57 in chips)
bethere1923: posts small blind $0.05
john08757: posts big blind $0.10
*** HOLE CARDS ***
Dealt to tapouttazz9 [2d 7c]
dougwid: folds
AbstractS0ul: raises $0.15 to $0.25
tapouttazz9: folds
jbay97: calls $0.25
bethere1923: folds
john08757: calls $0.15
*** FLOP *** [Ah Th 2h]
john08757: checks
AbstractS0ul: checks
jbay97: checks
*** TURN *** [Ah Th 2h] [Js]
john08757: checks
AbstractS0ul: bets $0.38
jbay97: calls $0.38
john08757: folds
*** RIVER *** [Ah Th 2h Js] [5c]
AbstractS0ul: checks
jbay97: checks
*** SHOW DOWN ***
AbstractS0ul: shows [Ts Qh] (a pair of Tens)
jbay97: shows [Jd Qd] (a pair of Jacks)
jbay97 collected $1.48 from pot
*** SUMMARY ***
Total pot $1.56 | Rake $0.08
Board [Ah Th 2h Js 5c]
Seat 1: bethere1923 (small blind) folded before Flop
Seat 2: john08757 (big blind) folded on the Turn
Seat 3: dougwid folded before Flop (didn't bet)
Seat 4: AbstractS0ul showed [Ts Qh] and lost with a pair of Tens
Seat 5: tapouttazz9 folded before Flop (didn't bet)
Seat 6: jbay97 (button) showed [Jd Qd] and won ($1.48) with a pair of Jacks


PokerStars Hand #157348878005:  Hold'em No Limit ($0.05/$0.10 USD) - 2016/08/24 20:04:15 ET
Table 'Pallas' 6-max Seat #1 is the button
Seat 1: bethere1923 ($11.92 in chips)
Seat 2: john08757 ($3.90 in chips)
Seat 3: dougwid ($10.15 in chips)
Seat 4: AbstractS0ul ($11.23 in chips)
Seat 5: tapouttazz9 ($14.29 in chips)
Seat 6: jbay97 ($11.42 in chips)
john08757: posts small blind $0.05
dougwid: posts big blind $0.10
*** HOLE CARDS ***
Dealt to tapouttazz9 [6s 7h]
AbstractS0ul: folds
tapouttazz9: folds
jbay97: folds
bethere1923: folds
john08757: raises $0.10 to $0.20
dougwid: calls $0.10
*** FLOP *** [8d 7d 9d]
john08757: checks
dougwid: bets $0.38
john08757: folds
Uncalled bet ($0.38) returned to dougwid
dougwid collected $0.38 from pot
dougwid: doesn't show hand
*** SUMMARY ***
Total pot $0.40 | Rake $0.02
Board [8d 7d 9d]
Seat 1: bethere1923 (button) folded before Flop (didn't bet)
Seat 2: john08757 (small blind) folded on the Flop
Seat 3: dougwid (big blind) collected ($0.38)
Seat 4: AbstractS0ul folded before Flop (didn't bet)
Seat 5: tapouttazz9 folded before Flop (didn't bet)
Seat 6: jbay97 folded before Flop (didn't bet)


PokerStars Hand #157348878165:  Hold'em No Limit ($0.05/$0.10 USD) - 2016/08/24 20:04:45 ET
Table 'Pallas' 6-max Seat #2 is the button
Seat 1: bethere1923 ($11.92 in chips)
Seat 2: john08757 ($3.70 in chips)
Seat 3: dougwid ($10.33 in chips)
Seat 4: AbstractS0ul ($11.23 in chips)
Seat 5: tapouttazz9 ($14.29 in chips)
Seat 6: jbay97 ($11.42 in chips)
dougwid: posts small blind $0.05
AbstractS0ul: posts big blind $0.10
*** HOLE CARDS ***
Dealt to tapouttazz9 [5h As]
tapouttazz9: folds
jbay97: folds
bethere1923: raises $0.20 to $0.30
john08757: folds
dougwid: folds
AbstractS0ul: folds
Uncalled bet ($0.20) returned to bethere1923
bethere1923 collected $0.25 from pot
*** SUMMARY ***
Total pot $0.25 | Rake $0
Seat 1: bethere1923 collected ($0.25)
Seat 2: john08757 (button) folded before Flop (didn't bet)
Seat 3: dougwid (small blind) folded before Flop
Seat 4: AbstractS0ul (big blind) folded before Flop
Seat 5: tapouttazz9 folded before Flop (didn't bet)
Seat 6: jbay97 folded before Flop (didn't bet)


PokerStars Hand #157348878261:  Hold'em No Limit ($0.05/$0.10 USD) - 2016/08/24 20:05:03 ET
Table 'Pallas' 6-max Seat #3 is the button
Seat 1: bethere1923 ($12.07 in chips)
Seat 2: john08757 ($3.70 in chips)
Seat 3: dougwid ($10.28 in chips)
Seat 4: AbstractS0ul ($11.13 in chips)
Seat 5: tapouttazz9 ($14.29 in chips)
Seat 6: jbay97 ($11.42 in chips)
AbstractS0ul: posts small blind $0.05
tapouttazz9: posts big blind $0.10
*** HOLE CARDS ***
Dealt to tapouttazz9 [6d 3s]
jbay97: folds
bethere1923: folds
john08757: folds
dougwid: folds
AbstractS0ul: folds
Uncalled bet ($0.05) returned to tapouttazz9
tapouttazz9 collected $0.10 from pot
*** SUMMARY ***
Total pot $0.10 | Rake $0
Seat 1: bethere1923 folded before Flop (didn't bet)
Seat 2: john08757 folded before Flop (didn't bet)
Seat 3: dougwid (button) folded before Flop (didn't bet)
Seat 4: AbstractS0ul (small blind) folded before Flop
Seat 5: tapouttazz9 (big blind) collected ($0.10)
Seat 6: jbay97 folded before Flop (didn't bet)


PokerStars Hand #157348878333:  Hold'em No Limit ($0.05/$0.10 USD) - 2016/08/24 20:05:17 ET
Table 'Pallas' 6-max Seat #4 is the button
Seat 1: bethere1923 ($12.07 in chips)
Seat 2: john08757 ($3.70 in chips)
Seat 3: dougwid ($10.28 in chips)
Seat 4: AbstractS0ul ($11.08 in chips)
Seat 5: tapouttazz9 ($14.34 in chips)
Seat 6: jbay97 ($11.42 in chips)
tapouttazz9: posts small blind $0.05
jbay97: posts big blind $0.10
*** HOLE CARDS ***
Dealt to tapouttazz9 [8c Qd]
bethere1923: folds
john08757: folds
dougwid: raises $0.25 to $0.35
AbstractS0ul: calls $0.35
tapouttazz9: folds
jbay97: raises $1.10 to $1.45
dougwid: calls $1.10
AbstractS0ul: folds
*** FLOP *** [7c Ad 6c]
jbay97: checks
dougwid: checks
*** TURN *** [7c Ad 6c] [4s]
jbay97: bets $1.40
dougwid: folds
Uncalled bet ($1.40) returned to jbay97
jbay97 collected $3.14 from pot
jbay97: doesn't show hand
*** SUMMARY ***
Total pot $3.30 | Rake $0.16
Board [7c Ad 6c 4s]
Seat 1: bethere1923 folded before Flop (didn't bet)
Seat 2: john08757 folded before Flop (didn't bet)
Seat 3: dougwid folded on the Turn
Seat 4: AbstractS0ul (button) folded before Flop
Seat 5: tapouttazz9 (small blind) folded before Flop
Seat 6: jbay97 (big blind) collected ($3.14)


PokerStars Hand #157348878605:  Hold'em No Limit ($0.05/$0.10 USD) - 2016/08/24 20:06:04 ET
Table 'Pallas' 6-max Seat #5 is the button
Seat 1: bethere1923 ($12.07 in chips)
Seat 2: john08757 ($3.70 in chips)
Seat 3: dougwid ($10 in chips)
Seat 4: AbstractS0ul ($10.73 in chips)
Seat 5: tapouttazz9 ($14.29 in chips)
Seat 6: jbay97 ($13.11 in chips)
jbay97: posts small blind $0.05
bethere1923: posts big blind $0.10
*** HOLE CARDS ***
Dealt to tapouttazz9 [3s 2c]
john08757: folds
dougwid: folds
AbstractS0ul: folds
tapouttazz9: folds
jbay97: folds
Uncalled bet ($0.05) returned to bethere1923
bethere1923 collected $0.10 from pot
*** SUMMARY ***
Total pot $0.10 | Rake $0
Seat 1: bethere1923 (big blind) collected ($0.10)
Seat 2: john08757 folded before Flop (didn't bet)
Seat 3: dougwid folded before Flop (didn't bet)
Seat 4: AbstractS0ul folded before Flop (didn't bet)
Seat 5: tapouttazz9 (button) folded before Flop (didn't bet)
Seat 6: jbay97 (small blind) folded before Flop


PokerStars Hand #152311923163:  Hold'em No Limit ($0.01/$0.02 USD) - 2016/05/02 16:57:06 ET
Table 'Delphinus' 6-max Seat #1 is the button
Seat 1: quarto1963 ($1.61 in chips)
Seat 2: tapouttazz9 ($2 in chips)
quarto1963: posts small blind $0.01
tapouttazz9: posts big blind $0.02
*** HOLE CARDS ***
Dealt to tapouttazz9 [Ks Ad]
quarto1963: raises $0.04 to $0.06
tapouttazz9: raises $1.94 to $2 and is all-in
quarto1963: folds [6h 6d]
Uncalled bet ($1.94) returned to tapouttazz9
tapouttazz9 collected $0.12 from pot
tapouttazz9: doesn't show hand
*** SUMMARY ***
Total pot $0.12 | Rake $0
Seat 1: quarto1963 (button) (small blind) folded before Flop
Seat 2: tapouttazz9 (big blind) collected ($0.12)


PokerStars Hand #152311923233:  Hold'em No Limit ($0.01/$0.02 USD) - 2016/05/02 16:57:31 ET
Table 'Delphinus' 6-max Seat #2 is the button
Seat 1: quarto1963 ($1.55 in chips)
Seat 2: tapouttazz9 ($2.06 in chips)
tapouttazz9: posts small blind $0.01
quarto1963: posts big blind $0.02
*** HOLE CARDS ***
Dealt to tapouttazz9 [6s 4c]
tapouttazz9: folds
Uncalled bet ($0.01) returned to quarto1963
quarto1963 collected $0.02 from pot
quarto1963: doesn't show hand
*** SUMMARY ***
Total pot $0.02 | Rake $0
Seat 1: quarto1963 (big blind) collected ($0.02)
Seat 2: tapouttazz9 (button) (small blind) folded before Flop


PokerStars Hand #152311923248:  Hold'em No Limit ($0.01/$0.02 USD) - 2016/05/02 16:57:36 ET
Table 'Delphinus' 6-max Seat #1 is the button
Seat 1: quarto1963 ($1.56 in chips)
Seat 2: tapouttazz9 ($2.05 in chips)
quarto1963: posts small blind $0.01
tapouttazz9: posts big blind $0.02
*** HOLE CARDS ***
Dealt to tapouttazz9 [9s Th]
quarto1963: calls $0.01
tapouttazz9: checks
*** FLOP *** [4c Tc Jh]
tapouttazz9: checks
quarto1963: bets $0.02
tapouttazz9: raises $0.02 to $0.04
quarto1963: calls $0.02
*** TURN *** [4c Tc Jh] [8d]
tapouttazz9: checks
quarto1963: checks
*** RIVER *** [4c Tc Jh 8d] [8h]
tapouttazz9: checks
quarto1963: checks
*** SHOW DOWN ***
tapouttazz9: shows [9s Th] (two pair, Tens and Eights)
quarto1963: shows [6h Jc] (two pair, Jacks and Eights)
quarto1963 collected $0.11 from pot
*** SUMMARY ***
Total pot $0.12 | Rake $0.01
Board [4c Tc Jh 8d 8h]
Seat 1: quarto1963 (button) (small blind) showed [6h Jc] and won ($0.11) with two pair, Jacks and Eights
Seat 2: tapouttazz9 (big blind) showed [9s Th] and lost with two pair, Tens and Eights


PokerStars Hand #152311923392:  Hold'em No Limit ($0.01/$0.02 USD) - 2016/05/02 16:58:30 ET
Table 'Delphinus' 6-max Seat #2 is the button
Seat 1: quarto1963 ($1.61 in chips)
Seat 2: tapouttazz9 ($1.99 in chips)
tapouttazz9: posts small blind $0.01
quarto1963: posts big blind $0.02
*** HOLE CARDS ***
Dealt to tapouttazz9 [4h 9d]
tapouttazz9: folds
Uncalled bet ($0.01) returned to quarto1963
quarto1963 collected $0.02 from pot
quarto1963: doesn't show hand
*** SUMMARY ***
Total pot $0.02 | Rake $0
Seat 1: quarto1963 (big blind) collected ($0.02)
Seat 2: tapouttazz9 (button) (small blind) folded before Flop


PokerStars Hand #152311923415:  Hold'em No Limit ($0.01/$0.02 USD) - 2016/05/02 16:58:36 ET
Table 'Delphinus' 6-max Seat #1 is the button
Seat 1: quarto1963 ($1.62 in chips)
Seat 2: tapouttazz9 ($1.98 in chips)
quarto1963: posts small blind $0.01
tapouttazz9: posts big blind $0.02
*** HOLE CARDS ***
Dealt to tapouttazz9 [3d 9s]
quarto1963: calls $0.01
tapouttazz9: checks
*** FLOP *** [7h 4d 8c]
tapouttazz9: checks
quarto1963: bets $0.02
tapouttazz9: folds
Uncalled bet ($0.02) returned to quarto1963
quarto1963 collected $0.04 from pot
quarto1963: doesn't show hand
*** SUMMARY ***
Total pot $0.04 | Rake $0
Board [7h 4d 8c]
Seat 1: quarto1963 (button) (small blind) collected ($0.04)
Seat 2: tapouttazz9 (big blind) folded on the Flop


PokerStars Hand #152311923496:  Hold'em No Limit ($0.01/$0.02 USD) - 2016/05/02 16:59:04 ET
Table 'Delphinus' 6-max Seat #2 is the button
Seat 1: quarto1963 ($1.64 in chips)
Seat 2: tapouttazz9 ($1.96 in chips)
tapouttazz9: posts small blind $0.01
quarto1963: posts big blind $0.02
*** HOLE CARDS ***
Dealt to tapouttazz9 [2h 9c]
tapouttazz9: folds
Uncalled bet ($0.01) returned to quarto1963
quarto1963 collected $0.02 from pot
quarto1963: doesn't show hand
*** SUMMARY ***
Total pot $0.02 | Rake $0
Seat 1: quarto1963 (big blind) collected ($0.02)
Seat 2: tapouttazz9 (button) (small blind) folded before Flop


PokerStars Hand #152311923514:  Hold'em No Limit ($0.01/$0.02 USD) - 2016/05/02 16:59:09 ET
Table 'Delphinus' 6-max Seat #1 is the button
Seat 1: quarto1963 ($1.65 in chips)
Seat 2: tapouttazz9 ($1.95 in chips)
quarto1963: posts small blind $0.01
tapouttazz9: posts big blind $0.02
*** HOLE CARDS ***
Dealt to tapouttazz9 [9s Ac]
quarto1963: calls $0.01
tapouttazz9: checks
*** FLOP *** [6c 5h 2s]
tapouttazz9: checks
quarto1963: bets $0.02
tapouttazz9: folds
Uncalled bet ($0.02) returned to quarto1963
quarto1963 collected $0.04 from pot
quarto1963: doesn't show hand
*** SUMMARY ***
Total pot $0.04 | Rake $0
Board [6c 5h 2s]
Seat 1: quarto1963 (button) (small blind) collected ($0.04)
Seat 2: tapouttazz9 (big blind) folded on the Flop


PokerStars Hand #153712627748:  Hold'em No Limit ($0.05/$0.10 USD) - 2016/05/31 15:51:44 ET
Table 'Delphinus' 6-max Seat #1 is the button
Seat 1: #3lynchmob ($12.67 in chips)
Seat 2: gladi8tor333 ($19.26 in chips)
Seat 3: JerseyPS ($10 in chips)
Seat 4: FnSmooth45 ($9.80 in chips)
Seat 5: Ishfaqa1 ($8.51 in chips)
Seat 6: Ghost of NJ ($8.14 in chips)
gladi8tor333: posts small blind $0.05
JerseyPS: posts big blind $0.10
*** HOLE CARDS ***
FnSmooth45: folds
Ishfaqa1: folds
Ghost of NJ: folds
#3lynchmob: raises $0.20 to $0.30
gladi8tor333: calls $0.25
JerseyPS: folds
*** FLOP *** [Kh 7c Jh]
gladi8tor333: bets $0.40
#3lynchmob: calls $0.40
*** TURN *** [Kh 7c Jh] [6d]
gladi8tor333: bets $0.71
#3lynchmob: calls $0.71
*** RIVER *** [Kh 7c Jh 6d] [8c]
gladi8tor333: checks
#3lynchmob: bets $1.38
gladi8tor333: folds
Uncalled bet ($1.38) returned to #3lynchmob
#3lynchmob collected $2.77 from pot
*** SUMMARY ***
Total pot $2.92 | Rake $0.15
Board [Kh 7c Jh 6d 8c]
Seat 1: #3lynchmob (button) collected ($2.77)
Seat 2: gladi8tor333 (small blind) folded on the River
Seat 3: JerseyPS (big blind) folded before Flop
Seat 4: FnSmooth45 folded before Flop (didn't bet)
Seat 5: Ishfaqa1 folded before Flop (didn't bet)
Seat 6: Ghost of NJ folded before Flop (didn't bet)


PokerStars Hand #154858674292:  Hold'em No Limit ($0.01/$0.02 USD) - 2016/06/24 16:06:05 ET
Table 'Delphinus' 6-max Seat #1 is the button
Seat 1: mwnj ($2.13 in chips)
Seat 2: Wildbill4761 ($0.75 in chips)
Seat 3: Freddybnj ($2.23 in chips)
Seat 4: pinnocio ($1.45 in chips)
Seat 5: TY4PAYING ($1.42 in chips)
Seat 6: professa oc ($3.15 in chips)
Wildbill4761: posts small blind $0.01
Freddybnj: posts big blind $0.02
*** HOLE CARDS ***
pinnocio: calls $0.02
TY4PAYING: calls $0.02
professa oc: raises $0.06 to $0.08
mwnj: calls $0.08
Wildbill4761: calls $0.07
Freddybnj: folds
pinnocio: calls $0.06
TY4PAYING: folds
*** FLOP *** [5h Jh 4s]
Wildbill4761: checks
pinnocio: checks
professa oc: bets $0.25
mwnj: raises $0.42 to $0.67
Wildbill4761: folds
pinnocio: folds
professa oc: folds
Uncalled bet ($0.42) returned to mwnj
mwnj collected $0.82 from pot
mwnj: doesn't show hand
*** SUMMARY ***
Total pot $0.86 | Rake $0.04
Board [5h Jh 4s]
Seat 1: mwnj (button) collected ($0.82)
Seat 2: Wildbill4761 (small blind) folded on the Flop
Seat 3: Freddybnj (big blind) folded before Flop
Seat 4: pinnocio folded on the Flop
Seat 5: TY4PAYING folded before Flop
Seat 6: professa oc folded on the Flop


PokerStars Hand #154858674679:  Hold'em No Limit ($0.01/$0.02 USD) - 2016/06/24 16:07:16 ET
Table 'Delphinus' 6-max Seat #2 is the button
Seat 1: mwnj ($2.62 in chips)
Seat 2: Wildbill4761 ($0.67 in chips)
Seat 3: Freddybnj ($2.21 in chips)
Seat 4: pinnocio ($1.37 in chips)
Seat 5: TY4PAYING ($1.40 in chips)
Seat 6: professa oc ($2.82 in chips)
Freddybnj: posts small blind $0.01
pinnocio: posts big blind $0.02
*** HOLE CARDS ***
TY4PAYING: calls $0.02
professa oc: folds
mwnj: folds
Wildbill4761: calls $0.02
Freddybnj: calls $0.01
pinnocio: checks
*** FLOP *** [9s Jc 9h]
Freddybnj: checks
pinnocio: checks
TY4PAYING: bets $0.05
Wildbill4761: calls $0.05
Freddybnj: folds
pinnocio: folds
*** TURN *** [9s Jc 9h] [Tc]
TY4PAYING: bets $0.11
Wildbill4761: folds
Uncalled bet ($0.11) returned to TY4PAYING
TY4PAYING collected $0.17 from pot
TY4PAYING: doesn't show hand
*** SUMMARY ***
Total pot $0.18 | Rake $0.01
Board [9s Jc 9h Tc]
Seat 1: mwnj folded before Flop (didn't bet)
Seat 2: Wildbill4761 (button) folded on the Turn
Seat 3: Freddybnj (small blind) folded on the Flop
Seat 4: pinnocio (big blind) folded on the Flop
Seat 5: TY4PAYING collected ($0.17)
Seat 6: professa oc folded before Flop (didn't bet)


PokerStars Hand #154858674866:  Hold'em No Limit ($0.01/$0.02 USD) - 2016/06/24 16:07:50 ET
Table 'Delphinus' 6-max Seat #3 is the button
Seat 1: mwnj ($2.62 in chips)
Seat 2: Wildbill4761 ($0.60 in chips)
Seat 3: Freddybnj ($2.19 in chips)
Seat 4: pinnocio ($1.35 in chips)
Seat 5: TY4PAYING ($1.50 in chips)
Seat 6: professa oc ($2.82 in chips)
pinnocio: posts small blind $0.01
TY4PAYING: posts big blind $0.02
*** HOLE CARDS ***
professa oc: folds
mwnj: folds
Wildbill4761: calls $0.02
Freddybnj: calls $0.02
pinnocio: calls $0.01
TY4PAYING: checks
*** FLOP *** [Ks 9c 2s]
pinnocio: checks
TY4PAYING: bets $0.02
Wildbill4761: calls $0.02
Freddybnj: raises $0.09 to $0.11
pinnocio: folds
TY4PAYING: calls $0.09
Wildbill4761: folds
*** TURN *** [Ks 9c 2s] [Qs]
TY4PAYING: checks
Freddybnj: bets $0.20
TY4PAYING: raises $0.20 to $0.40
Freddybnj: folds
Uncalled bet ($0.20) returned to TY4PAYING
TY4PAYING collected $0.69 from pot
TY4PAYING: doesn't show hand
*** SUMMARY ***
Total pot $0.72 | Rake $0.03
Board [Ks 9c 2s Qs]
Seat 1: mwnj folded before Flop (didn't bet)
Seat 2: Wildbill4761 folded on the Flop
Seat 3: Freddybnj (button) folded on the Turn
Seat 4: pinnocio (small blind) folded on the Flop
Seat 5: TY4PAYING (big blind) collected ($0.69)
Seat 6: professa oc folded before Flop (didn't bet)


PokerStars Hand #154858675190:  Hold'em No Limit ($0.01/$0.02 USD) - 2016/06/24 16:08:47 ET
Table 'Delphinus' 6-max Seat #4 is the button
Seat 1: mwnj ($2.62 in chips)
Seat 2: Wildbill4761 ($0.56 in chips)
Seat 3: Freddybnj ($1.86 in chips)
Seat 4: pinnocio ($1.33 in chips)
Seat 5: TY4PAYING ($1.86 in chips)
Seat 6: professa oc ($2.82 in chips)
TY4PAYING: posts small blind $0.01
professa oc: posts big blind $0.02
*** HOLE CARDS ***
mwnj: calls $0.02
Wildbill4761: calls $0.02
Freddybnj: raises $0.06 to $0.08
pinnocio: folds
TY4PAYING: folds
professa oc: folds
mwnj: calls $0.06
Wildbill4761: calls $0.06
*** FLOP *** [7s 2s 5d]
mwnj: checks
Wildbill4761: bets $0.02
Freddybnj: raises $0.19 to $0.21
mwnj: folds
Wildbill4761: folds
Uncalled bet ($0.19) returned to Freddybnj
Freddybnj collected $0.30 from pot
Freddybnj: doesn't show hand
*** SUMMARY ***
Total pot $0.31 | Rake $0.01
Board [7s 2s 5d]
Seat 1: mwnj folded on the Flop
Seat 2: Wildbill4761 folded on the Flop
Seat 3: Freddybnj collected ($0.30)
Seat 4: pinnocio (button) folded before Flop (didn't bet)
Seat 5: TY4PAYING (small blind) folded before Flop
Seat 6: professa oc (big blind) folded before Flop


PokerStars Hand #154858675470:  Hold'em No Limit ($0.01/$0.02 USD) - 2016/06/24 16:09:38 ET
Table 'Delphinus' 6-max Seat #5 is the button
Seat 1: mwnj ($2.54 in chips)
Seat 2: Wildbill4761 ($0.46 in chips)
Seat 3: Freddybnj ($2.06 in chips)
Seat 4: pinnocio ($1.33 in chips)
Seat 5: TY4PAYING ($1.85 in chips)
Seat 6: professa oc ($2.80 in chips)
professa oc: posts small blind $0.01
mwnj: posts big blind $0.02
*** HOLE CARDS ***
Wildbill4761: calls $0.02
Freddybnj: raises $0.06 to $0.08
pinnocio: folds
pinnocio leaves the table
TY4PAYING: folds
tapouttazz9 joins the table at seat #4
professa oc: folds
mwnj: folds
Wildbill4761: calls $0.06
*** FLOP *** [2c Jh 5h]
Wildbill4761: checks
Freddybnj: bets $0.11
Wildbill4761: folds
Uncalled bet ($0.11) returned to Freddybnj
Freddybnj collected $0.18 from pot
Freddybnj: doesn't show hand
*** SUMMARY ***
Total pot $0.19 | Rake $0.01
Board [2c Jh 5h]
Seat 1: mwnj (big blind) folded before Flop
Seat 2: Wildbill4761 folded on the Flop
Seat 3: Freddybnj collected ($0.18)
Seat 4: pinnocio folded before Flop (didn't bet)
Seat 5: TY4PAYING (button) folded before Flop (didn't bet)
Seat 6: professa oc (small blind) folded before Flop


PokerStars Hand #154858675669:  Hold'em No Limit ($0.01/$0.02 USD) - 2016/06/24 16:10:12 ET
Table 'Delphinus' 6-max Seat #6 is the button
Seat 1: mwnj ($2.52 in chips)
Seat 2: Wildbill4761 ($0.38 in chips)
Seat 3: Freddybnj ($2.16 in chips)
Seat 5: TY4PAYING ($1.85 in chips)
Seat 6: professa oc ($2.79 in chips)
mwnj: posts small blind $0.01
Wildbill4761: posts big blind $0.02
tapouttazz9: sits out
*** HOLE CARDS ***
Freddybnj: folds
TY4PAYING: folds
professa oc: folds
mwnj: calls $0.01
Wildbill4761: checks
*** FLOP *** [5d Jc 2d]
Freddybnj leaves the table
mwnj: checks
Wildbill4761: bets $0.04
mwnj: calls $0.04
*** TURN *** [5d Jc 2d] [Th]
mwnj: checks
Wildbill4761: bets $0.04
mwnj: folds
Uncalled bet ($0.04) returned to Wildbill4761
Wildbill4761 collected $0.11 from pot
*** SUMMARY ***
Total pot $0.12 | Rake $0.01
Board [5d Jc 2d Th]
Seat 1: mwnj (small blind) folded on the Turn
Seat 2: Wildbill4761 (big blind) collected ($0.11)
Seat 3: Freddybnj folded before Flop (didn't bet)
Seat 5: TY4PAYING folded before Flop (didn't bet)
Seat 6: professa oc (button) folded before Flop (didn't bet)


PokerStars Hand #154858675833:  Hold'em No Limit ($0.01/$0.02 USD) - 2016/06/24 16:10:42 ET
Table 'Delphinus' 6-max Seat #1 is the button
Seat 1: mwnj ($2.46 in chips)
Seat 2: Wildbill4761 ($0.43 in chips)
Seat 4: tapouttazz9 ($2 in chips)
Seat 5: TY4PAYING ($1.85 in chips)
Seat 6: professa oc ($2.79 in chips)
Wildbill4761: posts small blind $0.01
tapouttazz9: posts big blind $0.02
*** HOLE CARDS ***
Dealt to tapouttazz9 [Ah 9c]
TY4PAYING: folds
professa oc: folds
mwnj: raises $0.04 to $0.06
Wildbill4761: calls $0.05
tapouttazz9: calls $0.04
*** FLOP *** [6h Ts 5c]
Wildbill4761: bets $0.02
tapouttazz9: folds
mwnj: raises $0.06 to $0.08
Wildbill4761: calls $0.06
*** TURN *** [6h Ts 5c] [7c]
Wildbill4761: bets $0.29 and is all-in
mwnj: calls $0.29
*** RIVER *** [6h Ts 5c 7c] [7s]
*** SHOW DOWN ***
Wildbill4761: shows [4c 3s] (a straight, Three to Seven)
mwnj: shows [As Tc] (two pair, Tens and Sevens)
Wildbill4761 collected $0.88 from pot
*** SUMMARY ***
Total pot $0.92 | Rake $0.04
Board [6h Ts 5c 7c 7s]
Seat 1: mwnj (button) showed [As Tc] and lost with two pair, Tens and Sevens
Seat 2: Wildbill4761 (small blind) showed [4c 3s] and won ($0.88) with a straight, Three to Seven
Seat 4: tapouttazz9 (big blind) folded on the Flop
Seat 5: TY4PAYING folded before Flop (didn't bet)
Seat 6: professa oc folded before Flop (didn't bet)


PokerStars Hand #154858676187:  Hold'em No Limit ($0.01/$0.02 USD) - 2016/06/24 16:11:46 ET
Table 'Delphinus' 6-max Seat #2 is the button
Seat 1: mwnj ($2.03 in chips)
Seat 2: Wildbill4761 ($0.88 in chips)
Seat 4: tapouttazz9 ($1.94 in chips)
Seat 5: TY4PAYING ($1.85 in chips)
Seat 6: professa oc ($2.79 in chips)
tapouttazz9: posts small blind $0.01
TY4PAYING: posts big blind $0.02
*** HOLE CARDS ***
Dealt to tapouttazz9 [8c 2h]
professa oc: folds
mwnj: calls $0.02
Wildbill4761: calls $0.02
tapouttazz9: folds
TY4PAYING: checks
*** FLOP *** [Ah Ts Js]
TY4PAYING: checks
mwnj: checks
Wildbill4761: bets $0.02
TY4PAYING: folds
mwnj: calls $0.02
*** TURN *** [Ah Ts Js] [Kc]
mwnj: checks
Wildbill4761: bets $0.04
mwnj: folds
Uncalled bet ($0.04) returned to Wildbill4761
Wildbill4761 collected $0.11 from pot
*** SUMMARY ***
Total pot $0.11 | Rake $0
Board [Ah Ts Js Kc]
Seat 1: mwnj folded on the Turn
Seat 2: Wildbill4761 (button) collected ($0.11)
Seat 4: tapouttazz9 (small blind) folded before Flop
Seat 5: TY4PAYING (big blind) folded on the Flop
Seat 6: professa oc folded before Flop (didn't bet)


PokerStars Hand #154858676369:  Hold'em No Limit ($0.01/$0.02 USD) - 2016/06/24 16:12:18 ET
Table 'Delphinus' 6-max Seat #4 is the button
Seat 1: mwnj ($1.99 in chips)
Seat 2: Wildbill4761 ($0.95 in chips)
Seat 4: tapouttazz9 ($1.93 in chips)
Seat 5: TY4PAYING ($1.83 in chips)
Seat 6: professa oc ($2.79 in chips)
TY4PAYING: posts small blind $0.01
professa oc: posts big blind $0.02
*** HOLE CARDS ***
Dealt to tapouttazz9 [2c Jd]
mwnj: folds
Wildbill4761: calls $0.02
tapouttazz9: folds
TY4PAYING: calls $0.01
professa oc: checks
*** FLOP *** [Qd 6c Qc]
TY4PAYING: checks
professa oc: checks
Wildbill4761: checks
*** TURN *** [Qd 6c Qc] [Ah]
TY4PAYING: checks
professa oc: checks
Wildbill4761: checks
*** RIVER *** [Qd 6c Qc Ah] [3h]
TY4PAYING: bets $0.03
professa oc: folds
Wildbill4761: folds
Uncalled bet ($0.03) returned to TY4PAYING
TY4PAYING collected $0.06 from pot
TY4PAYING: doesn't show hand
*** SUMMARY ***
Total pot $0.06 | Rake $0
Board [Qd 6c Qc Ah 3h]
Seat 1: mwnj folded before Flop (didn't bet)
Seat 2: Wildbill4761 folded on the River
Seat 4: tapouttazz9 (button) folded before Flop (didn't bet)
Seat 5: TY4PAYING (small blind) collected ($0.06)
Seat 6: professa oc (big blind) folded on the River


PokerStars Hand #154858676601:  Hold'em No Limit ($0.01/$0.02 USD) - 2016/06/24 16:13:02 ET
Table 'Delphinus' 6-max Seat #5 is the button
Seat 1: mwnj ($1.99 in chips)
Seat 2: Wildbill4761 ($0.93 in chips)
Seat 4: tapouttazz9 ($1.93 in chips)
Seat 5: TY4PAYING ($1.87 in chips)
Seat 6: professa oc ($2.77 in chips)
professa oc: posts small blind $0.01
mwnj: posts big blind $0.02
*** HOLE CARDS ***
Dealt to tapouttazz9 [Jh 9c]
Wildbill4761: calls $0.02
tapouttazz9: folds
TY4PAYING: folds
professa oc: raises $0.08 to $0.10
mwnj: calls $0.08
Wildbill4761: calls $0.08
*** FLOP *** [Qs 8c 5c]
professa oc: checks
mwnj: bets $0.02
Wildbill4761: calls $0.02
professa oc: raises $0.24 to $0.26
mwnj: raises $1.63 to $1.89 and is all-in
Wildbill4761: folds
professa oc: calls $1.63
*** TURN *** [Qs 8c 5c] [6d]
*** RIVER *** [Qs 8c 5c 6d] [Qh]
*** SHOW DOWN ***
professa oc: shows [Kd Kh] (two pair, Kings and Queens)
mwnj: shows [8s 9s] (two pair, Queens and Eights)
professa oc collected $3.92 from pot
*** SUMMARY ***
Total pot $4.10 | Rake $0.18
Board [Qs 8c 5c 6d Qh]
Seat 1: mwnj (big blind) showed [8s 9s] and lost with two pair, Queens and Eights
Seat 2: Wildbill4761 folded on the Flop
Seat 4: tapouttazz9 folded before Flop (didn't bet)
Seat 5: TY4PAYING (button) folded before Flop (didn't bet)
Seat 6: professa oc (small blind) showed [Kd Kh] and won ($3.92) with two pair, Kings and Queens


PokerStars Hand #154858676976:  Hold'em No Limit ($0.01/$0.02 USD) - 2016/06/24 16:14:16 ET
Table 'Delphinus' 6-max Seat #6 is the button
Seat 2: Wildbill4761 ($0.81 in chips)
Seat 4: tapouttazz9 ($1.93 in chips)
Seat 5: TY4PAYING ($1.87 in chips)
Seat 6: professa oc ($4.70 in chips)
Wildbill4761: posts small blind $0.01
tapouttazz9: posts big blind $0.02
*** HOLE CARDS ***
Dealt to tapouttazz9 [8c 9h]
TY4PAYING: calls $0.02
mwnj leaves the table
professa oc: raises $0.07 to $0.09
Wildbill4761: calls $0.08
tapouttazz9: folds
TY4PAYING: calls $0.07
*** FLOP *** [4s Ac Td]
Wildbill4761: bets $0.02
TY4PAYING: raises $0.16 to $0.18
professa oc: folds
Wildbill4761: calls $0.16
*** TURN *** [4s Ac Td] [5h]
Wildbill4761: checks
TY4PAYING: bets $0.31
Wildbill4761: calls $0.31
*** RIVER *** [4s Ac Td 5h] [Th]
Wildbill4761: checks
TY4PAYING: checks
*** SHOW DOWN ***
Wildbill4761: shows [Ah 6h] (two pair, Aces and Tens)
TY4PAYING: mucks hand
Wildbill4761 collected $1.21 from pot
*** SUMMARY ***
Total pot $1.27 | Rake $0.06
Board [4s Ac Td 5h Th]
Seat 2: Wildbill4761 (small blind) showed [Ah 6h] and won ($1.21) with two pair, Aces and Tens
Seat 4: tapouttazz9 (big blind) folded before Flop
Seat 5: TY4PAYING mucked [2c As]
Seat 6: professa oc (button) folded on the Flop


PokerStars Hand #154858677251:  Hold'em No Limit ($0.01/$0.02 USD) - 2016/06/24 16:15:04 ET
Table 'Delphinus' 6-max Seat #2 is the button
Seat 2: Wildbill4761 ($1.44 in chips)
Seat 4: tapouttazz9 ($1.91 in chips)
Seat 5: TY4PAYING ($1.29 in chips)
Seat 6: professa oc ($4.61 in chips)
tapouttazz9: posts small blind $0.01
TY4PAYING: posts big blind $0.02
*** HOLE CARDS ***
Dealt to tapouttazz9 [Jd 4c]
professa oc: folds
Wildbill4761: calls $0.02
tapouttazz9: folds
TY4PAYING: raises $1.27 to $1.29 and is all-in
Wildbill4761: folds
Uncalled bet ($1.27) returned to TY4PAYING
TY4PAYING collected $0.05 from pot
TY4PAYING: doesn't show hand
*** SUMMARY ***
Total pot $0.05 | Rake $0
Seat 2: Wildbill4761 (button) folded before Flop
Seat 4: tapouttazz9 (small blind) folded before Flop
Seat 5: TY4PAYING (big blind) collected ($0.05)
Seat 6: professa oc folded before Flop (didn't bet)


PokerStars Hand #154858677346:  Hold'em No Limit ($0.01/$0.02 USD) - 2016/06/24 16:15:20 ET
Table 'Delphinus' 6-max Seat #4 is the button
Seat 2: Wildbill4761 ($1.42 in chips)
Seat 4: tapouttazz9 ($1.90 in chips)
Seat 5: TY4PAYING ($1.32 in chips)
Seat 6: professa oc ($4.61 in chips)
TY4PAYING: posts small blind $0.01
professa oc: posts big blind $0.02
*** HOLE CARDS ***
Dealt to tapouttazz9 [4c Ts]
Wildbill4761: calls $0.02
tapouttazz9: folds
TY4PAYING: calls $0.01
professa oc: checks
*** FLOP *** [9h 3c 7s]
TY4PAYING: bets $0.03
professa oc: calls $0.03
Wildbill4761: calls $0.03
*** TURN *** [9h 3c 7s] [Jh]
TY4PAYING: checks
professa oc: checks
Wildbill4761: checks
*** RIVER *** [9h 3c 7s Jh] [3d]
TY4PAYING: checks
professa oc: bets $0.14
Wildbill4761: calls $0.14
TY4PAYING: folds
*** SHOW DOWN ***
professa oc: shows [3s 8s] (three of a kind, Threes)
Wildbill4761: mucks hand
professa oc collected $0.41 from pot
*** SUMMARY ***
Total pot $0.43 | Rake $0.02
Board [9h 3c 7s Jh 3d]
Seat 2: Wildbill4761 mucked [Ks 7c]
Seat 4: tapouttazz9 (button) folded before Flop (didn't bet)
Seat 5: TY4PAYING (small blind) folded on the River
Seat 6: professa oc (big blind) showed [3s 8s] and won ($0.41) with three of a kind, Threes


PokerStars Hand #154858677585:  Hold'em No Limit ($0.01/$0.02 USD) - 2016/06/24 16:16:02 ET
Table 'Delphinus' 6-max Seat #5 is the button
Seat 2: Wildbill4761 ($1.23 in chips)
Seat 4: tapouttazz9 ($1.90 in chips)
Seat 5: TY4PAYING ($1.27 in chips)
Seat 6: professa oc ($4.83 in chips)
professa oc: posts small blind $0.01
Wildbill4761: posts big blind $0.02
*** HOLE CARDS ***
Dealt to tapouttazz9 [2s 9c]
tapouttazz9: folds
TY4PAYING: calls $0.02
Cypher1012 joins the table at seat #1
professa oc: calls $0.01
Wildbill4761: checks
*** FLOP *** [2c 8d Js]
professa oc: checks
Wildbill4761: checks
TY4PAYING: checks
*** TURN *** [2c 8d Js] [Ah]
professa oc: bets $0.03
Wildbill4761: folds
TY4PAYING: calls $0.03
*** RIVER *** [2c 8d Js Ah] [Jc]
professa oc: checks
TY4PAYING: checks
*** SHOW DOWN ***
professa oc: shows [3c Kc] (a pair of Jacks)
TY4PAYING: shows [Kd Td] (a pair of Jacks - Ace+King+Ten kicker)
TY4PAYING collected $0.11 from pot
Cypher1012 leaves the table
*** SUMMARY ***
Total pot $0.12 | Rake $0.01
Board [2c 8d Js Ah Jc]
Seat 2: Wildbill4761 (big blind) folded on the Turn
Seat 4: tapouttazz9 folded before Flop (didn't bet)
Seat 5: TY4PAYING (button) showed [Kd Td] and won ($0.11) with a pair of Jacks
Seat 6: professa oc (small blind) showed [3c Kc] and lost with a pair of Jacks


PokerStars Hand #154858677844:  Hold'em No Limit ($0.01/$0.02 USD) - 2016/06/24 16:16:49 ET
Table 'Delphinus' 6-max Seat #6 is the button
Seat 2: Wildbill4761 ($1.21 in chips)
Seat 4: tapouttazz9 ($1.90 in chips)
Seat 5: TY4PAYING ($1.33 in chips)
Seat 6: professa oc ($4.78 in chips)
Wildbill4761: posts small blind $0.01
tapouttazz9: posts big blind $0.02
*** HOLE CARDS ***
Dealt to tapouttazz9 [Js Qh]
TY4PAYING: folds
professa oc: raises $0.04 to $0.06
Wildbill4761: calls $0.05
tapouttazz9: calls $0.04
*** FLOP *** [3h 8h 8c]
Wildbill4761: checks
tapouttazz9: bets $0.08
professa oc: calls $0.08
Nguyenning joins the table at seat #1
Wildbill4761: calls $0.08
*** TURN *** [3h 8h 8c] [6d]
Wildbill4761: checks
tapouttazz9: checks
professa oc: bets $0.40
Wildbill4761: folds
tapouttazz9: folds
Uncalled bet ($0.40) returned to professa oc
professa oc collected $0.40 from pot
professa oc: doesn't show hand
*** SUMMARY ***
Total pot $0.42 | Rake $0.02
Board [3h 8h 8c 6d]
Seat 2: Wildbill4761 (small blind) folded on the Turn
Seat 4: tapouttazz9 (big blind) folded on the Turn
Seat 5: TY4PAYING folded before Flop (didn't bet)
Seat 6: professa oc (button) collected ($0.40)


PokerStars Hand #154858678166:  Hold'em No Limit ($0.01/$0.02 USD) - 2016/06/24 16:17:48 ET
Table 'Delphinus' 6-max Seat #2 is the button
Seat 2: Wildbill4761 ($1.07 in chips)
Seat 4: tapouttazz9 ($1.76 in chips)
Seat 5: TY4PAYING ($1.33 in chips)
Seat 6: professa oc ($5.04 in chips)
tapouttazz9: posts small blind $0.01
TY4PAYING: posts big blind $0.02
Nguyenning: sits out
*** HOLE CARDS ***
Dealt to tapouttazz9 [8s Ac]
professa oc: folds
Wildbill4761: calls $0.02
tapouttazz9: raises $0.02 to $0.04
TY4PAYING: folds
Wildbill4761: calls $0.02
*** FLOP *** [Kh Ts 7h]
tapouttazz9: checks
Wildbill4761: checks
*** TURN *** [Kh Ts 7h] [6d]
tapouttazz9: checks
Wildbill4761: checks
*** RIVER *** [Kh Ts 7h 6d] [4d]
tapouttazz9: checks
Wildbill4761: checks
*** SHOW DOWN ***
tapouttazz9: shows [8s Ac] (high card Ace)
Wildbill4761: shows [4s Qh] (a pair of Fours)
Wildbill4761 collected $0.10 from pot
*** SUMMARY ***
Total pot $0.10 | Rake $0
Board [Kh Ts 7h 6d 4d]
Seat 2: Wildbill4761 (button) showed [4s Qh] and won ($0.10) with a pair of Fours
Seat 4: tapouttazz9 (small blind) showed [8s Ac] and lost with high card Ace
Seat 5: TY4PAYING (big blind) folded before Flop
Seat 6: professa oc folded before Flop (didn't bet)


PokerStars Hand #154858678320:  Hold'em No Limit ($0.01/$0.02 USD) - 2016/06/24 16:18:18 ET
Table 'Delphinus' 6-max Seat #4 is the button
Seat 1: Nguyenning ($2.49 in chips)
Seat 2: Wildbill4761 ($1.13 in chips)
Seat 4: tapouttazz9 ($1.72 in chips)
Seat 5: TY4PAYING ($1.31 in chips)
Seat 6: professa oc ($5.04 in chips)
TY4PAYING: posts small blind $0.01
professa oc: posts big blind $0.02
Nguyenning: posts big blind $0.02
*** HOLE CARDS ***
Dealt to tapouttazz9 [9c 2c]
Nguyenning: checks
Wildbill4761: calls $0.02
tapouttazz9: folds
TY4PAYING: folds
professa oc: checks
*** FLOP *** [4c 4s Qh]
professa oc: checks
Nguyenning: bets $0.02
Wildbill4761: calls $0.02
professa oc: folds
*** TURN *** [4c 4s Qh] [Qc]
Nguyenning: checks
Wildbill4761: checks
*** RIVER *** [4c 4s Qh Qc] [Qs]
Nguyenning: checks
Wildbill4761: checks
*** SHOW DOWN ***
Nguyenning: shows [5d Th] (a full house, Queens full of Fours)
Wildbill4761: shows [6c 5c] (a full house, Queens full of Fours)
Nguyenning collected $0.06 from pot
Wildbill4761 collected $0.05 from pot
*** SUMMARY ***
Total pot $0.11 | Rake $0
Board [4c 4s Qh Qc Qs]
Seat 1: Nguyenning showed [5d Th] and won ($0.06) with a full house, Queens full of Fours
Seat 2: Wildbill4761 showed [6c 5c] and won ($0.05) with a full house, Queens full of Fours
Seat 4: tapouttazz9 (button) folded before Flop (didn't bet)
Seat 5: TY4PAYING (small blind) folded before Flop
Seat 6: professa oc (big blind) folded on the Flop


PokerStars Hand #154858678557:  Hold'em No Limit ($0.01/$0.02 USD) - 2016/06/24 16:18:55 ET
Table 'Delphinus' 6-max Seat #5 is the button
Seat 1: Nguyenning ($2.51 in chips)
Seat 2: Wildbill4761 ($1.14 in chips)
Seat 4: tapouttazz9 ($1.72 in chips)
Seat 5: TY4PAYING ($1.30 in chips)
Seat 6: professa oc ($5.02 in chips)
professa oc: posts small blind $0.01
Nguyenning: posts big blind $0.02
*** HOLE CARDS ***
Dealt to tapouttazz9 [2s 5h]
Wildbill4761: calls $0.02
tapouttazz9: folds
TY4PAYING: calls $0.02
professa oc: folds
Nguyenning: checks
*** FLOP *** [Qc Js 3s]
Nguyenning: bets $0.04
Wildbill4761: calls $0.04
TY4PAYING: calls $0.04
*** TURN *** [Qc Js 3s] [Jh]
Nguyenning: checks
Wildbill4761: checks
TY4PAYING: checks
*** RIVER *** [Qc Js 3s Jh] [5d]
Nguyenning: checks
Wildbill4761: checks
TY4PAYING: checks
*** SHOW DOWN ***
Nguyenning: shows [Qs 9c] (two pair, Queens and Jacks)
Wildbill4761: mucks hand
TY4PAYING: mucks hand
Nguyenning collected $0.18 from pot
*** SUMMARY ***
Total pot $0.19 | Rake $0.01
Board [Qc Js 3s Jh 5d]
Seat 1: Nguyenning (big blind) showed [Qs 9c] and won ($0.18) with two pair, Queens and Jacks
Seat 2: Wildbill4761 mucked [Ac 6s]
Seat 4: tapouttazz9 folded before Flop (didn't bet)
Seat 5: TY4PAYING (button) mucked [9s 7s]
Seat 6: professa oc (small blind) folded before Flop


PokerStars Hand #154858678778:  Hold'em No Limit ($0.01/$0.02 USD) - 2016/06/24 16:19:36 ET
Table 'Delphinus' 6-max Seat #6 is the button
Seat 1: Nguyenning ($2.63 in chips)
Seat 2: Wildbill4761 ($1.08 in chips)
Seat 4: tapouttazz9 ($1.72 in chips)
Seat 5: TY4PAYING ($1.24 in chips)
Seat 6: professa oc ($5.01 in chips)
Nguyenning: posts small blind $0.01
Wildbill4761: posts big blind $0.02
*** HOLE CARDS ***
Dealt to tapouttazz9 [Kc Ad]
tapouttazz9: raises $0.03 to $0.05
TY4PAYING: folds
professa oc: folds
Nguyenning: folds
Wildbill4761: calls $0.03
*** FLOP *** [Kh Ah 6h]
Wildbill4761: checks
tapouttazz9: bets $0.08
Wildbill4761: folds
Uncalled bet ($0.08) returned to tapouttazz9
tapouttazz9 collected $0.11 from pot
tapouttazz9: doesn't show hand
*** SUMMARY ***
Total pot $0.11 | Rake $0
Board [Kh Ah 6h]
Seat 1: Nguyenning (small blind) folded before Flop
Seat 2: Wildbill4761 (big blind) folded on the Flop
Seat 4: tapouttazz9 collected ($0.11)
Seat 5: TY4PAYING folded before Flop (didn't bet)
Seat 6: professa oc (button) folded before Flop (didn't bet)


PokerStars Hand #154858678989:  Hold'em No Limit ($0.01/$0.02 USD) - 2016/06/24 16:20:13 ET
Table 'Delphinus' 6-max Seat #1 is the button
Seat 1: Nguyenning ($2.62 in chips)
Seat 2: Wildbill4761 ($1.03 in chips)
Seat 4: tapouttazz9 ($1.78 in chips)
Seat 5: TY4PAYING ($1.24 in chips)
Seat 6: professa oc ($5.01 in chips)
Wildbill4761: posts small blind $0.01
tapouttazz9: posts big blind $0.02
*** HOLE CARDS ***
Dealt to tapouttazz9 [Qh 7c]
TY4PAYING: calls $0.02
professa oc: folds
Nguyenning: calls $0.02
Wildbill4761: calls $0.01
tapouttazz9: checks
*** FLOP *** [9c 4s Jc]
Wildbill4761: checks
tapouttazz9: checks
TY4PAYING: bets $0.05
Nguyenning: folds
Wildbill4761: calls $0.05
tapouttazz9: folds
*** TURN *** [9c 4s Jc] [9s]
Wildbill4761: checks
TY4PAYING: bets $0.08
Wildbill4761: folds
Uncalled bet ($0.08) returned to TY4PAYING
TY4PAYING collected $0.17 from pot
TY4PAYING: doesn't show hand
*** SUMMARY ***
Total pot $0.18 | Rake $0.01
Board [9c 4s Jc 9s]
Seat 1: Nguyenning (button) folded on the Flop
Seat 2: Wildbill4761 (small blind) folded on the Turn
Seat 4: tapouttazz9 (big blind) folded on the Flop
Seat 5: TY4PAYING collected ($0.17)
Seat 6: professa oc folded before Flop (didn't bet)


PokerStars Hand #154858679269:  Hold'em No Limit ($0.01/$0.02 USD) - 2016/06/24 16:21:01 ET
Table 'Delphinus' 6-max Seat #2 is the button
Seat 1: Nguyenning ($2.60 in chips)
Seat 2: Wildbill4761 ($0.96 in chips)
Seat 4: tapouttazz9 ($1.76 in chips)
Seat 5: TY4PAYING ($1.34 in chips)
Seat 6: professa oc ($5.01 in chips)
tapouttazz9: posts small blind $0.01
TY4PAYING: posts big blind $0.02
*** HOLE CARDS ***
Dealt to tapouttazz9 [5d Js]
professa oc: folds
Nguyenning: calls $0.02
Wildbill4761: calls $0.02
tapouttazz9: folds
TY4PAYING: checks
*** FLOP *** [9s Qs 3d]
TY4PAYING: checks
Nguyenning: bets $0.02
Wildbill4761: calls $0.02
TY4PAYING: folds
*** TURN *** [9s Qs 3d] [Kc]
Nguyenning: bets $0.04
Wildbill4761: folds
Uncalled bet ($0.04) returned to Nguyenning
Nguyenning collected $0.11 from pot
Nguyenning: doesn't show hand
*** SUMMARY ***
Total pot $0.11 | Rake $0
Board [9s Qs 3d Kc]
Seat 1: Nguyenning collected ($0.11)
Seat 2: Wildbill4761 (button) folded on the Turn
Seat 4: tapouttazz9 (small blind) folded before Flop
Seat 5: TY4PAYING (big blind) folded on the Flop
Seat 6: professa oc folded before Flop (didn't bet)


PokerStars Hand #154858679460:  Hold'em No Limit ($0.01/$0.02 USD) - 2016/06/24 16:21:35 ET
Table 'Delphinus' 6-max Seat #4 is the button
Seat 1: Nguyenning ($2.67 in chips)
Seat 2: Wildbill4761 ($0.92 in chips)
Seat 4: tapouttazz9 ($1.75 in chips)
Seat 5: TY4PAYING ($1.32 in chips)
Seat 6: professa oc ($5.01 in chips)
TY4PAYING: posts small blind $0.01
professa oc: posts big blind $0.02
*** HOLE CARDS ***
Dealt to tapouttazz9 [5s 8c]
Nguyenning: calls $0.02
Wildbill4761: calls $0.02
tapouttazz9: folds
TY4PAYING: calls $0.01
professa oc: checks
*** FLOP *** [8s Td 9c]
TY4PAYING: checks
professa oc: checks
Nguyenning: checks
Wildbill4761: bets $0.02
TY4PAYING: calls $0.02
professa oc: calls $0.02
Nguyenning: folds
*** TURN *** [8s Td 9c] [7s]
TY4PAYING: checks
professa oc: checks
youreaqtpie joins the table at seat #3
Wildbill4761: bets $0.20
TY4PAYING: folds
professa oc: folds
Uncalled bet ($0.20) returned to Wildbill4761
Wildbill4761 collected $0.13 from pot
*** SUMMARY ***
Total pot $0.14 | Rake $0.01
Board [8s Td 9c 7s]
Seat 1: Nguyenning folded on the Flop
Seat 2: Wildbill4761 collected ($0.13)
Seat 4: tapouttazz9 (button) folded before Flop (didn't bet)
Seat 5: TY4PAYING (small blind) folded on the Turn
Seat 6: professa oc (big blind) folded on the Turn


PokerStars Hand #154858679758:  Hold'em No Limit ($0.01/$0.02 USD) - 2016/06/24 16:22:24 ET
Table 'Delphinus' 6-max Seat #5 is the button
Seat 1: Nguyenning ($2.65 in chips)
Seat 2: Wildbill4761 ($1.01 in chips)
Seat 4: tapouttazz9 ($1.75 in chips)
Seat 5: TY4PAYING ($1.28 in chips)
Seat 6: professa oc ($4.97 in chips)
professa oc: posts small blind $0.01
Nguyenning: posts big blind $0.02
youreaqtpie: sits out
*** HOLE CARDS ***
Dealt to tapouttazz9 [3c Js]
Wildbill4761: calls $0.02
tapouttazz9: folds
TY4PAYING: folds
professa oc: folds
Nguyenning: raises $0.06 to $0.08
Wildbill4761: calls $0.06
*** FLOP *** [2h 8d 4h]
Nguyenning: bets $0.10
Wildbill4761: calls $0.10
*** TURN *** [2h 8d 4h] [Td]
Nguyenning: bets $0.26
Wildbill4761: calls $0.26
*** RIVER *** [2h 8d 4h Td] [Ac]
Nguyenning: bets $0.22
Wildbill4761: folds
Uncalled bet ($0.22) returned to Nguyenning
Nguyenning collected $0.85 from pot
Nguyenning: doesn't show hand
*** SUMMARY ***
Total pot $0.89 | Rake $0.04
Board [2h 8d 4h Td Ac]
Seat 1: Nguyenning (big blind) collected ($0.85)
Seat 2: Wildbill4761 folded on the River
Seat 4: tapouttazz9 folded before Flop (didn't bet)
Seat 5: TY4PAYING (button) folded before Flop (didn't bet)
Seat 6: professa oc (small blind) folded before Flop


PokerStars Hand #154859427233:  Hold'em No Limit ($0.01/$0.02 USD) - 2016/06/24 16:23:28 ET
Table 'Delphinus' 6-max Seat #6 is the button
Seat 1: Nguyenning ($3.06 in chips)
Seat 2: Wildbill4761 ($0.57 in chips)
Seat 4: tapouttazz9 ($1.75 in chips)
Seat 5: TY4PAYING ($1.28 in chips)
Seat 6: professa oc ($4.96 in chips)
Nguyenning: posts small blind $0.01
Wildbill4761: posts big blind $0.02
youreaqtpie: sits out
*** HOLE CARDS ***
Dealt to tapouttazz9 [Ts 3d]
tapouttazz9: folds
TY4PAYING: folds
professa oc: raises $0.04 to $0.06
Nguyenning: folds
youreaqtpie leaves the table
Wildbill4761: calls $0.04
*** FLOP *** [6h 9s Kd]
Wildbill4761: bets $0.04
professa oc: calls $0.04
*** TURN *** [6h 9s Kd] [3s]
Wildbill4761: bets $0.02
professa oc: raises $0.08 to $0.10
Wildbill4761: calls $0.08
*** RIVER *** [6h 9s Kd 3s] [Ks]
Wildbill4761: checks
professa oc: bets $0.20
Wildbill4761: calls $0.20
*** SHOW DOWN ***
professa oc: shows [7c Kh] (three of a kind, Kings)
Wildbill4761: mucks hand
professa oc collected $0.77 from pot
*** SUMMARY ***
Total pot $0.81 | Rake $0.04
Board [6h 9s Kd 3s Ks]
Seat 1: Nguyenning (small blind) folded before Flop
Seat 2: Wildbill4761 (big blind) mucked [9c Js]
Seat 4: tapouttazz9 folded before Flop (didn't bet)
Seat 5: TY4PAYING folded before Flop (didn't bet)
Seat 6: professa oc (button) showed [7c Kh] and won ($0.77) with three of a kind, Kings


PokerStars Hand #154859427577:  Hold'em No Limit ($0.01/$0.02 USD) - 2016/06/24 16:24:31 ET
Table 'Delphinus' 6-max Seat #1 is the button
Seat 1: Nguyenning ($3.05 in chips)
Seat 2: Wildbill4761 ($0.17 in chips)
Seat 4: tapouttazz9 ($1.75 in chips)
Seat 5: TY4PAYING ($1.28 in chips)
Seat 6: professa oc ($5.33 in chips)
Wildbill4761: posts small blind $0.01
tapouttazz9: posts big blind $0.02
*** HOLE CARDS ***
Dealt to tapouttazz9 [8c 9h]
TY4PAYING: folds
professa oc: raises $0.04 to $0.06
Nguyenning: folds
Wildbill4761: raises $0.04 to $0.10
tapouttazz9: calls $0.08
professa oc: calls $0.04
*** FLOP *** [Js 6h Tc]
Wildbill4761: bets $0.07 and is all-in
tapouttazz9: raises $0.21 to $0.28
professa oc: calls $0.28
*** TURN *** [Js 6h Tc] [2h]
tapouttazz9: bets $1.37 and is all-in
professa oc: calls $1.37
*** RIVER *** [Js 6h Tc 2h] [Jd]
*** SHOW DOWN ***
tapouttazz9: shows [8c 9h] (a pair of Jacks)
professa oc: shows [Jh Ts] (a full house, Jacks full of Tens)
professa oc collected $3.01 from side pot
Wildbill4761: shows [Ks Kc] (two pair, Kings and Jacks)
professa oc collected $0.49 from main pot
*** SUMMARY ***
Total pot $3.67 Main pot $0.49. Side pot $3.01. | Rake $0.17
Board [Js 6h Tc 2h Jd]
Seat 1: Nguyenning (button) folded before Flop (didn't bet)
Seat 2: Wildbill4761 (small blind) showed [Ks Kc] and lost with two pair, Kings and Jacks
Seat 4: tapouttazz9 (big blind) showed [8c 9h] and lost with a pair of Jacks
Seat 5: TY4PAYING folded before Flop (didn't bet)
Seat 6: professa oc showed [Jh Ts] and won ($3.50) with a full house, Jacks full of Tens


PokerStars Hand #154859427997:  Hold'em No Limit ($0.01/$0.02 USD) - 2016/06/24 16:25:43 ET
Table 'Delphinus' 6-max Seat #5 is the button
Seat 1: Nguyenning ($3.05 in chips)
Seat 5: TY4PAYING ($1.28 in chips)
Seat 6: professa oc ($7.08 in chips)
professa oc: posts small blind $0.01
Nguyenning: posts big blind $0.02
*** HOLE CARDS ***
TY4PAYING: calls $0.02
professa oc: calls $0.01
Nguyenning: checks
*** FLOP *** [3h Ts Jd]
professa oc: bets $0.03
Pandora Dad joins the table at seat #3
Nguyenning: folds
TY4PAYING: folds
Uncalled bet ($0.03) returned to professa oc
professa oc collected $0.06 from pot
professa oc: doesn't show hand
*** SUMMARY ***
Total pot $0.06 | Rake $0
Board [3h Ts Jd]
Seat 1: Nguyenning (big blind) folded on the Flop
Seat 5: TY4PAYING (button) folded on the Flop
Seat 6: professa oc (small blind) collected ($0.06)


PokerStars Hand #154859428280:  Hold'em No Limit ($0.01/$0.02 USD) - 2016/06/24 16:26:34 ET
Table 'Delphinus' 6-max Seat #6 is the button
Seat 1: Nguyenning ($3.03 in chips)
Seat 2: Wildbill4761 ($2 in chips)
Seat 4: tapouttazz9 ($2 in chips)
Seat 5: TY4PAYING ($1.26 in chips)
Seat 6: professa oc ($7.12 in chips)
Nguyenning: posts small blind $0.01
Wildbill4761: posts big blind $0.02
Pandora Dad: sits out
*** HOLE CARDS ***
Dealt to tapouttazz9 [Jd Ah]
tapouttazz9: raises $0.03 to $0.05
TY4PAYING: folds
professa oc: folds
Nguyenning: folds
Wildbill4761: calls $0.03
*** FLOP *** [9s Th 9c]
Wildbill4761: checks
tapouttazz9: checks
*** TURN *** [9s Th 9c] [4c]
Wildbill4761: checks
tapouttazz9: checks
*** RIVER *** [9s Th 9c 4c] [Qd]
Wildbill4761: checks
tapouttazz9: checks
*** SHOW DOWN ***
Wildbill4761: shows [Jh 7s] (a pair of Nines)
tapouttazz9: shows [Jd Ah] (a pair of Nines - Ace kicker)
tapouttazz9 collected $0.11 from pot
*** SUMMARY ***
Total pot $0.11 | Rake $0
Board [9s Th 9c 4c Qd]
Seat 1: Nguyenning (small blind) folded before Flop
Seat 2: Wildbill4761 (big blind) showed [Jh 7s] and lost with a pair of Nines
Seat 4: tapouttazz9 showed [Jd Ah] and won ($0.11) with a pair of Nines
Seat 5: TY4PAYING folded before Flop (didn't bet)
Seat 6: professa oc (button) folded before Flop (didn't bet)


PokerStars Hand #154859428523:  Hold'em No Limit ($0.01/$0.02 USD) - 2016/06/24 16:27:12 ET
Table 'Delphinus' 6-max Seat #1 is the button
Seat 1: Nguyenning ($3.02 in chips)
Seat 2: Wildbill4761 ($1.95 in chips)
Seat 3: Pandora Dad ($2 in chips)
Seat 4: tapouttazz9 ($2.06 in chips)
Seat 5: TY4PAYING ($1.26 in chips)
Seat 6: professa oc ($7.12 in chips)
Wildbill4761: posts small blind $0.01
Pandora Dad: posts big blind $0.02
*** HOLE CARDS ***
Dealt to tapouttazz9 [7c Td]
tapouttazz9: folds
TY4PAYING: folds
professa oc: folds
Nguyenning: raises $0.06 to $0.08
Wildbill4761: calls $0.07
Pandora Dad: calls $0.06
*** FLOP *** [Ad 3c 2c]
Wildbill4761: bets $0.02
Pandora Dad: calls $0.02
Nguyenning: raises $0.08 to $0.10
Wildbill4761: calls $0.08
Pandora Dad: calls $0.08
*** TURN *** [Ad 3c 2c] [7s]
Wildbill4761: checks
Pandora Dad: checks
Nguyenning: bets $0.26
Wildbill4761: folds
Pandora Dad: folds
Uncalled bet ($0.26) returned to Nguyenning
Nguyenning collected $0.52 from pot
Nguyenning: doesn't show hand
*** SUMMARY ***
Total pot $0.54 | Rake $0.02
Board [Ad 3c 2c 7s]
Seat 1: Nguyenning (button) collected ($0.52)
Seat 2: Wildbill4761 (small blind) folded on the Turn
Seat 3: Pandora Dad (big blind) folded on the Turn
Seat 4: tapouttazz9 folded before Flop (didn't bet)
Seat 5: TY4PAYING folded before Flop (didn't bet)
Seat 6: professa oc folded before Flop (didn't bet)


PokerStars Hand #154859429018:  Hold'em No Limit ($0.01/$0.02 USD) - 2016/06/24 16:28:33 ET
Table 'Delphinus' 6-max Seat #2 is the button
Seat 1: Nguyenning ($3.36 in chips)
Seat 2: Wildbill4761 ($1.77 in chips)
Seat 3: Pandora Dad ($1.82 in chips)
Seat 4: tapouttazz9 ($2.06 in chips)
Seat 5: TY4PAYING ($1.26 in chips)
Seat 6: professa oc ($7.12 in chips)
Pandora Dad: posts small blind $0.01
tapouttazz9: posts big blind $0.02
*** HOLE CARDS ***
Dealt to tapouttazz9 [8d Td]
TY4PAYING: folds
professa oc: folds
Nguyenning: calls $0.02
Wildbill4761: calls $0.02
Pandora Dad: calls $0.01
tapouttazz9: checks
*** FLOP *** [Jh 2h 3d]
Pandora Dad: checks
tapouttazz9: checks
Nguyenning: bets $0.06
Wildbill4761: calls $0.06
Pandora Dad: folds
tapouttazz9: folds
*** TURN *** [Jh 2h 3d] [8c]
Nguyenning: bets $0.12
Wildbill4761: folds
Uncalled bet ($0.12) returned to Nguyenning
Nguyenning collected $0.19 from pot
Nguyenning: doesn't show hand
*** SUMMARY ***
Total pot $0.20 | Rake $0.01
Board [Jh 2h 3d 8c]
Seat 1: Nguyenning collected ($0.19)
Seat 2: Wildbill4761 (button) folded on the Turn
Seat 3: Pandora Dad (small blind) folded on the Flop
Seat 4: tapouttazz9 (big blind) folded on the Flop
Seat 5: TY4PAYING folded before Flop (didn't bet)
Seat 6: professa oc folded before Flop (didn't bet)


PokerStars Hand #154859429516:  Hold'em No Limit ($0.01/$0.02 USD) - 2016/06/24 16:30:01 ET
Table 'Delphinus' 6-max Seat #3 is the button
Seat 1: Nguyenning ($3.47 in chips)
Seat 2: Wildbill4761 ($1.69 in chips)
Seat 3: Pandora Dad ($1.80 in chips)
Seat 4: tapouttazz9 ($2.04 in chips)
Seat 5: TY4PAYING ($1.26 in chips)
Seat 6: professa oc ($7.12 in chips)
tapouttazz9: posts small blind $0.01
TY4PAYING: posts big blind $0.02
*** HOLE CARDS ***
Dealt to tapouttazz9 [Jh 7s]
professa oc: folds
Nguyenning: raises $0.02 to $0.04
Wildbill4761: calls $0.04
Pandora Dad: calls $0.04
tapouttazz9: folds
TY4PAYING: calls $0.02
*** FLOP *** [9s 9h 3s]
TY4PAYING: checks
Nguyenning: checks
Wildbill4761: checks
Pandora Dad: checks
*** TURN *** [9s 9h 3s] [Td]
TY4PAYING: checks
Nguyenning: checks
Wildbill4761: checks
Pandora Dad: checks
*** RIVER *** [9s 9h 3s Td] [2c]
TY4PAYING: checks
Nguyenning: checks
Wildbill4761: checks
Pandora Dad: checks
*** SHOW DOWN ***
TY4PAYING: shows [5c Qd] (a pair of Nines)
Nguyenning: shows [6s Ah] (a pair of Nines - Ace kicker)
Wildbill4761: mucks hand
Pandora Dad: mucks hand
Nguyenning collected $0.16 from pot
*** SUMMARY ***
Total pot $0.17 | Rake $0.01
Board [9s 9h 3s Td 2c]
Seat 1: Nguyenning showed [6s Ah] and won ($0.16) with a pair of Nines
Seat 2: Wildbill4761 mucked [Qs 8c]
Seat 3: Pandora Dad (button) mucked [Qh Kc]
Seat 4: tapouttazz9 (small blind) folded before Flop
Seat 5: TY4PAYING (big blind) showed [5c Qd] and lost with a pair of Nines
Seat 6: professa oc folded before Flop (didn't bet)


PokerStars Hand #154859429842:  Hold'em No Limit ($0.01/$0.02 USD) - 2016/06/24 16:30:54 ET
Table 'Delphinus' 6-max Seat #4 is the button
Seat 1: Nguyenning ($3.59 in chips)
Seat 2: Wildbill4761 ($1.65 in chips)
Seat 3: Pandora Dad ($1.76 in chips)
Seat 4: tapouttazz9 ($2.03 in chips)
Seat 5: TY4PAYING ($1.22 in chips)
Seat 6: professa oc ($7.12 in chips)
TY4PAYING: posts small blind $0.01
professa oc: posts big blind $0.02
*** HOLE CARDS ***
Dealt to tapouttazz9 [7s 5c]
Nguyenning: folds
Wildbill4761: raises $0.02 to $0.04
Pandora Dad: folds
tapouttazz9: folds
TY4PAYING: folds
professa oc: folds
Uncalled bet ($0.02) returned to Wildbill4761
Wildbill4761 collected $0.05 from pot
*** SUMMARY ***
Total pot $0.05 | Rake $0
Seat 1: Nguyenning folded before Flop (didn't bet)
Seat 2: Wildbill4761 collected ($0.05)
Seat 3: Pandora Dad folded before Flop (didn't bet)
Seat 4: tapouttazz9 (button) folded before Flop (didn't bet)
Seat 5: TY4PAYING (small blind) folded before Flop
Seat 6: professa oc (big blind) folded before Flop


PokerStars Hand #154859429921:  Hold'em No Limit ($0.01/$0.02 USD) - 2016/06/24 16:31:07 ET
Table 'Delphinus' 6-max Seat #5 is the button
Seat 1: Nguyenning ($3.59 in chips)
Seat 2: Wildbill4761 ($1.68 in chips)
Seat 3: Pandora Dad ($1.76 in chips)
Seat 4: tapouttazz9 ($2.03 in chips)
Seat 5: TY4PAYING ($1.21 in chips)
Seat 6: professa oc ($7.10 in chips)
professa oc: posts small blind $0.01
Nguyenning: posts big blind $0.02
*** HOLE CARDS ***
Dealt to tapouttazz9 [6c Jh]
Wildbill4761: calls $0.02
Pandora Dad: folds
tapouttazz9: folds
TY4PAYING: folds
professa oc: folds
Nguyenning: checks
*** FLOP *** [5c 2s Qc]
Nguyenning: checks
Wildbill4761: checks
*** TURN *** [5c 2s Qc] [9s]
Nguyenning: checks
Wildbill4761: checks
*** RIVER *** [5c 2s Qc 9s] [Ad]
Nguyenning: checks
Wildbill4761: checks
*** SHOW DOWN ***
Nguyenning: shows [Jd 3s] (high card Ace)
Wildbill4761: mucks hand
Nguyenning collected $0.05 from pot
*** SUMMARY ***
Total pot $0.05 | Rake $0
Board [5c 2s Qc 9s Ad]
Seat 1: Nguyenning (big blind) showed [Jd 3s] and won ($0.05) with high card Ace
Seat 2: Wildbill4761 mucked [Ts 4s]
Seat 3: Pandora Dad folded before Flop (didn't bet)
Seat 4: tapouttazz9 folded before Flop (didn't bet)
Seat 5: TY4PAYING (button) folded before Flop (didn't bet)
Seat 6: professa oc (small blind) folded before Flop


PokerStars Hand #154859806149:  Hold'em No Limit ($0.01/$0.02 USD) - 2016/06/24 16:32:11 ET
Table 'Delphinus' 6-max Seat #6 is the button
Seat 1: Nguyenning ($3.62 in chips)
Seat 2: Wildbill4761 ($1.66 in chips)
Seat 3: Pandora Dad ($1.76 in chips)
Seat 4: tapouttazz9 ($2.03 in chips)
Seat 5: TY4PAYING ($1.21 in chips)
Seat 6: professa oc ($7.09 in chips)
Nguyenning: posts small blind $0.01
Wildbill4761: posts big blind $0.02
*** HOLE CARDS ***
Dealt to tapouttazz9 [Td 4d]
Pandora Dad: calls $0.02
tapouttazz9: folds
TY4PAYING: folds
professa oc: raises $0.06 to $0.08
Nguyenning: folds
Wildbill4761: calls $0.06
Pandora Dad: folds
*** FLOP *** [6d Ah Jc]
Wildbill4761: checks
professa oc: bets $0.10
Wildbill4761: calls $0.10
*** TURN *** [6d Ah Jc] [8d]
Wildbill4761: checks
professa oc: bets $0.25
Wildbill4761: folds
Uncalled bet ($0.25) returned to professa oc
professa oc collected $0.37 from pot
professa oc: doesn't show hand
*** SUMMARY ***
Total pot $0.39 | Rake $0.02
Board [6d Ah Jc 8d]
Seat 1: Nguyenning (small blind) folded before Flop
Seat 2: Wildbill4761 (big blind) folded on the Turn
Seat 3: Pandora Dad folded before Flop
Seat 4: tapouttazz9 folded before Flop (didn't bet)
Seat 5: TY4PAYING folded before Flop (didn't bet)
Seat 6: professa oc (button) collected ($0.37)


PokerStars Hand #154859806485:  Hold'em No Limit ($0.01/$0.02 USD) - 2016/06/24 16:33:13 ET
Table 'Delphinus' 6-max Seat #1 is the button
Seat 1: Nguyenning ($3.61 in chips)
Seat 2: Wildbill4761 ($1.48 in chips)
Seat 3: Pandora Dad ($1.74 in chips)
Seat 4: tapouttazz9 ($2.03 in chips)
Seat 5: TY4PAYING ($1.21 in chips)
Seat 6: professa oc ($7.28 in chips)
Wildbill4761: posts small blind $0.01
Pandora Dad: posts big blind $0.02
*** HOLE CARDS ***
Dealt to tapouttazz9 [5d Ad]
tapouttazz9: raises $0.02 to $0.04
TY4PAYING: folds
professa oc: folds
Nguyenning: folds
Wildbill4761: calls $0.03
Pandora Dad: calls $0.02
*** FLOP *** [3h 8h 4h]
Wildbill4761: checks
Pandora Dad: checks
tapouttazz9: checks
*** TURN *** [3h 8h 4h] [Qs]
Wildbill4761: checks
Pandora Dad: bets $0.02
tapouttazz9: folds
Wildbill4761: calls $0.02
*** RIVER *** [3h 8h 4h Qs] [Td]
Wildbill4761: checks
Pandora Dad: bets $0.14
Wildbill4761: folds
Uncalled bet ($0.14) returned to Pandora Dad
Pandora Dad collected $0.15 from pot
Pandora Dad: doesn't show hand
*** SUMMARY ***
Total pot $0.16 | Rake $0.01
Board [3h 8h 4h Qs Td]
Seat 1: Nguyenning (button) folded before Flop (didn't bet)
Seat 2: Wildbill4761 (small blind) folded on the River
Seat 3: Pandora Dad (big blind) collected ($0.15)
Seat 4: tapouttazz9 folded on the Turn
Seat 5: TY4PAYING folded before Flop (didn't bet)
Seat 6: professa oc folded before Flop (didn't bet)


PokerStars Hand #154859806790:  Hold'em No Limit ($0.01/$0.02 USD) - 2016/06/24 16:34:06 ET
Table 'Delphinus' 6-max Seat #2 is the button
Seat 1: Nguyenning ($3.61 in chips)
Seat 2: Wildbill4761 ($1.42 in chips)
Seat 3: Pandora Dad ($1.83 in chips)
Seat 4: tapouttazz9 ($1.99 in chips)
Seat 5: TY4PAYING ($1.21 in chips)
Seat 6: professa oc ($7.28 in chips)
Pandora Dad: posts small blind $0.01
tapouttazz9: posts big blind $0.02
*** HOLE CARDS ***
Dealt to tapouttazz9 [5d Ac]
TY4PAYING: folds
professa oc: folds
Nguyenning: raises $0.06 to $0.08
Wildbill4761: calls $0.08
Pandora Dad: folds
tapouttazz9: calls $0.06
*** FLOP *** [8c Th 7h]
tapouttazz9: checks
Nguyenning: checks
Wildbill4761: bets $0.02
tapouttazz9: calls $0.02
Nguyenning: calls $0.02
*** TURN *** [8c Th 7h] [7c]
tapouttazz9: checks
Nguyenning: bets $0.02
Wildbill4761: raises $0.02 to $0.04
tapouttazz9: folds
Nguyenning: folds
Uncalled bet ($0.02) returned to Wildbill4761
Wildbill4761 collected $0.33 from pot
*** SUMMARY ***
Total pot $0.35 | Rake $0.02
Board [8c Th 7h 7c]
Seat 1: Nguyenning folded on the Turn
Seat 2: Wildbill4761 (button) collected ($0.33)
Seat 3: Pandora Dad (small blind) folded before Flop
Seat 4: tapouttazz9 (big blind) folded on the Turn
Seat 5: TY4PAYING folded before Flop (didn't bet)
Seat 6: professa oc folded before Flop (didn't bet)


PokerStars Hand #154859807055:  Hold'em No Limit ($0.01/$0.02 USD) - 2016/06/24 16:34:51 ET
Table 'Delphinus' 6-max Seat #3 is the button
Seat 1: Nguyenning ($3.49 in chips)
Seat 2: Wildbill4761 ($1.63 in chips)
Seat 3: Pandora Dad ($1.82 in chips)
Seat 4: tapouttazz9 ($1.89 in chips)
Seat 5: TY4PAYING ($1.21 in chips)
Seat 6: professa oc ($7.28 in chips)
tapouttazz9: posts small blind $0.01
TY4PAYING: posts big blind $0.02
*** HOLE CARDS ***
Dealt to tapouttazz9 [5c 6s]
professa oc: raises $0.04 to $0.06
Nguyenning: calls $0.06
Wildbill4761: calls $0.06
Pandora Dad: folds
tapouttazz9: folds
TY4PAYING: calls $0.04
*** FLOP *** [6d 3d 2s]
TY4PAYING: bets $1.15 and is all-in
professa oc: calls $1.15
Nguyenning: folds
Wildbill4761: folds
*** TURN *** [6d 3d 2s] [4d]
*** RIVER *** [6d 3d 2s 4d] [9s]
*** SHOW DOWN ***
TY4PAYING: shows [8s 8d] (a pair of Eights)
professa oc: shows [Ac As] (a pair of Aces)
professa oc collected $2.44 from pot
*** SUMMARY ***
Total pot $2.55 | Rake $0.11
Board [6d 3d 2s 4d 9s]
Seat 1: Nguyenning folded on the Flop
Seat 2: Wildbill4761 folded on the Flop
Seat 3: Pandora Dad (button) folded before Flop (didn't bet)
Seat 4: tapouttazz9 (small blind) folded before Flop
Seat 5: TY4PAYING (big blind) showed [8s 8d] and lost with a pair of Eights
Seat 6: professa oc showed [Ac As] and won ($2.44) with a pair of Aces


PokerStars Hand #154859807370:  Hold'em No Limit ($0.01/$0.02 USD) - 2016/06/24 16:35:44 ET
Table 'Delphinus' 6-max Seat #4 is the button
Seat 1: Nguyenning ($3.43 in chips)
Seat 2: Wildbill4761 ($1.57 in chips)
Seat 3: Pandora Dad ($1.82 in chips)
Seat 4: tapouttazz9 ($1.88 in chips)
Seat 6: professa oc ($8.51 in chips)
professa oc: posts small blind $0.01
Nguyenning: posts big blind $0.02
*** HOLE CARDS ***
Dealt to tapouttazz9 [4h Qc]
Wildbill4761: calls $0.02
Pandora Dad: calls $0.02
tapouttazz9: folds
professa oc: calls $0.01
Nguyenning: checks
*** FLOP *** [Js 2c 4s]
professa oc: checks
Nguyenning: checks
Wildbill4761: checks
Pandora Dad: checks
*** TURN *** [Js 2c 4s] [Ks]
TY4PAYING said, "yikes"
professa oc: checks
Nguyenning: bets $0.08
Wildbill4761: calls $0.08
Pandora Dad: folds
professa oc: folds
*** RIVER *** [Js 2c 4s Ks] [9c]
Nguyenning: checks
Wildbill4761: checks
*** SHOW DOWN ***
Nguyenning: shows [2h 2s] (three of a kind, Deuces)
Wildbill4761: mucks hand
Nguyenning collected $0.23 from pot
*** SUMMARY ***
Total pot $0.24 | Rake $0.01
Board [Js 2c 4s Ks 9c]
Seat 1: Nguyenning (big blind) showed [2h 2s] and won ($0.23) with three of a kind, Deuces
Seat 2: Wildbill4761 mucked [3c Kd]
Seat 3: Pandora Dad folded on the Turn
Seat 4: tapouttazz9 (button) folded before Flop (didn't bet)
Seat 6: professa oc (small blind) folded on the Turn


PokerStars Hand #154859807663:  Hold'em No Limit ($0.01/$0.02 USD) - 2016/06/24 16:36:33 ET
Table 'Delphinus' 6-max Seat #6 is the button
Seat 1: Nguyenning ($3.56 in chips)
Seat 2: Wildbill4761 ($1.47 in chips)
Seat 3: Pandora Dad ($1.80 in chips)
Seat 4: tapouttazz9 ($1.88 in chips)
Seat 6: professa oc ($8.49 in chips)
Nguyenning: posts small blind $0.01
Wildbill4761: posts big blind $0.02
TY4PAYING: sits out
*** HOLE CARDS ***
Dealt to tapouttazz9 [Qd Tc]
Pandora Dad: folds
tapouttazz9: raises $0.02 to $0.04
professa oc: calls $0.04
Nguyenning: folds
Wildbill4761: calls $0.02
*** FLOP *** [2d 7s 7c]
Wildbill4761: checks
tapouttazz9: checks
professa oc: bets $0.08
Wildbill4761: calls $0.08
tapouttazz9: calls $0.08
*** TURN *** [2d 7s 7c] [4s]
Wildbill4761: checks
tapouttazz9: checks
professa oc: checks
*** RIVER *** [2d 7s 7c 4s] [5h]
Wildbill4761: bets $0.08
tapouttazz9: folds
professa oc: folds
Uncalled bet ($0.08) returned to Wildbill4761
Wildbill4761 collected $0.35 from pot
*** SUMMARY ***
Total pot $0.37 | Rake $0.02
Board [2d 7s 7c 4s 5h]
Seat 1: Nguyenning (small blind) folded before Flop
Seat 2: Wildbill4761 (big blind) collected ($0.35)
Seat 3: Pandora Dad folded before Flop (didn't bet)
Seat 4: tapouttazz9 folded on the River
Seat 6: professa oc (button) folded on the River


PokerStars Hand #154859807996:  Hold'em No Limit ($0.01/$0.02 USD) - 2016/06/24 16:37:34 ET
Table 'Delphinus' 6-max Seat #1 is the button
Seat 1: Nguyenning ($3.55 in chips)
Seat 2: Wildbill4761 ($1.70 in chips)
Seat 3: Pandora Dad ($1.80 in chips)
Seat 4: tapouttazz9 ($1.76 in chips)
Seat 6: professa oc ($8.37 in chips)
Wildbill4761: posts small blind $0.01
Pandora Dad: posts big blind $0.02
TY4PAYING: sits out
*** HOLE CARDS ***
Dealt to tapouttazz9 [Qh 2d]
tapouttazz9: folds
professa oc: folds
Nguyenning: calls $0.02
Wildbill4761: calls $0.01
Pandora Dad: checks
*** FLOP *** [7c Jh Kh]
Wildbill4761: checks
Pandora Dad: bets $0.04
Nguyenning: folds
Wildbill4761: folds
Uncalled bet ($0.04) returned to Pandora Dad
Pandora Dad collected $0.06 from pot
Pandora Dad: doesn't show hand
*** SUMMARY ***
Total pot $0.06 | Rake $0
Board [7c Jh Kh]
Seat 1: Nguyenning (button) folded on the Flop
Seat 2: Wildbill4761 (small blind) folded on the Flop
Seat 3: Pandora Dad (big blind) collected ($0.06)
Seat 4: tapouttazz9 folded before Flop (didn't bet)
Seat 6: professa oc folded before Flop (didn't bet)


PokerStars Hand #154859808204:  Hold'em No Limit ($0.01/$0.02 USD) - 2016/06/24 16:38:10 ET
Table 'Delphinus' 6-max Seat #2 is the button
Seat 1: Nguyenning ($3.53 in chips)
Seat 2: Wildbill4761 ($1.68 in chips)
Seat 3: Pandora Dad ($1.84 in chips)
Seat 4: tapouttazz9 ($1.76 in chips)
Seat 6: professa oc ($8.37 in chips)
Pandora Dad: posts small blind $0.01
tapouttazz9: posts big blind $0.02
TY4PAYING: sits out
*** HOLE CARDS ***
Dealt to tapouttazz9 [Ah Js]
professa oc: folds
Nguyenning: folds
Wildbill4761: calls $0.02
Pandora Dad: calls $0.01
tapouttazz9: raises $0.06 to $0.08
Wildbill4761: calls $0.06
Pandora Dad: folds
*** FLOP *** [Jd Kc Ts]
tapouttazz9: bets $0.08
Wildbill4761: calls $0.08
*** TURN *** [Jd Kc Ts] [Qh]
tapouttazz9: checks
Wildbill4761: bets $0.12
tapouttazz9: raises $0.56 to $0.68
Wildbill4761: folds
Uncalled bet ($0.56) returned to tapouttazz9
tapouttazz9 collected $0.55 from pot
tapouttazz9: doesn't show hand
*** SUMMARY ***
Total pot $0.58 | Rake $0.03
Board [Jd Kc Ts Qh]
Seat 1: Nguyenning folded before Flop (didn't bet)
Seat 2: Wildbill4761 (button) folded on the Turn
Seat 3: Pandora Dad (small blind) folded before Flop
Seat 4: tapouttazz9 (big blind) collected ($0.55)
Seat 6: professa oc folded before Flop (didn't bet)


PokerStars Hand #154859808430:  Hold'em No Limit ($0.01/$0.02 USD) - 2016/06/24 16:38:49 ET
Table 'Delphinus' 6-max Seat #3 is the button
Seat 1: Nguyenning ($3.53 in chips)
Seat 2: Wildbill4761 ($1.40 in chips)
Seat 3: Pandora Dad ($1.82 in chips)
Seat 4: tapouttazz9 ($2.03 in chips)
Seat 5: TY4PAYING ($2 in chips)
Seat 6: professa oc ($8.37 in chips)
tapouttazz9: posts small blind $0.01
TY4PAYING: posts big blind $0.02
*** HOLE CARDS ***
Dealt to tapouttazz9 [Kc 7c]
professa oc: folds
Nguyenning: folds
Wildbill4761: raises $0.02 to $0.04
Pandora Dad: calls $0.04
tapouttazz9: calls $0.03
TY4PAYING: calls $0.02
*** FLOP *** [Js Ad 5h]
tapouttazz9: checks
TY4PAYING: checks
Wildbill4761: bets $0.04
Pandora Dad: folds
tapouttazz9: folds
TY4PAYING: calls $0.04
*** TURN *** [Js Ad 5h] [5d]
TY4PAYING: checks
Wildbill4761: bets $0.10
TY4PAYING: folds
Uncalled bet ($0.10) returned to Wildbill4761
Wildbill4761 collected $0.23 from pot
*** SUMMARY ***
Total pot $0.24 | Rake $0.01
Board [Js Ad 5h 5d]
Seat 1: Nguyenning folded before Flop (didn't bet)
Seat 2: Wildbill4761 collected ($0.23)
Seat 3: Pandora Dad (button) folded on the Flop
Seat 4: tapouttazz9 (small blind) folded on the Flop
Seat 5: TY4PAYING (big blind) folded on the Turn
Seat 6: professa oc folded before Flop (didn't bet)


PokerStars Hand #154859808698:  Hold'em No Limit ($0.01/$0.02 USD) - 2016/06/24 16:39:37 ET
Table 'Delphinus' 6-max Seat #4 is the button
Seat 1: Nguyenning ($3.53 in chips)
Seat 2: Wildbill4761 ($1.55 in chips)
Seat 3: Pandora Dad ($1.78 in chips)
Seat 4: tapouttazz9 ($1.99 in chips)
Seat 5: TY4PAYING ($1.92 in chips)
Seat 6: professa oc ($8.37 in chips)
TY4PAYING: posts small blind $0.01
professa oc: posts big blind $0.02
*** HOLE CARDS ***
Dealt to tapouttazz9 [2h 8c]
Nguyenning: folds
Wildbill4761: calls $0.02
Pandora Dad: calls $0.02
tapouttazz9: folds
TY4PAYING: calls $0.01
professa oc: checks
*** FLOP *** [Qc Tc Js]
TY4PAYING: checks
professa oc: bets $0.06
Wildbill4761: folds
Pandora Dad: folds
TY4PAYING: calls $0.06
*** TURN *** [Qc Tc Js] [8s]
Nguyenning said, "saucy"
TY4PAYING: checks
professa oc: bets $0.09
TY4PAYING: calls $0.09
*** RIVER *** [Qc Tc Js 8s] [5s]
TY4PAYING: checks
professa oc: bets $0.25
TY4PAYING: folds
Uncalled bet ($0.25) returned to professa oc
professa oc collected $0.36 from pot
professa oc: doesn't show hand
*** SUMMARY ***
Total pot $0.38 | Rake $0.02
Board [Qc Tc Js 8s 5s]
Seat 1: Nguyenning folded before Flop (didn't bet)
Seat 2: Wildbill4761 folded on the Flop
Seat 3: Pandora Dad folded on the Flop
Seat 4: tapouttazz9 (button) folded before Flop (didn't bet)
Seat 5: TY4PAYING (small blind) folded on the River
Seat 6: professa oc (big blind) collected ($0.36)


PokerStars Hand #154859809145:  Hold'em No Limit ($0.01/$0.02 USD) - 2016/06/24 16:40:58 ET
Table 'Delphinus' 6-max Seat #5 is the button
Seat 1: Nguyenning ($3.53 in chips)
Seat 2: Wildbill4761 ($1.53 in chips)
Seat 3: Pandora Dad ($1.76 in chips)
Seat 4: tapouttazz9 ($1.99 in chips)
Seat 5: TY4PAYING ($1.75 in chips)
Seat 6: professa oc ($8.56 in chips)
professa oc: posts small blind $0.01
Nguyenning: posts big blind $0.02
*** HOLE CARDS ***
Dealt to tapouttazz9 [5s As]
Wildbill4761: folds
Pandora Dad: calls $0.02
tapouttazz9: raises $0.02 to $0.04
TY4PAYING: folds
professa oc: folds
Nguyenning: calls $0.02
Pandora Dad: calls $0.02
*** FLOP *** [6h 2s Ks]
Nguyenning: checks
Pandora Dad: bets $0.02
tapouttazz9: raises $0.08 to $0.10
Nguyenning: folds
Pandora Dad: calls $0.08
*** TURN *** [6h 2s Ks] [Th]
Pandora Dad: checks
tapouttazz9: bets $0.16
Pandora Dad: calls $0.16
*** RIVER *** [6h 2s Ks Th] [6d]
Pandora Dad: checks
tapouttazz9: bets $0.62
Pandora Dad: raises $0.84 to $1.46 and is all-in
tapouttazz9: folds [5s As]
Uncalled bet ($0.84) returned to Pandora Dad
Pandora Dad collected $1.81 from pot
Pandora Dad: doesn't show hand
*** SUMMARY ***
Total pot $1.89 | Rake $0.08
Board [6h 2s Ks Th 6d]
Seat 1: Nguyenning (big blind) folded on the Flop
Seat 2: Wildbill4761 folded before Flop (didn't bet)
Seat 3: Pandora Dad collected ($1.81)
Seat 4: tapouttazz9 folded on the River
Seat 5: TY4PAYING (button) folded before Flop (didn't bet)
Seat 6: professa oc (small blind) folded before Flop


PokerStars Hand #154859809625:  Hold'em No Limit ($0.01/$0.02 USD) - 2016/06/24 16:42:20 ET
Table 'Delphinus' 6-max Seat #6 is the button
Seat 1: Nguyenning ($3.49 in chips)
Seat 2: Wildbill4761 ($1.53 in chips)
Seat 3: Pandora Dad ($2.65 in chips)
Seat 4: tapouttazz9 ($1.07 in chips)
Seat 5: TY4PAYING ($1.75 in chips)
Seat 6: professa oc ($8.55 in chips)
Nguyenning: posts small blind $0.01
Wildbill4761: posts big blind $0.02
*** HOLE CARDS ***
Dealt to tapouttazz9 [Kc 3s]
Pandora Dad: calls $0.02
tapouttazz9: folds
TY4PAYING: calls $0.02
professa oc: folds
Nguyenning: folds
Wildbill4761: checks
*** FLOP *** [Jh Qs 6d]
Wildbill4761: checks
Pandora Dad: bets $0.02
TY4PAYING: raises $0.02 to $0.04
Wildbill4761: calls $0.04
Pandora Dad: calls $0.02
*** TURN *** [Jh Qs 6d] [7c]
Wildbill4761: checks
Pandora Dad: checks
TY4PAYING: bets $0.09
Wildbill4761: folds
Pandora Dad: calls $0.09
*** RIVER *** [Jh Qs 6d 7c] [Ks]
Pandora Dad: checks
TY4PAYING: checks
*** SHOW DOWN ***
Pandora Dad: shows [Qh 4s] (a pair of Queens)
TY4PAYING: mucks hand
Pandora Dad collected $0.35 from pot
*** SUMMARY ***
Total pot $0.37 | Rake $0.02
Board [Jh Qs 6d 7c Ks]
Seat 1: Nguyenning (small blind) folded before Flop
Seat 2: Wildbill4761 (big blind) folded on the Turn
Seat 3: Pandora Dad showed [Qh 4s] and won ($0.35) with a pair of Queens
Seat 4: tapouttazz9 folded before Flop (didn't bet)
Seat 5: TY4PAYING mucked [Jc 5c]
Seat 6: professa oc (button) folded before Flop (didn't bet)


PokerStars Hand #152406398230:  Hold'em No Limit ($0.01/$0.02 USD) - 2016/05/04 17:16:02 ET
Table 'Draco' 6-max Seat #6 is the button
Seat 1: lgny ($2.87 in chips)
Seat 2: tapouttazz9 ($2 in chips)
Seat 3: PotatoCh!p ($3.17 in chips)
Seat 4: LumberJackk7 ($1.21 in chips)
Seat 5: Jonesey45420 ($4.09 in chips)
Seat 6: IsMr10 ($0.82 in chips)
lgny: posts small blind $0.01
tapouttazz9: posts big blind $0.02
*** HOLE CARDS ***
Dealt to tapouttazz9 [Ad 4s]
PotatoCh!p: folds
LumberJackk7: folds
Jonesey45420: raises $0.05 to $0.07
IsMr10: folds
lgny: raises $0.43 to $0.50
tapouttazz9: folds
Jonesey45420: calls $0.43
*** FLOP *** [3h 6h 4c]
lgny: bets $0.97
Jonesey45420: raises $2.62 to $3.59 and is all-in
lgny: calls $1.40 and is all-in
Uncalled bet ($1.22) returned to Jonesey45420
*** TURN *** [3h 6h 4c] [Ah]
*** RIVER *** [3h 6h 4c Ah] [4d]
*** SHOW DOWN ***
lgny: shows [As Qs] (two pair, Aces and Fours)
Jonesey45420: mucks hand
lgny collected $5.50 from pot
*** SUMMARY ***
Total pot $5.76 | Rake $0.26
Board [3h 6h 4c Ah 4d]
Seat 1: lgny (small blind) showed [As Qs] and won ($5.50) with two pair, Aces and Fours
Seat 2: tapouttazz9 (big blind) folded before Flop
Seat 3: PotatoCh!p folded before Flop (didn't bet)
Seat 4: LumberJackk7 folded before Flop (didn't bet)
Seat 5: Jonesey45420 mucked [Jh Js]
Seat 6: IsMr10 (button) folded before Flop (didn't bet)


PokerStars Hand #152406398404:  Hold'em No Limit ($0.01/$0.02 USD) - 2016/05/04 17:16:53 ET
Table 'Draco' 6-max Seat #1 is the button
Seat 1: lgny ($5.50 in chips)
Seat 2: tapouttazz9 ($1.98 in chips)
Seat 3: PotatoCh!p ($3.17 in chips)
Seat 4: LumberJackk7 ($1.21 in chips)
Seat 5: Jonesey45420 ($1.22 in chips)
Seat 6: IsMr10 ($0.82 in chips)
tapouttazz9: posts small blind $0.01
PotatoCh!p: posts big blind $0.02
*** HOLE CARDS ***
Dealt to tapouttazz9 [2h Ts]
LumberJackk7: calls $0.02
Jonesey45420: raises $1.20 to $1.22 and is all-in
IsMr10: folds
lgny: folds
tapouttazz9: folds
PotatoCh!p: folds
LumberJackk7: folds
Uncalled bet ($1.20) returned to Jonesey45420
Jonesey45420 collected $0.07 from pot
Jonesey45420: doesn't show hand
*** SUMMARY ***
Total pot $0.07 | Rake $0
Seat 1: lgny (button) folded before Flop (didn't bet)
Seat 2: tapouttazz9 (small blind) folded before Flop
Seat 3: PotatoCh!p (big blind) folded before Flop
Seat 4: LumberJackk7 folded before Flop
Seat 5: Jonesey45420 collected ($0.07)
Seat 6: IsMr10 folded before Flop (didn't bet)


PokerStars Hand #152406398484:  Hold'em No Limit ($0.01/$0.02 USD) - 2016/05/04 17:17:17 ET
Table 'Draco' 6-max Seat #2 is the button
Seat 1: lgny ($5.50 in chips)
Seat 2: tapouttazz9 ($1.97 in chips)
Seat 3: PotatoCh!p ($3.15 in chips)
Seat 4: LumberJackk7 ($1.19 in chips)
Seat 5: Jonesey45420 ($1.27 in chips)
Seat 6: IsMr10 ($0.82 in chips)
PotatoCh!p: posts small blind $0.01
LumberJackk7: posts big blind $0.02
*** HOLE CARDS ***
Dealt to tapouttazz9 [Ah 7d]
Jonesey45420: calls $0.02
IsMr10: folds
lgny: folds
tapouttazz9: folds
PotatoCh!p: folds
LumberJackk7: checks
*** FLOP *** [Ts Jh Ks]
LumberJackk7: checks
Jonesey45420: checks
*** TURN *** [Ts Jh Ks] [3s]
LumberJackk7: checks
Jonesey45420: checks
*** RIVER *** [Ts Jh Ks 3s] [3d]
LumberJackk7: checks
Jonesey45420: checks
*** SHOW DOWN ***
LumberJackk7: shows [9s 4h] (a pair of Threes)
Jonesey45420: shows [2h 7c] (a pair of Threes)
LumberJackk7 collected $0.03 from pot
Jonesey45420 collected $0.02 from pot
*** SUMMARY ***
Total pot $0.05 | Rake $0
Board [Ts Jh Ks 3s 3d]
Seat 1: lgny folded before Flop (didn't bet)
Seat 2: tapouttazz9 (button) folded before Flop (didn't bet)
Seat 3: PotatoCh!p (small blind) folded before Flop
Seat 4: LumberJackk7 (big blind) showed [9s 4h] and won ($0.03) with a pair of Threes
Seat 5: Jonesey45420 showed [2h 7c] and won ($0.02) with a pair of Threes
Seat 6: IsMr10 folded before Flop (didn't bet)


PokerStars Hand #152406398584:  Hold'em No Limit ($0.01/$0.02 USD) - 2016/05/04 17:17:43 ET
Table 'Draco' 6-max Seat #3 is the button
Seat 1: lgny ($5.50 in chips)
Seat 2: tapouttazz9 ($1.97 in chips)
Seat 3: PotatoCh!p ($3.14 in chips)
Seat 4: LumberJackk7 ($1.20 in chips)
Seat 5: Jonesey45420 ($1.27 in chips)
Seat 6: IsMr10 ($0.82 in chips)
LumberJackk7: posts small blind $0.01
Jonesey45420: posts big blind $0.02
*** HOLE CARDS ***
Dealt to tapouttazz9 [5c Qh]
IsMr10: raises $0.04 to $0.06
lgny: folds
tapouttazz9: folds
PotatoCh!p: calls $0.06
LumberJackk7: folds
Jonesey45420: calls $0.04
*** FLOP *** [Ad 3d 2c]
Jonesey45420: checks
IsMr10: bets $0.18
PotatoCh!p: folds
Jonesey45420: raises $1.03 to $1.21 and is all-in
IsMr10: calls $0.58 and is all-in
Uncalled bet ($0.45) returned to Jonesey45420
*** TURN *** [Ad 3d 2c] [7s]
*** RIVER *** [Ad 3d 2c 7s] [3c]
*** SHOW DOWN ***
Jonesey45420: shows [7h Ac] (two pair, Aces and Sevens)
IsMr10: shows [6h Ah] (two pair, Aces and Threes)
Jonesey45420 collected $1.63 from pot
*** SUMMARY ***
Total pot $1.71 | Rake $0.08
Board [Ad 3d 2c 7s 3c]
Seat 1: lgny folded before Flop (didn't bet)
Seat 2: tapouttazz9 folded before Flop (didn't bet)
Seat 3: PotatoCh!p (button) folded on the Flop
Seat 4: LumberJackk7 (small blind) folded before Flop
Seat 5: Jonesey45420 (big blind) showed [7h Ac] and won ($1.63) with two pair, Aces and Sevens
Seat 6: IsMr10 showed [6h Ah] and lost with two pair, Aces and Threes


PokerStars Hand #152406398706:  Hold'em No Limit ($0.01/$0.02 USD) - 2016/05/04 17:18:15 ET
Table 'Draco' 6-max Seat #4 is the button
Seat 1: lgny ($5.50 in chips)
Seat 2: tapouttazz9 ($1.97 in chips)
Seat 3: PotatoCh!p ($3.08 in chips)
Seat 4: LumberJackk7 ($1.19 in chips)
Seat 5: Jonesey45420 ($2.08 in chips)
Jonesey45420: posts small blind $0.01
lgny: posts big blind $0.02
*** HOLE CARDS ***
Dealt to tapouttazz9 [Js Th]
tapouttazz9: folds
PotatoCh!p: folds
LumberJackk7: folds
Jonesey45420: calls $0.01
lgny: raises $0.04 to $0.06
Jonesey45420: calls $0.04
*** FLOP *** [Ks 6h Qd]
Jonesey45420: checks
lgny: bets $0.11
Jonesey45420: calls $0.11
*** TURN *** [Ks 6h Qd] [2c]
Jonesey45420: checks
lgny: bets $0.18
IsMr10 leaves the table
Jonesey45420: calls $0.18
*** RIVER *** [Ks 6h Qd 2c] [2s]
Jonesey45420: checks
lgny: bets $1
Jonesey45420: folds
Uncalled bet ($1) returned to lgny
lgny collected $0.67 from pot
lgny: shows [2h]
*** SUMMARY ***
Total pot $0.70 | Rake $0.03
Board [Ks 6h Qd 2c 2s]
Seat 1: lgny (big blind) collected ($0.67)
Seat 2: tapouttazz9 folded before Flop (didn't bet)
Seat 3: PotatoCh!p folded before Flop (didn't bet)
Seat 4: LumberJackk7 (button) folded before Flop (didn't bet)
Seat 5: Jonesey45420 (small blind) folded on the River


PokerStars Hand #152406398880:  Hold'em No Limit ($0.01/$0.02 USD) - 2016/05/04 17:19:06 ET
Table 'Draco' 6-max Seat #5 is the button
Seat 1: lgny ($5.82 in chips)
Seat 2: tapouttazz9 ($1.97 in chips)
Seat 3: PotatoCh!p ($3.08 in chips)
Seat 4: LumberJackk7 ($1.19 in chips)
Seat 5: Jonesey45420 ($1.73 in chips)
lgny: posts small blind $0.01
tapouttazz9: posts big blind $0.02
*** HOLE CARDS ***
Dealt to tapouttazz9 [Kd Qs]
PotatoCh!p: calls $0.02
LumberJackk7: folds
Jonesey45420: calls $0.02
lgny: calls $0.01
tapouttazz9: checks
*** FLOP *** [2h Ks 6d]
lgny: checks
tapouttazz9: bets $0.02
PotatoCh!p: folds
Jonesey45420: calls $0.02
lgny: calls $0.02
*** TURN *** [2h Ks 6d] [3s]
lgny: checks
tapouttazz9: bets $0.09
Jonesey45420: calls $0.09
lgny: calls $0.09
*** RIVER *** [2h Ks 6d 3s] [5s]
lgny: checks
tapouttazz9: bets $0.19
Jonesey45420: calls $0.19
lgny: raises $0.96 to $1.15
tapouttazz9: folds
Jonesey45420: folds
Uncalled bet ($0.96) returned to lgny
lgny collected $0.94 from pot
lgny: doesn't show hand
*** SUMMARY ***
Total pot $0.98 | Rake $0.04
Board [2h Ks 6d 3s 5s]
Seat 1: lgny (small blind) collected ($0.94)
Seat 2: tapouttazz9 (big blind) folded on the River
Seat 3: PotatoCh!p folded on the Flop
Seat 4: LumberJackk7 folded before Flop (didn't bet)
Seat 5: Jonesey45420 (button) folded on the River


PokerStars Hand #152406399105:  Hold'em No Limit ($0.01/$0.02 USD) - 2016/05/04 17:20:16 ET
Table 'Draco' 6-max Seat #1 is the button
Seat 1: lgny ($6.44 in chips)
Seat 2: tapouttazz9 ($1.65 in chips)
Seat 4: LumberJackk7 ($1.19 in chips)
Seat 5: Jonesey45420 ($1.41 in chips)
tapouttazz9: posts small blind $0.01
LumberJackk7: posts big blind $0.02
*** HOLE CARDS ***
Dealt to tapouttazz9 [2h 4h]
Jonesey45420: folds
lgny: calls $0.02
tapouttazz9: folds
PotatoCh!p leaves the table
LumberJackk7: checks
*** FLOP *** [6d 6h 3c]
LumberJackk7: checks
lgny: checks
*** TURN *** [6d 6h 3c] [2s]
LumberJackk7: checks
lgny: checks
*** RIVER *** [6d 6h 3c 2s] [2c]
LumberJackk7: checks
lgny: bets $0.10
LumberJackk7: folds
Uncalled bet ($0.10) returned to lgny
lgny collected $0.05 from pot
lgny: shows [As 2d] (a full house, Deuces full of Sixes)
*** SUMMARY ***
Total pot $0.05 | Rake $0
Board [6d 6h 3c 2s 2c]
Seat 1: lgny (button) collected ($0.05)
Seat 2: tapouttazz9 (small blind) folded before Flop
Seat 4: LumberJackk7 (big blind) folded on the River
Seat 5: Jonesey45420 folded before Flop (didn't bet)


PokerStars Hand #152406399235:  Hold'em No Limit ($0.01/$0.02 USD) - 2016/05/04 17:20:53 ET
Table 'Draco' 6-max Seat #2 is the button
Seat 1: lgny ($6.47 in chips)
Seat 2: tapouttazz9 ($2 in chips)
Seat 4: LumberJackk7 ($1.17 in chips)
Seat 5: Jonesey45420 ($1.41 in chips)
LumberJackk7: posts small blind $0.01
Jonesey45420: posts big blind $0.02
*** HOLE CARDS ***
Dealt to tapouttazz9 [5d Ah]
lgny: calls $0.02
tapouttazz9: folds
LumberJackk7: calls $0.01
Jonesey45420: checks
*** FLOP *** [6d Qd 4h]
LumberJackk7: bets $0.02
Jonesey45420: calls $0.02
lgny: calls $0.02
*** TURN *** [6d Qd 4h] [Qs]
LumberJackk7: bets $0.02
Jonesey45420: calls $0.02
lgny: calls $0.02
*** RIVER *** [6d Qd 4h Qs] [9h]
LumberJackk7: bets $0.02
Jonesey45420: calls $0.02
lgny: folds
*** SHOW DOWN ***
LumberJackk7: shows [8d 4d] (two pair, Queens and Fours)
Jonesey45420: mucks hand
LumberJackk7 collected $0.21 from pot
blindguy1954 joins the table at seat #6
*** SUMMARY ***
Total pot $0.22 | Rake $0.01
Board [6d Qd 4h Qs 9h]
Seat 1: lgny folded on the River
Seat 2: tapouttazz9 (button) folded before Flop (didn't bet)
Seat 4: LumberJackk7 (small blind) showed [8d 4d] and won ($0.21) with two pair, Queens and Fours
Seat 5: Jonesey45420 (big blind) mucked [8h Kc]


PokerStars Hand #152406399369:  Hold'em No Limit ($0.01/$0.02 USD) - 2016/05/04 17:21:27 ET
Table 'Draco' 6-max Seat #4 is the button
Seat 1: lgny ($6.41 in chips)
Seat 2: tapouttazz9 ($2 in chips)
Seat 4: LumberJackk7 ($1.30 in chips)
Seat 5: Jonesey45420 ($1.33 in chips)
Seat 6: blindguy1954 ($2 in chips)
Jonesey45420: posts small blind $0.01
blindguy1954: posts big blind $0.02
*** HOLE CARDS ***
Dealt to tapouttazz9 [3s 7d]
lgny: folds
tapouttazz9: folds
LumberJackk7: calls $0.02
Jonesey45420: calls $0.01
blindguy1954: raises $0.06 to $0.08
LumberJackk7: calls $0.06
Jonesey45420: calls $0.06
*** FLOP *** [Qs 5c Jh]
Jonesey45420: checks
blindguy1954: bets $0.10
LumberJackk7: folds
Jonesey45420: calls $0.10
*** TURN *** [Qs 5c Jh] [8d]
Jonesey45420: checks
blindguy1954: checks
*** RIVER *** [Qs 5c Jh 8d] [6h]
Jonesey45420: checks
blindguy1954: bets $0.20
Jonesey45420: folds
Uncalled bet ($0.20) returned to blindguy1954
blindguy1954 collected $0.42 from pot
blindguy1954: doesn't show hand
*** SUMMARY ***
Total pot $0.44 | Rake $0.02
Board [Qs 5c Jh 8d 6h]
Seat 1: lgny folded before Flop (didn't bet)
Seat 2: tapouttazz9 folded before Flop (didn't bet)
Seat 4: LumberJackk7 (button) folded on the Flop
Seat 5: Jonesey45420 (small blind) folded on the River
Seat 6: blindguy1954 (big blind) collected ($0.42)


PokerStars Hand #152406399526:  Hold'em No Limit ($0.01/$0.02 USD) - 2016/05/04 17:22:13 ET
Table 'Draco' 6-max Seat #5 is the button
Seat 1: lgny ($6.41 in chips)
Seat 2: tapouttazz9 ($2 in chips)
Seat 4: LumberJackk7 ($1.22 in chips)
Seat 5: Jonesey45420 ($1.15 in chips)
Seat 6: blindguy1954 ($2.24 in chips)
blindguy1954: posts small blind $0.01
lgny: posts big blind $0.02
*** HOLE CARDS ***
Dealt to tapouttazz9 [Jh Ac]
tapouttazz9: raises $0.02 to $0.04
LumberJackk7: folds
Jonesey45420: folds
blindguy1954: folds
lgny: calls $0.02
*** FLOP *** [2h 5d Th]
lgny: checks
tapouttazz9: checks
*** TURN *** [2h 5d Th] [2d]
lgny: checks
tapouttazz9: checks
*** RIVER *** [2h 5d Th 2d] [3d]
lgny: bets $0.20
tapouttazz9: folds
Uncalled bet ($0.20) returned to lgny
lgny collected $0.09 from pot
lgny: doesn't show hand
*** SUMMARY ***
Total pot $0.09 | Rake $0
Board [2h 5d Th 2d 3d]
Seat 1: lgny (big blind) collected ($0.09)
Seat 2: tapouttazz9 folded on the River
Seat 4: LumberJackk7 folded before Flop (didn't bet)
Seat 5: Jonesey45420 (button) folded before Flop (didn't bet)
Seat 6: blindguy1954 (small blind) folded before Flop


PokerStars Hand #152406399609:  Hold'em No Limit ($0.01/$0.02 USD) - 2016/05/04 17:22:35 ET
Table 'Draco' 6-max Seat #6 is the button
Seat 1: lgny ($6.46 in chips)
Seat 2: tapouttazz9 ($1.96 in chips)
Seat 4: LumberJackk7 ($1.22 in chips)
Seat 5: Jonesey45420 ($1.15 in chips)
Seat 6: blindguy1954 ($2.23 in chips)
lgny: posts small blind $0.01
tapouttazz9: posts big blind $0.02
*** HOLE CARDS ***
Dealt to tapouttazz9 [Ks 9h]
LumberJackk7: calls $0.02
Jonesey45420: raises $0.07 to $0.09
blindguy1954: folds
lgny: raises $0.07 to $0.16
tapouttazz9: folds
LumberJackk7: folds
Jonesey45420: raises $0.99 to $1.15 and is all-in
lgny: calls $0.99
*** FLOP *** [4h 6c 6d]
*** TURN *** [4h 6c 6d] [2c]
*** RIVER *** [4h 6c 6d 2c] [5s]
*** SHOW DOWN ***
lgny: shows [Tc Ac] (a pair of Sixes)
Jonesey45420: shows [Kd Ah] (a pair of Sixes - Ace+King kicker)
Jonesey45420 collected $2.23 from pot
*** SUMMARY ***
Total pot $2.34 | Rake $0.11
Board [4h 6c 6d 2c 5s]
Seat 1: lgny (small blind) showed [Tc Ac] and lost with a pair of Sixes
Seat 2: tapouttazz9 (big blind) folded before Flop
Seat 4: LumberJackk7 folded before Flop
Seat 5: Jonesey45420 showed [Kd Ah] and won ($2.23) with a pair of Sixes
Seat 6: blindguy1954 (button) folded before Flop (didn't bet)


PokerStars Hand #152406399698:  Hold'em No Limit ($0.01/$0.02 USD) - 2016/05/04 17:22:58 ET
Table 'Draco' 6-max Seat #1 is the button
Seat 1: lgny ($5.31 in chips)
Seat 2: tapouttazz9 ($1.94 in chips)
Seat 4: LumberJackk7 ($1.20 in chips)
Seat 5: Jonesey45420 ($2.23 in chips)
Seat 6: blindguy1954 ($2.23 in chips)
tapouttazz9: posts small blind $0.01
LumberJackk7: posts big blind $0.02
*** HOLE CARDS ***
Dealt to tapouttazz9 [8s 8h]
Jonesey45420: folds
blindguy1954: calls $0.02
lgny: calls $0.02
tapouttazz9: raises $0.02 to $0.04
LumberJackk7: calls $0.02
blindguy1954: calls $0.02
lgny: calls $0.02
*** FLOP *** [9d 9c 2h]
tapouttazz9: bets $0.15
LumberJackk7: folds
blindguy1954: raises $0.15 to $0.30
lgny: folds
tapouttazz9: calls $0.15
*** TURN *** [9d 9c 2h] [7c]
tapouttazz9: checks
blindguy1954: bets $0.72
tapouttazz9: raises $0.88 to $1.60 and is all-in
blindguy1954: calls $0.88
*** RIVER *** [9d 9c 2h 7c] [7h]
*** SHOW DOWN ***
tapouttazz9: shows [8s 8h] (two pair, Nines and Eights)
blindguy1954: shows [4c 2s] (two pair, Nines and Sevens)
lgny said, "lol"
tapouttazz9 collected $3.78 from pot
*** SUMMARY ***
Total pot $3.96 | Rake $0.18
Board [9d 9c 2h 7c 7h]
Seat 1: lgny (button) folded on the Flop
Seat 2: tapouttazz9 (small blind) showed [8s 8h] and won ($3.78) with two pair, Nines and Eights
Seat 4: LumberJackk7 (big blind) folded on the Flop
Seat 5: Jonesey45420 folded before Flop (didn't bet)
Seat 6: blindguy1954 showed [4c 2s] and lost with two pair, Nines and Sevens


PokerStars Hand #152406399864:  Hold'em No Limit ($0.01/$0.02 USD) - 2016/05/04 17:23:47 ET
Table 'Draco' 6-max Seat #2 is the button
Seat 1: lgny ($5.27 in chips)
Seat 2: tapouttazz9 ($3.78 in chips)
Seat 4: LumberJackk7 ($1.16 in chips)
Seat 5: Jonesey45420 ($2.23 in chips)
Seat 6: blindguy1954 ($0.29 in chips)
LumberJackk7: posts small blind $0.01
Jonesey45420: posts big blind $0.02
*** HOLE CARDS ***
Dealt to tapouttazz9 [6d Ac]
blindguy1954: raises $0.27 to $0.29 and is all-in
lgny: folds
tapouttazz9: folds
LumberJackk7: folds
Jonesey45420: folds
Uncalled bet ($0.27) returned to blindguy1954
blindguy1954 collected $0.05 from pot
blindguy1954: doesn't show hand
*** SUMMARY ***
Total pot $0.05 | Rake $0
Seat 1: lgny folded before Flop (didn't bet)
Seat 2: tapouttazz9 (button) folded before Flop (didn't bet)
Seat 4: LumberJackk7 (small blind) folded before Flop
Seat 5: Jonesey45420 (big blind) folded before Flop
Seat 6: blindguy1954 collected ($0.05)


PokerStars Hand #152406399926:  Hold'em No Limit ($0.01/$0.02 USD) - 2016/05/04 17:24:06 ET
Table 'Draco' 6-max Seat #4 is the button
Seat 1: lgny ($5.27 in chips)
Seat 2: tapouttazz9 ($3.78 in chips)
Seat 4: LumberJackk7 ($1.15 in chips)
Seat 5: Jonesey45420 ($2.21 in chips)
Seat 6: blindguy1954 ($0.32 in chips)
Jonesey45420: posts small blind $0.01
blindguy1954: posts big blind $0.02
*** HOLE CARDS ***
Dealt to tapouttazz9 [7d 4c]
lgny: raises $0.10 to $0.12
tapouttazz9: folds
LumberJackk7: folds
Jonesey45420: calls $0.11
blindguy1954: raises $0.20 to $0.32 and is all-in
lgny: raises $0.76 to $1.08
mgro316 joins the table at seat #3
Jonesey45420: calls $0.96
*** FLOP *** [9c 3d 3c]
Jonesey45420: checks
lgny: bets $1.18
Jonesey45420: calls $1.13 and is all-in
Uncalled bet ($0.05) returned to lgny
*** TURN *** [9c 3d 3c] [4d]
*** RIVER *** [9c 3d 3c 4d] [6d]
*** SHOW DOWN ***
Jonesey45420: shows [8d 8s] (two pair, Eights and Threes)
lgny: shows [Qh Ad] (a pair of Threes)
Jonesey45420 collected $3.61 from side pot
blindguy1954: mucks hand
Jonesey45420 collected $0.92 from main pot
*** SUMMARY ***
Total pot $4.74 Main pot $0.92. Side pot $3.61. | Rake $0.21
Board [9c 3d 3c 4d 6d]
Seat 1: lgny showed [Qh Ad] and lost with a pair of Threes
Seat 2: tapouttazz9 folded before Flop (didn't bet)
Seat 4: LumberJackk7 (button) folded before Flop (didn't bet)
Seat 5: Jonesey45420 (small blind) showed [8d 8s] and won ($4.53) with two pair, Eights and Threes
Seat 6: blindguy1954 (big blind) mucked [6c Ts]


PokerStars Hand #152406654810:  Hold'em No Limit ($0.01/$0.02 USD) - 2016/05/04 17:25:03 ET
Table 'Draco' 6-max Seat #5 is the button
Seat 1: lgny ($3.06 in chips)
Seat 2: tapouttazz9 ($3.78 in chips)
Seat 3: mgro316 ($2 in chips)
Seat 4: LumberJackk7 ($1.15 in chips)
Seat 5: Jonesey45420 ($4.53 in chips)
Seat 6: blindguy1954 ($2 in chips)
blindguy1954: posts small blind $0.01
lgny: posts big blind $0.02
mgro316: posts big blind $0.02
*** HOLE CARDS ***
Dealt to tapouttazz9 [Ad Tc]
tapouttazz9: raises $0.03 to $0.05
mgro316: raises $0.03 to $0.08
LumberJackk7: calls $0.08
Jonesey45420: folds
blindguy1954: folds
lgny: calls $0.06
tapouttazz9: calls $0.03
*** FLOP *** [Jh 4s 5c]
lgny: bets $2.98 and is all-in
tapouttazz9: folds
mgro316: folds
LumberJackk7: folds
Uncalled bet ($2.98) returned to lgny
lgny collected $0.32 from pot
*** SUMMARY ***
Total pot $0.33 | Rake $0.01
Board [Jh 4s 5c]
Seat 1: lgny (big blind) collected ($0.32)
Seat 2: tapouttazz9 folded on the Flop
Seat 3: mgro316 folded on the Flop
Seat 4: LumberJackk7 folded on the Flop
Seat 5: Jonesey45420 (button) folded before Flop (didn't bet)
Seat 6: blindguy1954 (small blind) folded before Flop


PokerStars Hand #152406655376:  Hold'em No Limit ($0.01/$0.02 USD) - 2016/05/04 17:28:00 ET
Table 'Draco' 6-max Seat #5 is the button
Seat 1: lgny ($6.03 in chips)
Seat 2: tapouttazz9 ($3.70 in chips)
Seat 3: mgro316 ($2.11 in chips)
Seat 5: Jonesey45420 ($4.42 in chips)
blindguy1954 will be allowed to play after the button
lgny: posts small blind $0.01
tapouttazz9: posts big blind $0.02
*** HOLE CARDS ***
Dealt to tapouttazz9 [Ts 7s]
mgro316: folds
Jonesey45420: calls $0.02
lgny: folds
tapouttazz9: checks
*** FLOP *** [9d Th Ah]
mgro316 leaves the table
tapouttazz9: checks
Jonesey45420: checks
*** TURN *** [9d Th Ah] [Qs]
tapouttazz9: checks
Jonesey45420: checks
*** RIVER *** [9d Th Ah Qs] [Td]
tapouttazz9: bets $0.06
Ashes2dust11 joins the table at seat #3
Jonesey45420: calls $0.06
*** SHOW DOWN ***
tapouttazz9: shows [Ts 7s] (three of a kind, Tens)
Jonesey45420: mucks hand
tapouttazz9 collected $0.16 from pot
*** SUMMARY ***
Total pot $0.17 | Rake $0.01
Board [9d Th Ah Qs Td]
Seat 1: lgny (small blind) folded before Flop
Seat 2: tapouttazz9 (big blind) showed [Ts 7s] and won ($0.16) with three of a kind, Tens
Seat 3: mgro316 folded before Flop (didn't bet)
Seat 5: Jonesey45420 (button) mucked [6c Qc]


PokerStars Hand #152406655531:  Hold'em No Limit ($0.01/$0.02 USD) - 2016/05/04 17:28:41 ET
Table 'Draco' 6-max Seat #1 is the button
Seat 1: lgny ($6.02 in chips)
Seat 2: tapouttazz9 ($3.78 in chips)
Seat 3: Ashes2dust11 ($2 in chips)
Seat 5: Jonesey45420 ($4.34 in chips)
Seat 6: blindguy1954 ($2 in chips)
tapouttazz9: posts small blind $0.01
Ashes2dust11: posts big blind $0.02
blindguy1954: posts small & big blinds $0.03
*** HOLE CARDS ***
Dealt to tapouttazz9 [9h As]
Jonesey45420: calls $0.02
blindguy1954: checks
lgny: folds
tapouttazz9: raises $0.02 to $0.04
Ashes2dust11: calls $0.02
Jonesey45420: calls $0.02
blindguy1954: raises $0.17 to $0.21
tapouttazz9: folds
Ashes2dust11: folds
Jonesey45420: folds
Uncalled bet ($0.17) returned to blindguy1954
blindguy1954 collected $0.17 from pot
blindguy1954: doesn't show hand
*** SUMMARY ***
Total pot $0.17 | Rake $0
Seat 1: lgny (button) folded before Flop (didn't bet)
Seat 2: tapouttazz9 (small blind) folded before Flop
Seat 3: Ashes2dust11 (big blind) folded before Flop
Seat 5: Jonesey45420 folded before Flop
Seat 6: blindguy1954 collected ($0.17)


PokerStars Hand #152406655637:  Hold'em No Limit ($0.01/$0.02 USD) - 2016/05/04 17:29:15 ET
Table 'Draco' 6-max Seat #2 is the button
Seat 1: lgny ($6.02 in chips)
Seat 2: tapouttazz9 ($3.74 in chips)
Seat 3: Ashes2dust11 ($1.96 in chips)
Seat 5: Jonesey45420 ($4.30 in chips)
Seat 6: blindguy1954 ($2.12 in chips)
Ashes2dust11: posts small blind $0.01
Jonesey45420: posts big blind $0.02
*** HOLE CARDS ***
Dealt to tapouttazz9 [4c As]
blindguy1954: calls $0.02
lgny: calls $0.02
tapouttazz9: folds
Ashes2dust11: calls $0.01
Jonesey45420: checks
*** FLOP *** [5d 8h Tc]
Ashes2dust11: checks
Jonesey45420: checks
blindguy1954: bets $0.02
lgny: calls $0.02
Ashes2dust11: folds
Jonesey45420: calls $0.02
*** TURN *** [5d 8h Tc] [3s]
Jonesey45420: checks
blindguy1954: checks
lgny: checks
*** RIVER *** [5d 8h Tc 3s] [7h]
Jonesey45420: checks
blindguy1954: checks
lgny: checks
*** SHOW DOWN ***
Jonesey45420: shows [9d 5s] (a pair of Fives)
blindguy1954: shows [Qh Qs] (a pair of Queens)
lgny: mucks hand
blindguy1954 collected $0.13 from pot
*** SUMMARY ***
Total pot $0.14 | Rake $0.01
Board [5d 8h Tc 3s 7h]
Seat 1: lgny mucked [Qd 6c]
Seat 2: tapouttazz9 (button) folded before Flop (didn't bet)
Seat 3: Ashes2dust11 (small blind) folded on the Flop
Seat 5: Jonesey45420 (big blind) showed [9d 5s] and lost with a pair of Fives
Seat 6: blindguy1954 showed [Qh Qs] and won ($0.13) with a pair of Queens


PokerStars Hand #152406655815:  Hold'em No Limit ($0.01/$0.02 USD) - 2016/05/04 17:30:13 ET
Table 'Draco' 6-max Seat #3 is the button
Seat 1: lgny ($5.98 in chips)
Seat 2: tapouttazz9 ($3.74 in chips)
Seat 3: Ashes2dust11 ($1.94 in chips)
Seat 5: Jonesey45420 ($4.26 in chips)
Seat 6: blindguy1954 ($2.21 in chips)
Jonesey45420: posts small blind $0.01
blindguy1954: posts big blind $0.02
*** HOLE CARDS ***
Dealt to tapouttazz9 [Ac 7c]
lgny: folds
tapouttazz9: raises $0.02 to $0.04
lgny said, "the one hand you should bet you dont"
Ashes2dust11: calls $0.04
Jonesey45420: folds
blindguy1954: raises $0.13 to $0.17
tapouttazz9: calls $0.13
Ashes2dust11: folds
*** FLOP *** [2d 8h 4c]
blindguy1954: bets $0.36
tapouttazz9: raises $0.36 to $0.72
blindguy1954: raises $1.32 to $2.04 and is all-in
tapouttazz9: calls $1.32
*** TURN *** [2d 8h 4c] [3c]
*** RIVER *** [2d 8h 4c 3c] [Js]
*** SHOW DOWN ***
blindguy1954: shows [6c 5d] (a straight, Deuce to Six)
tapouttazz9: shows [Ac 7c] (high card Ace)
blindguy1954 collected $4.27 from pot
*** SUMMARY ***
Total pot $4.47 | Rake $0.20
Board [2d 8h 4c 3c Js]
Seat 1: lgny folded before Flop (didn't bet)
Seat 2: tapouttazz9 showed [Ac 7c] and lost with high card Ace
Seat 3: Ashes2dust11 (button) folded before Flop
Seat 5: Jonesey45420 (small blind) folded before Flop
Seat 6: blindguy1954 (big blind) showed [6c 5d] and won ($4.27) with a straight, Deuce to Six


PokerStars Hand #152406656027:  Hold'em No Limit ($0.01/$0.02 USD) - 2016/05/04 17:31:11 ET
Table 'Draco' 6-max Seat #5 is the button
Seat 1: lgny ($5.98 in chips)
Seat 2: tapouttazz9 ($1.53 in chips)
Seat 3: Ashes2dust11 ($1.90 in chips)
Seat 5: Jonesey45420 ($4.25 in chips)
Seat 6: blindguy1954 ($4.27 in chips)
blindguy1954: posts small blind $0.01
lgny: posts big blind $0.02
*** HOLE CARDS ***
Dealt to tapouttazz9 [Kh 3h]
tapouttazz9: folds
Ashes2dust11: calls $0.02
Jonesey45420: folds
blindguy1954: calls $0.01
lgny: raises $0.06 to $0.08
blindguy1954 said, "lol"
Ashes2dust11: calls $0.06
blindguy1954: calls $0.06
*** FLOP *** [Kc 7d 5c]
blindguy1954: checks
lgny: checks
Ashes2dust11: checks
*** TURN *** [Kc 7d 5c] [7h]
blindguy1954: bets $0.10
lgny: calls $0.10
Ashes2dust11: calls $0.10
*** RIVER *** [Kc 7d 5c 7h] [5s]
blindguy1954: checks
lgny: checks
Ashes2dust11: bets $0.26
blindguy1954: raises $0.52 to $0.78
lgny: folds
Ashes2dust11: calls $0.52
*** SHOW DOWN ***
blindguy1954: shows [7c Js] (a full house, Sevens full of Fives)
Ashes2dust11: mucks hand
blindguy1954 collected $2.01 from pot
*** SUMMARY ***
Total pot $2.10 | Rake $0.09
Board [Kc 7d 5c 7h 5s]
Seat 1: lgny (big blind) folded on the River
Seat 2: tapouttazz9 folded before Flop (didn't bet)
Seat 3: Ashes2dust11 mucked [Ks Tc]
Seat 5: Jonesey45420 (button) folded before Flop (didn't bet)
Seat 6: blindguy1954 (small blind) showed [7c Js] and won ($2.01) with a full house, Sevens full of Fives


PokerStars Hand #152406656254:  Hold'em No Limit ($0.01/$0.02 USD) - 2016/05/04 17:32:17 ET
Table 'Draco' 6-max Seat #6 is the button
Seat 1: lgny ($5.80 in chips)
Seat 2: tapouttazz9 ($2 in chips)
Seat 3: Ashes2dust11 ($0.94 in chips)
Seat 5: Jonesey45420 ($4.25 in chips)
Seat 6: blindguy1954 ($5.32 in chips)
lgny: posts small blind $0.01
tapouttazz9: posts big blind $0.02
*** HOLE CARDS ***
Dealt to tapouttazz9 [6d 4h]
Ashes2dust11: calls $0.02
Jonesey45420: calls $0.02
blindguy1954: calls $0.02
lgny: calls $0.01
tapouttazz9: checks
*** FLOP *** [2s Jh 4s]
lgny: checks
tapouttazz9: checks
Ashes2dust11: checks
Jonesey45420: checks
blindguy1954: checks
*** TURN *** [2s Jh 4s] [7d]
lgny: checks
tapouttazz9: checks
Ashes2dust11: checks
Jonesey45420: checks
blindguy1954: checks
*** RIVER *** [2s Jh 4s 7d] [4d]
lgny: checks
tapouttazz9: bets $0.10
Ashes2dust11: folds
Jonesey45420: folds
blindguy1954: calls $0.10
lgny: folds
*** SHOW DOWN ***
tapouttazz9: shows [6d 4h] (three of a kind, Fours)
blindguy1954: mucks hand
tapouttazz9 collected $0.29 from pot
*** SUMMARY ***
Total pot $0.30 | Rake $0.01
Board [2s Jh 4s 7d 4d]
Seat 1: lgny (small blind) folded on the River
Seat 2: tapouttazz9 (big blind) showed [6d 4h] and won ($0.29) with three of a kind, Fours
Seat 3: Ashes2dust11 folded on the River
Seat 5: Jonesey45420 folded on the River
Seat 6: blindguy1954 (button) mucked [2c Ts]


PokerStars Hand #152406656437:  Hold'em No Limit ($0.01/$0.02 USD) - 2016/05/04 17:33:08 ET
Table 'Draco' 6-max Seat #1 is the button
Seat 1: lgny ($5.78 in chips)
Seat 2: tapouttazz9 ($2.17 in chips)
Seat 3: Ashes2dust11 ($0.92 in chips)
Seat 5: Jonesey45420 ($4.23 in chips)
Seat 6: blindguy1954 ($5.20 in chips)
tapouttazz9: posts small blind $0.01
Ashes2dust11: posts big blind $0.02
*** HOLE CARDS ***
Dealt to tapouttazz9 [6c 9s]
Jonesey45420 has timed out
Jonesey45420: folds
blindguy1954: calls $0.02
lgny: folds
tapouttazz9: folds
Ashes2dust11: checks
*** FLOP *** [8d Kh Qd]
blindguy1954 said, "let's go!"
Ashes2dust11: checks
blindguy1954: checks
*** TURN *** [8d Kh Qd] [2c]
Ashes2dust11: checks
blindguy1954: checks
*** RIVER *** [8d Kh Qd 2c] [Th]
Ashes2dust11: checks
blindguy1954: checks
*** SHOW DOWN ***
Ashes2dust11: shows [6d 9c] (high card King)
blindguy1954: shows [4s As] (high card Ace)
blindguy1954 collected $0.05 from pot
*** SUMMARY ***
Total pot $0.05 | Rake $0
Board [8d Kh Qd 2c Th]
Seat 1: lgny (button) folded before Flop (didn't bet)
Seat 2: tapouttazz9 (small blind) folded before Flop
Seat 3: Ashes2dust11 (big blind) showed [6d 9c] and lost with high card King
Seat 5: Jonesey45420 folded before Flop (didn't bet)
Seat 6: blindguy1954 showed [4s As] and won ($0.05) with high card Ace


PokerStars Hand #152406656609:  Hold'em No Limit ($0.01/$0.02 USD) - 2016/05/04 17:33:59 ET
Table 'Draco' 6-max Seat #2 is the button
Seat 1: lgny ($5.78 in chips)
Seat 2: tapouttazz9 ($2.16 in chips)
Seat 3: Ashes2dust11 ($0.90 in chips)
Seat 6: blindguy1954 ($5.23 in chips)
Ashes2dust11: posts small blind $0.01
blindguy1954: posts big blind $0.02
*** HOLE CARDS ***
Dealt to tapouttazz9 [4h Tc]
lgny: calls $0.02
tapouttazz9: folds
Ashes2dust11: calls $0.01
blindguy1954: checks
*** FLOP *** [Jh 6s Ks]
Ashes2dust11: checks
blindguy1954: checks
lgny: checks
*** TURN *** [Jh 6s Ks] [7s]
Ashes2dust11: checks
blindguy1954: checks
lgny: bets $0.06
Ashes2dust11: folds
blindguy1954: calls $0.06
*** RIVER *** [Jh 6s Ks 7s] [6d]
blindguy1954: checks
lgny: checks
*** SHOW DOWN ***
blindguy1954: shows [7c 8h] (two pair, Sevens and Sixes)
lgny: mucks hand
blindguy1954 collected $0.17 from pot
*** SUMMARY ***
Total pot $0.18 | Rake $0.01
Board [Jh 6s Ks 7s 6d]
Seat 1: lgny mucked [2d As]
Seat 2: tapouttazz9 (button) folded before Flop (didn't bet)
Seat 3: Ashes2dust11 (small blind) folded on the Turn
Seat 6: blindguy1954 (big blind) showed [7c 8h] and won ($0.17) with two pair, Sevens and Sixes


PokerStars Hand #152406656761:  Hold'em No Limit ($0.01/$0.02 USD) - 2016/05/04 17:34:38 ET
Table 'Draco' 6-max Seat #3 is the button
Seat 1: lgny ($5.70 in chips)
Seat 2: tapouttazz9 ($2.16 in chips)
Seat 3: Ashes2dust11 ($0.88 in chips)
Seat 6: blindguy1954 ($5.32 in chips)
blindguy1954: posts small blind $0.01
lgny: posts big blind $0.02
*** HOLE CARDS ***
Dealt to tapouttazz9 [4s Qs]
tapouttazz9: folds
Ashes2dust11: calls $0.02
blindguy1954: folds
lgny: checks
*** FLOP *** [8s 4h Td]
lgny: checks
Ashes2dust11: checks
*** TURN *** [8s 4h Td] [Js]
lgny: bets $0.02
Ashes2dust11: calls $0.02
*** RIVER *** [8s 4h Td Js] [Tc]
lgny: bets $0.02
Ashes2dust11: calls $0.02
*** SHOW DOWN ***
lgny: shows [Jc 3d] (two pair, Jacks and Tens)
Ashes2dust11: shows [Jd Kh] (two pair, Jacks and Tens - King kicker)
Ashes2dust11 collected $0.12 from pot
*** SUMMARY ***
Total pot $0.13 | Rake $0.01
Board [8s 4h Td Js Tc]
Seat 1: lgny (big blind) showed [Jc 3d] and lost with two pair, Jacks and Tens
Seat 2: tapouttazz9 folded before Flop (didn't bet)
Seat 3: Ashes2dust11 (button) showed [Jd Kh] and won ($0.12) with two pair, Jacks and Tens
Seat 6: blindguy1954 (small blind) folded before Flop


PokerStars Hand #152406656835:  Hold'em No Limit ($0.01/$0.02 USD) - 2016/05/04 17:35:04 ET
Table 'Draco' 6-max Seat #6 is the button
Seat 1: lgny ($5.64 in chips)
Seat 2: tapouttazz9 ($2.16 in chips)
Seat 3: Ashes2dust11 ($0.94 in chips)
Seat 6: blindguy1954 ($5.31 in chips)
lgny: posts small blind $0.01
tapouttazz9: posts big blind $0.02
*** HOLE CARDS ***
Dealt to tapouttazz9 [Jc Kh]
Ashes2dust11: calls $0.02
blindguy1954: calls $0.02
lgny: calls $0.01
tapouttazz9: checks
*** FLOP *** [Qs 9c 9d]
lgny: checks
tapouttazz9: checks
Ashes2dust11: bets $0.04
blindguy1954: folds
lgny: folds
tapouttazz9: calls $0.04
*** TURN *** [Qs 9c 9d] [8c]
tapouttazz9: checks
Ashes2dust11: bets $0.06
tapouttazz9: calls $0.06
*** RIVER *** [Qs 9c 9d 8c] [4c]
tapouttazz9: checks
Ashes2dust11: checks
*** SHOW DOWN ***
tapouttazz9: shows [Jc Kh] (a pair of Nines)
Ashes2dust11: shows [8d Qh] (two pair, Queens and Nines)
Ashes2dust11 collected $0.27 from pot
*** SUMMARY ***
Total pot $0.28 | Rake $0.01
Board [Qs 9c 9d 8c 4c]
Seat 1: lgny (small blind) folded on the Flop
Seat 2: tapouttazz9 (big blind) showed [Jc Kh] and lost with a pair of Nines
Seat 3: Ashes2dust11 showed [8d Qh] and won ($0.27) with two pair, Queens and Nines
Seat 6: blindguy1954 (button) folded on the Flop


PokerStars Hand #152406656959:  Hold'em No Limit ($0.01/$0.02 USD) - 2016/05/04 17:35:40 ET
Table 'Draco' 6-max Seat #1 is the button
Seat 1: lgny ($5.62 in chips)
Seat 2: tapouttazz9 ($2.04 in chips)
Seat 3: Ashes2dust11 ($1.09 in chips)
Seat 6: blindguy1954 ($5.29 in chips)
tapouttazz9: posts small blind $0.01
Ashes2dust11: posts big blind $0.02
*** HOLE CARDS ***
Dealt to tapouttazz9 [2c Ac]
blindguy1954: calls $0.02
lgny: folds
tapouttazz9: raises $0.02 to $0.04
Ashes2dust11: calls $0.02
blindguy1954: calls $0.02
*** FLOP *** [Jd Th Qh]
tapouttazz9: checks
Ashes2dust11: checks
blindguy1954: checks
*** TURN *** [Jd Th Qh] [3c]
tapouttazz9: checks
Ashes2dust11: checks
blindguy1954: checks
*** RIVER *** [Jd Th Qh 3c] [3h]
tapouttazz9: checks
Ashes2dust11: checks
blindguy1954: bets $0.04
tapouttazz9: folds
Ashes2dust11: calls $0.04
*** SHOW DOWN ***
blindguy1954: shows [Ks 6c] (a pair of Threes)
Ashes2dust11: shows [Tc 9s] (two pair, Tens and Threes)
Ashes2dust11 collected $0.19 from pot
*** SUMMARY ***
Total pot $0.20 | Rake $0.01
Board [Jd Th Qh 3c 3h]
Seat 1: lgny (button) folded before Flop (didn't bet)
Seat 2: tapouttazz9 (small blind) folded on the River
Seat 3: Ashes2dust11 (big blind) showed [Tc 9s] and won ($0.19) with two pair, Tens and Threes
Seat 6: blindguy1954 showed [Ks 6c] and lost with a pair of Threes


PokerStars Hand #152406657141:  Hold'em No Limit ($0.01/$0.02 USD) - 2016/05/04 17:36:35 ET
Table 'Draco' 6-max Seat #2 is the button
Seat 1: lgny ($5.62 in chips)
Seat 2: tapouttazz9 ($2 in chips)
Seat 3: Ashes2dust11 ($2 in chips)
Seat 6: blindguy1954 ($5.21 in chips)
Ashes2dust11: posts small blind $0.01
LumberJackk7 was removed from the table for failing to post
blindguy1954: posts big blind $0.02
*** HOLE CARDS ***
Dealt to tapouttazz9 [8c Ts]
lgny: raises $0.05 to $0.07
tapouttazz9: folds
The L joins the table at seat #4
Ashes2dust11: calls $0.06
blindguy1954: calls $0.05
*** FLOP *** [7s Jh 7h]
Ashes2dust11: bets $0.04
blindguy1954: calls $0.04
lgny: calls $0.04
*** TURN *** [7s Jh 7h] [7d]
Ashes2dust11: checks
blindguy1954: checks
lgny: checks
*** RIVER *** [7s Jh 7h 7d] [Ad]
Ashes2dust11: bets $0.04
blindguy1954: folds
lgny: raises $0.04 to $0.08
Jonesey45420 is disconnected
Ashes2dust11: calls $0.04
*** SHOW DOWN ***
lgny: shows [Ah 2c] (a full house, Sevens full of Aces)
Ashes2dust11: mucks hand
lgny collected $0.47 from pot
*** SUMMARY ***
Total pot $0.49 | Rake $0.02
Board [7s Jh 7h 7d Ad]
Seat 1: lgny showed [Ah 2c] and won ($0.47) with a full house, Sevens full of Aces
Seat 2: tapouttazz9 (button) folded before Flop (didn't bet)
Seat 3: Ashes2dust11 (small blind) mucked [Js Td]
Seat 6: blindguy1954 (big blind) folded on the River


PokerStars Hand #152406657359:  Hold'em No Limit ($0.01/$0.02 USD) - 2016/05/04 17:37:34 ET
Table 'Draco' 6-max Seat #3 is the button
Seat 1: lgny ($5.90 in chips)
Seat 2: tapouttazz9 ($2 in chips)
Seat 3: Ashes2dust11 ($1.81 in chips)
Seat 6: blindguy1954 ($5.10 in chips)
The L will be allowed to play after the button
blindguy1954: posts small blind $0.01
lgny: posts big blind $0.02
*** HOLE CARDS ***
Dealt to tapouttazz9 [Tc Jc]
tapouttazz9: raises $0.02 to $0.04
Ashes2dust11: folds
blindguy1954: calls $0.03
lgny: folds
*** FLOP *** [2h Kd 3s]
blindguy1954: checks
tapouttazz9: bets $0.07
blindguy1954: folds
Uncalled bet ($0.07) returned to tapouttazz9
tapouttazz9 collected $0.10 from pot
tapouttazz9: doesn't show hand
*** SUMMARY ***
Total pot $0.10 | Rake $0
Board [2h Kd 3s]
Seat 1: lgny (big blind) folded before Flop
Seat 2: tapouttazz9 collected ($0.10)
Seat 3: Ashes2dust11 (button) folded before Flop (didn't bet)
Seat 6: blindguy1954 (small blind) folded on the Flop


PokerStars Hand #152406657444:  Hold'em No Limit ($0.01/$0.02 USD) - 2016/05/04 17:37:57 ET
Table 'Draco' 6-max Seat #6 is the button
Seat 1: lgny ($5.88 in chips)
Seat 2: tapouttazz9 ($2.06 in chips)
Seat 3: Ashes2dust11 ($1.81 in chips)
Seat 6: blindguy1954 ($5.06 in chips)
lgny: posts small blind $0.01
tapouttazz9: posts big blind $0.02
The L: sits out
*** HOLE CARDS ***
Dealt to tapouttazz9 [7h 3s]
Ashes2dust11: folds
blindguy1954: calls $0.02
lgny: calls $0.01
tapouttazz9: checks
*** FLOP *** [2d Jd Ac]
lgny: checks
tapouttazz9: checks
blindguy1954: checks
*** TURN *** [2d Jd Ac] [As]
lgny: checks
tapouttazz9: checks
blindguy1954: checks
*** RIVER *** [2d Jd Ac As] [Ah]
lgny: checks
tapouttazz9: checks
blindguy1954: checks
*** SHOW DOWN ***
lgny: shows [Th 8d] (three of a kind, Aces)
tapouttazz9: mucks hand
blindguy1954: shows [6s Kh] (three of a kind, Aces - King kicker)
blindguy1954 collected $0.06 from pot
*** SUMMARY ***
Total pot $0.06 | Rake $0
Board [2d Jd Ac As Ah]
Seat 1: lgny (small blind) showed [Th 8d] and lost with three of a kind, Aces
Seat 2: tapouttazz9 (big blind) mucked [7h 3s]
Seat 3: Ashes2dust11 folded before Flop (didn't bet)
Seat 6: blindguy1954 (button) showed [6s Kh] and won ($0.06) with three of a kind, Aces


PokerStars Hand #152406657582:  Hold'em No Limit ($0.01/$0.02 USD) - 2016/05/04 17:38:31 ET
Table 'Draco' 6-max Seat #1 is the button
Seat 1: lgny ($5.86 in chips)
Seat 2: tapouttazz9 ($2.04 in chips)
Seat 3: Ashes2dust11 ($1.81 in chips)
Seat 6: blindguy1954 ($5.10 in chips)
tapouttazz9: posts small blind $0.01
Ashes2dust11: posts big blind $0.02
The L: sits out
*** HOLE CARDS ***
Dealt to tapouttazz9 [3c 2s]
blindguy1954: calls $0.02
lgny: calls $0.02
tapouttazz9: folds
Ashes2dust11: checks
*** FLOP *** [Ts 3d 4s]
Ashes2dust11: checks
blindguy1954: checks
lgny: bets $0.07
blindguy1954 said, "oh yea!"
Ashes2dust11: folds
blindguy1954: calls $0.07
*** TURN *** [Ts 3d 4s] [2h]
blindguy1954: checks
lgny: bets $0.20
blindguy1954: calls $0.20
*** RIVER *** [Ts 3d 4s 2h] [Jd]
blindguy1954: checks
lgny: checks
*** SHOW DOWN ***
blindguy1954: shows [8s 8c] (a pair of Eights)
lgny: shows [9s Td] (a pair of Tens)
lgny collected $0.58 from pot
*** SUMMARY ***
Total pot $0.61 | Rake $0.03
Board [Ts 3d 4s 2h Jd]
Seat 1: lgny (button) showed [9s Td] and won ($0.58) with a pair of Tens
Seat 2: tapouttazz9 (small blind) folded before Flop
Seat 3: Ashes2dust11 (big blind) folded on the Flop
Seat 6: blindguy1954 showed [8s 8c] and lost with a pair of Eights


PokerStars Hand #152406657792:  Hold'em No Limit ($0.01/$0.02 USD) - 2016/05/04 17:39:17 ET
Table 'Draco' 6-max Seat #2 is the button
Seat 1: lgny ($6.15 in chips)
Seat 2: tapouttazz9 ($2.03 in chips)
Seat 3: Ashes2dust11 ($1.79 in chips)
Seat 4: The L ($1.60 in chips)
Seat 6: blindguy1954 ($4.81 in chips)
Ashes2dust11: posts small blind $0.01
The L: posts big blind $0.02
*** HOLE CARDS ***
Dealt to tapouttazz9 [9d 8h]
blindguy1954: raises $0.05 to $0.07
lgny: calls $0.07
tapouttazz9: folds
Ashes2dust11: calls $0.06
The L: folds
*** FLOP *** [2d Kc 4c]
Ashes2dust11: checks
blindguy1954: checks
lgny: checks
*** TURN *** [2d Kc 4c] [Ad]
Ashes2dust11: bets $0.04
blindguy1954: folds
lgny: calls $0.04
*** RIVER *** [2d Kc 4c Ad] [Td]
Ashes2dust11: checks
lgny: checks
*** SHOW DOWN ***
Ashes2dust11: shows [Ac 3c] (a pair of Aces)
lgny: mucks hand
Ashes2dust11 collected $0.30 from pot
*** SUMMARY ***
Total pot $0.31 | Rake $0.01
Board [2d Kc 4c Ad Td]
Seat 1: lgny mucked [Jc 3d]
Seat 2: tapouttazz9 (button) folded before Flop (didn't bet)
Seat 3: Ashes2dust11 (small blind) showed [Ac 3c] and won ($0.30) with a pair of Aces
Seat 4: The L (big blind) folded before Flop
Seat 6: blindguy1954 folded on the Turn


PokerStars Hand #152406657939:  Hold'em No Limit ($0.01/$0.02 USD) - 2016/05/04 17:39:55 ET
Table 'Draco' 6-max Seat #3 is the button
Seat 1: lgny ($6.04 in chips)
Seat 2: tapouttazz9 ($2.03 in chips)
Seat 3: Ashes2dust11 ($1.98 in chips)
Seat 4: The L ($1.58 in chips)
Seat 6: blindguy1954 ($4.74 in chips)
The L: posts small blind $0.01
blindguy1954: posts big blind $0.02
*** HOLE CARDS ***
Dealt to tapouttazz9 [3h Ac]
lgny: calls $0.02
tapouttazz9: folds
Ashes2dust11: calls $0.02
The L: calls $0.01
blindguy1954: raises $0.08 to $0.10
lgny: calls $0.08
Ashes2dust11: calls $0.08
The L: folds
*** FLOP *** [5s Tc 4c]
blindguy1954: bets $0.30
lgny: raises $0.30 to $0.60
Ashes2dust11: folds
blindguy1954: raises $0.74 to $1.34
lgny: raises $2.99 to $4.33
blindguy1954: raises $0.31 to $4.64 and is all-in
lgny: calls $0.31
*** TURN *** [5s Tc 4c] [Jh]
*** RIVER *** [5s Tc 4c Jh] [Kc]
*** SHOW DOWN ***
blindguy1954: shows [2s Ad] (high card Ace)
lgny: shows [5d 5h] (three of a kind, Fives)
lgny collected $9.30 from pot
*** SUMMARY ***
Total pot $9.60 | Rake $0.30
Board [5s Tc 4c Jh Kc]
Seat 1: lgny showed [5d 5h] and won ($9.30) with three of a kind, Fives
Seat 2: tapouttazz9 folded before Flop (didn't bet)
Seat 3: Ashes2dust11 (button) folded on the Flop
Seat 4: The L (small blind) folded before Flop
Seat 6: blindguy1954 (big blind) showed [2s Ad] and lost with high card Ace


PokerStars Hand #152406658122:  Hold'em No Limit ($0.01/$0.02 USD) - 2016/05/04 17:40:43 ET
Table 'Draco' 6-max Seat #4 is the button
Seat 1: lgny ($10.60 in chips)
Seat 2: tapouttazz9 ($2.03 in chips)
Seat 3: Ashes2dust11 ($1.88 in chips)
Seat 4: The L ($1.56 in chips)
lgny: posts small blind $0.01
tapouttazz9: posts big blind $0.02
*** HOLE CARDS ***
Dealt to tapouttazz9 [6s 8s]
blindguy1954 leaves the table
Ashes2dust11: calls $0.02
The L: folds
lgny: raises $0.02 to $0.04
tapouttazz9: folds
Ashes2dust11: calls $0.02
*** FLOP *** [7s Kc Kh]
lgny: checks
Ashes2dust11: checks
*** TURN *** [7s Kc Kh] [Jh]
lgny: bets $0.10
Ashes2dust11: calls $0.10
*** RIVER *** [7s Kc Kh Jh] [5h]
lgny: bets $0.38
Ashes2dust11: folds
Uncalled bet ($0.38) returned to lgny
lgny collected $0.29 from pot
lgny: shows [Ks Jc] (a full house, Kings full of Jacks)
*** SUMMARY ***
Total pot $0.30 | Rake $0.01
Board [7s Kc Kh Jh 5h]
Seat 1: lgny (small blind) collected ($0.29)
Seat 2: tapouttazz9 (big blind) folded before Flop
Seat 3: Ashes2dust11 folded on the River
Seat 4: The L (button) folded before Flop (didn't bet)


PokerStars Hand #152406658316:  Hold'em No Limit ($0.01/$0.02 USD) - 2016/05/04 17:41:38 ET
Table 'Draco' 6-max Seat #1 is the button
Seat 1: lgny ($10.75 in chips)
Seat 2: tapouttazz9 ($2.01 in chips)
Seat 3: Ashes2dust11 ($1.74 in chips)
Seat 4: The L ($1.56 in chips)
tapouttazz9: posts small blind $0.01
Ashes2dust11: posts big blind $0.02
*** HOLE CARDS ***
Dealt to tapouttazz9 [5s 8s]
The L: calls $0.02
lgny: raises $0.07 to $0.09
tapouttazz9: folds
Ashes2dust11: calls $0.07
The L: calls $0.07
*** FLOP *** [Ad 4c 5c]
Ashes2dust11: checks
The L: checks
lgny: bets $0.06
Ashes2dust11: folds
The L: folds
Uncalled bet ($0.06) returned to lgny
lgny collected $0.27 from pot
lgny: shows [Ac Qc] (a pair of Aces)
*** SUMMARY ***
Total pot $0.28 | Rake $0.01
Board [Ad 4c 5c]
Seat 1: lgny (button) collected ($0.27)
Seat 2: tapouttazz9 (small blind) folded before Flop
Seat 3: Ashes2dust11 (big blind) folded on the Flop
Seat 4: The L folded on the Flop


PokerStars Hand #152406658423:  Hold'em No Limit ($0.01/$0.02 USD) - 2016/05/04 17:42:08 ET
Table 'Draco' 6-max Seat #2 is the button
Seat 1: lgny ($10.93 in chips)
Seat 2: tapouttazz9 ($2 in chips)
Seat 3: Ashes2dust11 ($1.65 in chips)
Seat 4: The L ($1.47 in chips)
Ashes2dust11: posts small blind $0.01
The L: posts big blind $0.02
*** HOLE CARDS ***
Dealt to tapouttazz9 [3s 2s]
lgny: raises $0.04 to $0.06
tapouttazz9: folds
Ashes2dust11: folds
The L: folds
Uncalled bet ($0.04) returned to lgny
lgny collected $0.05 from pot
*** SUMMARY ***
Total pot $0.05 | Rake $0
Seat 1: lgny collected ($0.05)
Seat 2: tapouttazz9 (button) folded before Flop (didn't bet)
Seat 3: Ashes2dust11 (small blind) folded before Flop
Seat 4: The L (big blind) folded before Flop


PokerStars Hand #152406658467:  Hold'em No Limit ($0.01/$0.02 USD) - 2016/05/04 17:42:18 ET
Table 'Draco' 6-max Seat #3 is the button
Seat 1: lgny ($10.96 in chips)
Seat 2: tapouttazz9 ($2 in chips)
Seat 3: Ashes2dust11 ($1.64 in chips)
Seat 4: The L ($1.45 in chips)
The L: posts small blind $0.01
lgny: posts big blind $0.02
*** HOLE CARDS ***
Dealt to tapouttazz9 [6c 7h]
tapouttazz9: folds
Ashes2dust11: calls $0.02
The L: calls $0.01
lgny: checks
*** FLOP *** [5s 7s Qs]
The L: checks
lgny: checks
Ashes2dust11: checks
*** TURN *** [5s 7s Qs] [8h]
The L: checks
lgny: checks
Ashes2dust11: checks
*** RIVER *** [5s 7s Qs 8h] [2h]
The L: checks
lgny: bets $0.06
Ashes2dust11: calls $0.06
The L: folds
*** SHOW DOWN ***
lgny: shows [2s 2d] (three of a kind, Deuces)
Ashes2dust11: mucks hand
lgny collected $0.17 from pot
*** SUMMARY ***
Total pot $0.18 | Rake $0.01
Board [5s 7s Qs 8h 2h]
Seat 1: lgny (big blind) showed [2s 2d] and won ($0.17) with three of a kind, Deuces
Seat 2: tapouttazz9 folded before Flop (didn't bet)
Seat 3: Ashes2dust11 (button) mucked [3d 8d]
Seat 4: The L (small blind) folded on the River


PokerStars Hand #152406658607:  Hold'em No Limit ($0.01/$0.02 USD) - 2016/05/04 17:42:52 ET
Table 'Draco' 6-max Seat #4 is the button
Seat 1: lgny ($11.05 in chips)
Seat 2: tapouttazz9 ($2 in chips)
Seat 3: Ashes2dust11 ($1.56 in chips)
Seat 4: The L ($1.43 in chips)
lgny: posts small blind $0.01
tapouttazz9: posts big blind $0.02
*** HOLE CARDS ***
Dealt to tapouttazz9 [8d 8h]
Ashes2dust11: calls $0.02
The L: calls $0.02
lgny: calls $0.01
tapouttazz9: checks
*** FLOP *** [3c 7d Js]
lgny: bets $0.02
tapouttazz9: calls $0.02
Ashes2dust11: folds
The L: raises $0.08 to $0.10
lgny: calls $0.08
tapouttazz9: folds
*** TURN *** [3c 7d Js] [3h]
lgny: checks
The L: checks
*** RIVER *** [3c 7d Js 3h] [Kd]
lgny: checks
The L: checks
*** SHOW DOWN ***
lgny: shows [Ts 7h] (two pair, Sevens and Threes)
The L: shows [Jh Tc] (two pair, Jacks and Threes)
The L collected $0.29 from pot
*** SUMMARY ***
Total pot $0.30 | Rake $0.01
Board [3c 7d Js 3h Kd]
Seat 1: lgny (small blind) showed [Ts 7h] and lost with two pair, Sevens and Threes
Seat 2: tapouttazz9 (big blind) folded on the Flop
Seat 3: Ashes2dust11 folded on the Flop
Seat 4: The L (button) showed [Jh Tc] and won ($0.29) with two pair, Jacks and Threes


PokerStars Hand #152406658742:  Hold'em No Limit ($0.01/$0.02 USD) - 2016/05/04 17:43:27 ET
Table 'Draco' 6-max Seat #1 is the button
Seat 1: lgny ($10.93 in chips)
Seat 2: tapouttazz9 ($1.96 in chips)
Seat 3: Ashes2dust11 ($1.54 in chips)
Seat 4: The L ($1.60 in chips)
tapouttazz9: posts small blind $0.01
Ashes2dust11: posts big blind $0.02
*** HOLE CARDS ***
Dealt to tapouttazz9 [5h 9s]
The L: folds
lgny: folds
tapouttazz9: folds
Uncalled bet ($0.01) returned to Ashes2dust11
Ashes2dust11 collected $0.02 from pot
Ashes2dust11: doesn't show hand
*** SUMMARY ***
Total pot $0.02 | Rake $0
Seat 1: lgny (button) folded before Flop (didn't bet)
Seat 2: tapouttazz9 (small blind) folded before Flop
Seat 3: Ashes2dust11 (big blind) collected ($0.02)
Seat 4: The L folded before Flop (didn't bet)


PokerStars Hand #152406658774:  Hold'em No Limit ($0.01/$0.02 USD) - 2016/05/04 17:43:36 ET
Table 'Draco' 6-max Seat #2 is the button
Seat 1: lgny ($10.93 in chips)
Seat 2: tapouttazz9 ($1.95 in chips)
Seat 3: Ashes2dust11 ($1.55 in chips)
Seat 4: The L ($1.60 in chips)
Ashes2dust11: posts small blind $0.01
The L: posts big blind $0.02
*** HOLE CARDS ***
Dealt to tapouttazz9 [6s 8d]
lgny: folds
tapouttazz9: folds
Ashes2dust11: folds
Uncalled bet ($0.01) returned to The L
The L collected $0.02 from pot
The L: doesn't show hand
*** SUMMARY ***
Total pot $0.02 | Rake $0
Seat 1: lgny folded before Flop (didn't bet)
Seat 2: tapouttazz9 (button) folded before Flop (didn't bet)
Seat 3: Ashes2dust11 (small blind) folded before Flop
Seat 4: The L (big blind) collected ($0.02)


PokerStars Hand #152406658804:  Hold'em No Limit ($0.01/$0.02 USD) - 2016/05/04 17:43:42 ET
Table 'Draco' 6-max Seat #3 is the button
Seat 1: lgny ($10.93 in chips)
Seat 2: tapouttazz9 ($1.95 in chips)
Seat 3: Ashes2dust11 ($1.54 in chips)
Seat 4: The L ($1.61 in chips)
The L: posts small blind $0.01
lgny: posts big blind $0.02
*** HOLE CARDS ***
Dealt to tapouttazz9 [9h Jh]
tapouttazz9: raises $0.02 to $0.04
Ashes2dust11: folds
The L: folds
lgny: calls $0.02
*** FLOP *** [5s 2c 3d]
lgny: bets $0.02
tapouttazz9: calls $0.02
*** TURN *** [5s 2c 3d] [Qc]
lgny: checks
tapouttazz9: bets $0.06
lgny: calls $0.06
*** RIVER *** [5s 2c 3d Qc] [Kd]
lgny: checks
tapouttazz9: checks
*** SHOW DOWN ***
lgny: shows [5d 8d] (a pair of Fives)
tapouttazz9: mucks hand
lgny collected $0.24 from pot
*** SUMMARY ***
Total pot $0.25 | Rake $0.01
Board [5s 2c 3d Qc Kd]
Seat 1: lgny (big blind) showed [5d 8d] and won ($0.24) with a pair of Fives
Seat 2: tapouttazz9 mucked [9h Jh]
Seat 3: Ashes2dust11 (button) folded before Flop (didn't bet)
Seat 4: The L (small blind) folded before Flop


PokerStars Hand #152406658890:  Hold'em No Limit ($0.01/$0.02 USD) - 2016/05/04 17:44:08 ET
Table 'Draco' 6-max Seat #4 is the button
Seat 1: lgny ($11.05 in chips)
Seat 2: tapouttazz9 ($1.83 in chips)
Seat 3: Ashes2dust11 ($1.54 in chips)
Seat 4: The L ($1.60 in chips)
lgny: posts small blind $0.01
tapouttazz9: posts big blind $0.02
*** HOLE CARDS ***
Dealt to tapouttazz9 [8s Ad]
Ashes2dust11: folds
The L: calls $0.02
lgny: calls $0.01
tapouttazz9: checks
*** FLOP *** [5s Jc 4s]
lgny: checks
tapouttazz9: checks
The L: checks
*** TURN *** [5s Jc 4s] [9d]
lgny: checks
tapouttazz9: checks
The L: bets $0.06
lgny: calls $0.06
tapouttazz9: folds
*** RIVER *** [5s Jc 4s 9d] [Qh]
lgny: checks
The L: bets $0.10
lgny: folds
Uncalled bet ($0.10) returned to The L
The L collected $0.17 from pot
The L: doesn't show hand
*** SUMMARY ***
Total pot $0.18 | Rake $0.01
Board [5s Jc 4s 9d Qh]
Seat 1: lgny (small blind) folded on the River
Seat 2: tapouttazz9 (big blind) folded on the Turn
Seat 3: Ashes2dust11 folded before Flop (didn't bet)
Seat 4: The L (button) collected ($0.17)


PokerStars Hand #152406659055:  Hold'em No Limit ($0.01/$0.02 USD) - 2016/05/04 17:44:51 ET
Table 'Draco' 6-max Seat #1 is the button
Seat 1: lgny ($10.97 in chips)
Seat 2: tapouttazz9 ($1.81 in chips)
Seat 3: Ashes2dust11 ($1.54 in chips)
Seat 4: The L ($1.69 in chips)
tapouttazz9: posts small blind $0.01
Ashes2dust11: posts big blind $0.02
*** HOLE CARDS ***
Dealt to tapouttazz9 [5c 7d]
The L: folds
lgny: raises $0.04 to $0.06
tapouttazz9: folds
Ashes2dust11: calls $0.04
*** FLOP *** [2h 5h 4c]
wallstwst joins the table at seat #6
Ashes2dust11: checks
lgny: bets $0.06
Ashes2dust11: folds
Uncalled bet ($0.06) returned to lgny
lgny collected $0.12 from pot
lgny: doesn't show hand
*** SUMMARY ***
Total pot $0.13 | Rake $0.01
Board [2h 5h 4c]
Seat 1: lgny (button) collected ($0.12)
Seat 2: tapouttazz9 (small blind) folded before Flop
Seat 3: Ashes2dust11 (big blind) folded on the Flop
Seat 4: The L folded before Flop (didn't bet)


PokerStars Hand #152406659130:  Hold'em No Limit ($0.01/$0.02 USD) - 2016/05/04 17:45:13 ET
Table 'Draco' 6-max Seat #2 is the button
Seat 1: lgny ($11.03 in chips)
Seat 2: tapouttazz9 ($1.80 in chips)
Seat 3: Ashes2dust11 ($1.48 in chips)
Seat 4: The L ($1.69 in chips)
Ashes2dust11: posts small blind $0.01
The L: posts big blind $0.02
wallstwst: sits out
*** HOLE CARDS ***
Dealt to tapouttazz9 [4h Td]
lgny: calls $0.02
tapouttazz9: folds
Ashes2dust11: calls $0.01
The L: checks
*** FLOP *** [Qc 9c 5s]
Ashes2dust11: checks
The L: checks
lgny: checks
*** TURN *** [Qc 9c 5s] [2c]
Ashes2dust11: bets $0.04
The L: folds
lgny: calls $0.04
*** RIVER *** [Qc 9c 5s 2c] [Qd]
Ashes2dust11: bets $0.20
lgny: calls $0.20
*** SHOW DOWN ***
Ashes2dust11: shows [Qs 6c] (three of a kind, Queens)
lgny: shows [Ah 5c] (two pair, Queens and Fives)
Ashes2dust11 collected $0.52 from pot
*** SUMMARY ***
Total pot $0.54 | Rake $0.02
Board [Qc 9c 5s 2c Qd]
Seat 1: lgny showed [Ah 5c] and lost with two pair, Queens and Fives
Seat 2: tapouttazz9 (button) folded before Flop (didn't bet)
Seat 3: Ashes2dust11 (small blind) showed [Qs 6c] and won ($0.52) with three of a kind, Queens
Seat 4: The L (big blind) folded on the Turn


PokerStars Hand #152406659261:  Hold'em No Limit ($0.01/$0.02 USD) - 2016/05/04 17:45:50 ET
Table 'Draco' 6-max Seat #3 is the button
Seat 1: lgny ($10.77 in chips)
Seat 2: tapouttazz9 ($1.80 in chips)
Seat 3: Ashes2dust11 ($1.74 in chips)
Seat 4: The L ($1.67 in chips)
Seat 6: wallstwst ($1 in chips)
The L: posts small blind $0.01
Jonesey45420 was removed from the table for failing to post
wallstwst: posts big blind $0.02
*** HOLE CARDS ***
Dealt to tapouttazz9 [Jc 2d]
lgny: raises $0.04 to $0.06
tapouttazz9: folds
Ashes2dust11: calls $0.06
The L: folds
wallstwst: calls $0.04
*** FLOP *** [7h 5d 4s]
wallstwst: bets $0.07
lgny: calls $0.07
Ashes2dust11: calls $0.07
*** TURN *** [7h 5d 4s] [9s]
wallstwst: checks
lgny: checks
Ashes2dust11: checks
*** RIVER *** [7h 5d 4s 9s] [2c]
wallstwst: checks
lgny: checks
Ashes2dust11: bets $0.38
wallstwst: folds
lgny: folds
Uncalled bet ($0.38) returned to Ashes2dust11
Ashes2dust11 collected $0.38 from pot
Ashes2dust11: doesn't show hand
*** SUMMARY ***
Total pot $0.40 | Rake $0.02
Board [7h 5d 4s 9s 2c]
Seat 1: lgny folded on the River
Seat 2: tapouttazz9 folded before Flop (didn't bet)
Seat 3: Ashes2dust11 (button) collected ($0.38)
Seat 4: The L (small blind) folded before Flop
Seat 6: wallstwst (big blind) folded on the River


PokerStars Hand #152940088121:  Hold'em No Limit ($0.01/$0.02 USD) - 2016/05/16 16:41:19 ET
Table 'Draco' 6-max Seat #4 is the button
Seat 1: unicorn_0812 ($1.78 in chips)
Seat 4: Superman4164 ($3.81 in chips)
Seat 5: 96jomama ($0.72 in chips)
Seat 6: JerseyGuy316 ($1.89 in chips)
96jomama: posts small blind $0.01
JerseyGuy316: posts big blind $0.02
superiorsl: sits out
*** HOLE CARDS ***
unicorn_0812: calls $0.02
Superman4164: calls $0.02
96jomama: calls $0.01
JerseyGuy316: checks
*** FLOP *** [5h 4c Qs]
96jomama: checks
JerseyGuy316: checks
unicorn_0812: checks
Superman4164: checks
*** TURN *** [5h 4c Qs] [5d]
96jomama: checks
JerseyGuy316: checks
unicorn_0812: checks
Superman4164: checks
*** RIVER *** [5h 4c Qs 5d] [Tc]
96jomama: checks
JerseyGuy316: checks
unicorn_0812: bets $0.02
tapouttazz9 joins the table at seat #3
Superman4164: calls $0.02
96jomama: folds
JerseyGuy316: folds
*** SHOW DOWN ***
unicorn_0812: shows [Td As] (two pair, Tens and Fives)
Superman4164: mucks hand
unicorn_0812 collected $0.11 from pot
*** SUMMARY ***
Total pot $0.12 | Rake $0.01
Board [5h 4c Qs 5d Tc]
Seat 1: unicorn_0812 showed [Td As] and won ($0.11) with two pair, Tens and Fives
Seat 4: Superman4164 (button) mucked
Seat 5: 96jomama (small blind) folded on the River
Seat 6: JerseyGuy316 (big blind) folded on the River


PokerStars Hand #152940088316:  Hold'em No Limit ($0.01/$0.02 USD) - 2016/05/16 16:42:15 ET
Table 'Draco' 6-max Seat #5 is the button
Seat 1: unicorn_0812 ($1.85 in chips)
Seat 4: Superman4164 ($3.77 in chips)
Seat 5: 96jomama ($0.70 in chips)
Seat 6: JerseyGuy316 ($1.87 in chips)
JerseyGuy316: posts small blind $0.01
unicorn_0812: posts big blind $0.02
superiorsl: sits out
tapouttazz9: sits out
*** HOLE CARDS ***
Superman4164: calls $0.02
96jomama: calls $0.02
JerseyGuy316: raises $0.04 to $0.06
unicorn_0812: folds
Superman4164: calls $0.04
96jomama: calls $0.04
*** FLOP *** [8d Kh 5d]
JerseyGuy316: checks
Superman4164: checks
96jomama: checks
*** TURN *** [8d Kh 5d] [7s]
JerseyGuy316: checks
Superman4164: checks
96jomama: checks
*** RIVER *** [8d Kh 5d 7s] [Tc]
JerseyGuy316: checks
Superman4164: checks
96jomama: checks
*** SHOW DOWN ***
JerseyGuy316: shows [Qs Ah] (high card Ace)
Superman4164: mucks hand
96jomama: shows [Ac Ts] (a pair of Tens)
96jomama collected $0.19 from pot
*** SUMMARY ***
Total pot $0.20 | Rake $0.01
Board [8d Kh 5d 7s Tc]
Seat 1: unicorn_0812 (big blind) folded before Flop
Seat 4: Superman4164 mucked
Seat 5: 96jomama (button) showed [Ac Ts] and won ($0.19) with a pair of Tens
Seat 6: JerseyGuy316 (small blind) showed [Qs Ah] and lost with high card Ace


PokerStars Hand #152940088494:  Hold'em No Limit ($0.01/$0.02 USD) - 2016/05/16 16:43:06 ET
Table 'Draco' 6-max Seat #6 is the button
Seat 1: unicorn_0812 ($1.83 in chips)
Seat 2: superiorsl ($2 in chips)
Seat 4: Superman4164 ($3.71 in chips)
Seat 5: 96jomama ($0.83 in chips)
Seat 6: JerseyGuy316 ($1.81 in chips)
unicorn_0812: posts small blind $0.01
superiorsl: posts big blind $0.02
tapouttazz9: sits out
*** HOLE CARDS ***
Superman4164: calls $0.02
96jomama: folds
JerseyGuy316: folds
unicorn_0812: calls $0.01
superiorsl: checks
*** FLOP *** [3s Tc Js]
unicorn_0812: checks
superiorsl: bets $0.03
Superman4164: calls $0.03
unicorn_0812: folds
*** TURN *** [3s Tc Js] [5c]
superiorsl: bets $0.06
Superman4164: folds
Uncalled bet ($0.06) returned to superiorsl
superiorsl collected $0.11 from pot
superiorsl: doesn't show hand
*** SUMMARY ***
Total pot $0.12 | Rake $0.01
Board [3s Tc Js 5c]
Seat 1: unicorn_0812 (small blind) folded on the Flop
Seat 2: superiorsl (big blind) collected ($0.11)
Seat 4: Superman4164 folded on the Turn
Seat 5: 96jomama folded before Flop (didn't bet)
Seat 6: JerseyGuy316 (button) folded before Flop (didn't bet)


PokerStars Hand #152940088695:  Hold'em No Limit ($0.01/$0.02 USD) - 2016/05/16 16:44:07 ET
Table 'Draco' 6-max Seat #1 is the button
Seat 1: unicorn_0812 ($1.81 in chips)
Seat 2: superiorsl ($2.06 in chips)
Seat 3: tapouttazz9 ($2 in chips)
Seat 4: Superman4164 ($3.66 in chips)
Seat 5: 96jomama ($0.83 in chips)
Seat 6: JerseyGuy316 ($1.81 in chips)
superiorsl: posts small blind $0.01
tapouttazz9: posts big blind $0.02
*** HOLE CARDS ***
Dealt to tapouttazz9 [Kd 2d]
Superman4164: calls $0.02
96jomama: folds
JerseyGuy316: raises $0.04 to $0.06
unicorn_0812: calls $0.06
superiorsl: calls $0.05
tapouttazz9: folds
Superman4164: calls $0.04
*** FLOP *** [Ad 2s 7c]
superiorsl: checks
Superman4164: checks
JerseyGuy316: checks
unicorn_0812: checks
*** TURN *** [Ad 2s 7c] [9c]
superiorsl: checks
Superman4164: checks
JerseyGuy316: bets $0.12
unicorn_0812: folds
superiorsl: folds
Superman4164: folds
Uncalled bet ($0.12) returned to JerseyGuy316
JerseyGuy316 collected $0.25 from pot
JerseyGuy316: doesn't show hand
*** SUMMARY ***
Total pot $0.26 | Rake $0.01
Board [Ad 2s 7c 9c]
Seat 1: unicorn_0812 (button) folded on the Turn
Seat 2: superiorsl (small blind) folded on the Turn
Seat 3: tapouttazz9 (big blind) folded before Flop
Seat 4: Superman4164 folded on the Turn
Seat 5: 96jomama folded before Flop (didn't bet)
Seat 6: JerseyGuy316 collected ($0.25)


PokerStars Hand #152940088874:  Hold'em No Limit ($0.01/$0.02 USD) - 2016/05/16 16:45:04 ET
Table 'Draco' 6-max Seat #2 is the button
Seat 1: unicorn_0812 ($1.75 in chips)
Seat 2: superiorsl ($2 in chips)
Seat 3: tapouttazz9 ($1.98 in chips)
Seat 4: Superman4164 ($3.60 in chips)
Seat 5: 96jomama ($0.83 in chips)
Seat 6: JerseyGuy316 ($2 in chips)
tapouttazz9: posts small blind $0.01
Superman4164: posts big blind $0.02
*** HOLE CARDS ***
Dealt to tapouttazz9 [Td 6s]
96jomama: folds
JerseyGuy316: raises $0.04 to $0.06
unicorn_0812: folds
superiorsl: folds
tapouttazz9: folds
Superman4164: calls $0.04
*** FLOP *** [2s Ts 5d]
Superman4164: checks
JerseyGuy316: bets $0.12
Superman4164: folds
Uncalled bet ($0.12) returned to JerseyGuy316
JerseyGuy316 collected $0.12 from pot
JerseyGuy316: doesn't show hand
*** SUMMARY ***
Total pot $0.13 | Rake $0.01
Board [2s Ts 5d]
Seat 1: unicorn_0812 folded before Flop (didn't bet)
Seat 2: superiorsl (button) folded before Flop (didn't bet)
Seat 3: tapouttazz9 (small blind) folded before Flop
Seat 4: Superman4164 (big blind) folded on the Flop
Seat 5: 96jomama folded before Flop (didn't bet)
Seat 6: JerseyGuy316 collected ($0.12)


PokerStars Hand #152940088958:  Hold'em No Limit ($0.01/$0.02 USD) - 2016/05/16 16:45:33 ET
Table 'Draco' 6-max Seat #3 is the button
Seat 1: unicorn_0812 ($1.75 in chips)
Seat 2: superiorsl ($2 in chips)
Seat 3: tapouttazz9 ($1.97 in chips)
Seat 4: Superman4164 ($3.54 in chips)
Seat 5: 96jomama ($0.83 in chips)
Seat 6: JerseyGuy316 ($2.06 in chips)
Superman4164: posts small blind $0.01
96jomama: posts big blind $0.02
*** HOLE CARDS ***
Dealt to tapouttazz9 [4c 3d]
JerseyGuy316: folds
unicorn_0812 has timed out
unicorn_0812: folds
superiorsl: folds
tapouttazz9: folds
Superman4164: calls $0.01
96jomama: checks
*** FLOP *** [Qs 3h Jc]
Superman4164: checks
96jomama: bets $0.02
Superman4164: calls $0.02
*** TURN *** [Qs 3h Jc] [6h]
Superman4164: checks
JerseyGuy316 leaves the table
96jomama: bets $0.02
Superman4164: calls $0.02
*** RIVER *** [Qs 3h Jc 6h] [6d]
Superman4164: checks
96jomama: bets $0.02
Superman4164: folds
Uncalled bet ($0.02) returned to 96jomama
96jomama collected $0.11 from pot
96jomama: doesn't show hand
*** SUMMARY ***
Total pot $0.12 | Rake $0.01
Board [Qs 3h Jc 6h 6d]
Seat 1: unicorn_0812 folded before Flop (didn't bet)
Seat 2: superiorsl folded before Flop (didn't bet)
Seat 3: tapouttazz9 (button) folded before Flop (didn't bet)
Seat 4: Superman4164 (small blind) folded on the River
Seat 5: 96jomama (big blind) collected ($0.11)
Seat 6: JerseyGuy316 folded before Flop (didn't bet)


PokerStars Hand #152940089133:  Hold'em No Limit ($0.01/$0.02 USD) - 2016/05/16 16:46:27 ET
Table 'Draco' 6-max Seat #4 is the button
Seat 2: superiorsl ($2 in chips)
Seat 3: tapouttazz9 ($1.97 in chips)
Seat 4: Superman4164 ($3.48 in chips)
Seat 5: 96jomama ($0.88 in chips)
96jomama: posts small blind $0.01
superiorsl: posts big blind $0.02
*** HOLE CARDS ***
Dealt to tapouttazz9 [2d 8c]
tapouttazz9: folds
Superman4164: folds
96jomama: calls $0.01
superiorsl: checks
*** FLOP *** [6d Td Qs]
96jomama: checks
superiorsl: bets $0.02
96jomama: folds
Uncalled bet ($0.02) returned to superiorsl
superiorsl collected $0.04 from pot
superiorsl: doesn't show hand
*** SUMMARY ***
Total pot $0.04 | Rake $0
Board [6d Td Qs]
Seat 2: superiorsl (big blind) collected ($0.04)
Seat 3: tapouttazz9 folded before Flop (didn't bet)
Seat 4: Superman4164 (button) folded before Flop (didn't bet)
Seat 5: 96jomama (small blind) folded on the Flop


PokerStars Hand #152940089213:  Hold'em No Limit ($0.01/$0.02 USD) - 2016/05/16 16:46:51 ET
Table 'Draco' 6-max Seat #5 is the button
Seat 2: superiorsl ($2.02 in chips)
Seat 3: tapouttazz9 ($1.97 in chips)
Seat 4: Superman4164 ($3.48 in chips)
Seat 5: 96jomama ($0.86 in chips)
superiorsl: posts small blind $0.01
tapouttazz9: posts big blind $0.02
*** HOLE CARDS ***
Dealt to tapouttazz9 [5h 5s]
Superman4164: folds
96jomama: folds
superiorsl: calls $0.01
tapouttazz9: checks
*** FLOP *** [7d Th Td]
superiorsl: checks
tapouttazz9: checks
*** TURN *** [7d Th Td] [Qh]
superiorsl: checks
tapouttazz9: checks
*** RIVER *** [7d Th Td Qh] [As]
superiorsl: bets $0.02
tapouttazz9: folds
Uncalled bet ($0.02) returned to superiorsl
superiorsl collected $0.04 from pot
superiorsl: doesn't show hand
*** SUMMARY ***
Total pot $0.04 | Rake $0
Board [7d Th Td Qh As]
Seat 2: superiorsl (small blind) collected ($0.04)
Seat 3: tapouttazz9 (big blind) folded on the River
Seat 4: Superman4164 folded before Flop (didn't bet)
Seat 5: 96jomama (button) folded before Flop (didn't bet)


PokerStars Hand #152940089299:  Hold'em No Limit ($0.01/$0.02 USD) - 2016/05/16 16:47:20 ET
Table 'Draco' 6-max Seat #2 is the button
Seat 2: superiorsl ($2.04 in chips)
Seat 3: tapouttazz9 ($1.95 in chips)
Seat 4: Superman4164 ($3.48 in chips)
Seat 5: 96jomama ($0.86 in chips)
tapouttazz9: posts small blind $0.01
Superman4164: posts big blind $0.02
*** HOLE CARDS ***
Dealt to tapouttazz9 [Kh 4d]
96jomama: calls $0.02
superiorsl: raises $0.07 to $0.09
tapouttazz9: folds
Superman4164: calls $0.07
96jomama: folds
*** FLOP *** [2c 2s As]
Superman4164: checks
colinsdad16 joins the table at seat #6
superiorsl: checks
*** TURN *** [2c 2s As] [9h]
Superman4164: checks
superiorsl: checks
*** RIVER *** [2c 2s As 9h] [5c]
Superman4164: bets $0.02
superiorsl: folds
Uncalled bet ($0.02) returned to Superman4164
Superman4164 collected $0.20 from pot
Superman4164: doesn't show hand
*** SUMMARY ***
Total pot $0.21 | Rake $0.01
Board [2c 2s As 9h 5c]
Seat 2: superiorsl (button) folded on the River
Seat 3: tapouttazz9 (small blind) folded before Flop
Seat 4: Superman4164 (big blind) collected ($0.20)
Seat 5: 96jomama folded before Flop


PokerStars Hand #152940089435:  Hold'em No Limit ($0.01/$0.02 USD) - 2016/05/16 16:48:06 ET
Table 'Draco' 6-max Seat #3 is the button
Seat 2: superiorsl ($1.95 in chips)
Seat 3: tapouttazz9 ($1.94 in chips)
Seat 4: Superman4164 ($3.59 in chips)
Seat 5: 96jomama ($0.84 in chips)
Superman4164: posts small blind $0.01
96jomama: posts big blind $0.02
colinsdad16: sits out
*** HOLE CARDS ***
Dealt to tapouttazz9 [Jh 8s]
superiorsl: calls $0.02
tapouttazz9: folds
Superman4164: calls $0.01
96jomama: checks
*** FLOP *** [4d 7d 3d]
Superman4164: checks
96jomama: checks
superiorsl: checks
*** TURN *** [4d 7d 3d] [3c]
Superman4164: bets $0.02
96jomama: folds
superiorsl: calls $0.02
*** RIVER *** [4d 7d 3d 3c] [Jd]
Superman4164: checks
superiorsl: checks
*** SHOW DOWN ***
Superman4164: shows [Qh Ks] (a pair of Threes)
superiorsl: mucks hand
Superman4164 collected $0.10 from pot
*** SUMMARY ***
Total pot $0.10 | Rake $0
Board [4d 7d 3d 3c Jd]
Seat 2: superiorsl mucked [6h Kc]
Seat 3: tapouttazz9 (button) folded before Flop (didn't bet)
Seat 4: Superman4164 (small blind) showed [Qh Ks] and won ($0.10) with a pair of Threes
Seat 5: 96jomama (big blind) folded on the Turn


PokerStars Hand #152940089524:  Hold'em No Limit ($0.01/$0.02 USD) - 2016/05/16 16:48:38 ET
Table 'Draco' 6-max Seat #4 is the button
Seat 2: superiorsl ($1.91 in chips)
Seat 3: tapouttazz9 ($1.94 in chips)
Seat 4: Superman4164 ($3.65 in chips)
Seat 5: 96jomama ($0.82 in chips)
Seat 6: colinsdad16 ($2 in chips)
96jomama: posts small blind $0.01
colinsdad16: posts big blind $0.02
*** HOLE CARDS ***
Dealt to tapouttazz9 [6c 6h]
superiorsl: folds
tapouttazz9: raises $0.04 to $0.06
Superman4164: folds
96jomama: folds
colinsdad16: folds
Uncalled bet ($0.04) returned to tapouttazz9
tapouttazz9 collected $0.05 from pot
tapouttazz9: doesn't show hand
*** SUMMARY ***
Total pot $0.05 | Rake $0
Seat 2: superiorsl folded before Flop (didn't bet)
Seat 3: tapouttazz9 collected ($0.05)
Seat 4: Superman4164 (button) folded before Flop (didn't bet)
Seat 5: 96jomama (small blind) folded before Flop
Seat 6: colinsdad16 (big blind) folded before Flop


PokerStars Hand #152940089559:  Hold'em No Limit ($0.01/$0.02 USD) - 2016/05/16 16:48:53 ET
Table 'Draco' 6-max Seat #5 is the button
Seat 2: superiorsl ($1.91 in chips)
Seat 3: tapouttazz9 ($1.97 in chips)
Seat 4: Superman4164 ($3.65 in chips)
Seat 5: 96jomama ($0.81 in chips)
Seat 6: colinsdad16 ($1.98 in chips)
colinsdad16: posts small blind $0.01
superiorsl: posts big blind $0.02
*** HOLE CARDS ***
Dealt to tapouttazz9 [3d Jh]
tapouttazz9: folds
Superman4164: calls $0.02
96jomama: folds
96jomama leaves the table
unicorn_0812 is disconnected
colinsdad16: calls $0.01
superiorsl: checks
*** FLOP *** [Td Ts Qs]
colinsdad16: checks
superiorsl: checks
Superman4164: checks
*** TURN *** [Td Ts Qs] [6d]
colinsdad16: checks
superiorsl: bets $0.03
Superman4164: folds
colinsdad16: calls $0.03
*** RIVER *** [Td Ts Qs 6d] [Kc]
colinsdad16: checks
superiorsl: bets $0.04
colinsdad16: folds
Uncalled bet ($0.04) returned to superiorsl
superiorsl collected $0.11 from pot
superiorsl: doesn't show hand
*** SUMMARY ***
Total pot $0.12 | Rake $0.01
Board [Td Ts Qs 6d Kc]
Seat 2: superiorsl (big blind) collected ($0.11)
Seat 3: tapouttazz9 folded before Flop (didn't bet)
Seat 4: Superman4164 folded on the Turn
Seat 5: 96jomama (button) folded before Flop (didn't bet)
Seat 6: colinsdad16 (small blind) folded on the River


PokerStars Hand #152940089687:  Hold'em No Limit ($0.01/$0.02 USD) - 2016/05/16 16:49:39 ET
Table 'Draco' 6-max Seat #6 is the button
Seat 2: superiorsl ($1.97 in chips)
Seat 3: tapouttazz9 ($1.97 in chips)
Seat 4: Superman4164 ($3.63 in chips)
Seat 6: colinsdad16 ($1.93 in chips)
superiorsl: posts small blind $0.01
tapouttazz9: posts big blind $0.02
*** HOLE CARDS ***
Dealt to tapouttazz9 [Ks Qc]
Superman4164: calls $0.02
colinsdad16: folds
superiorsl: calls $0.01
tapouttazz9: checks
*** FLOP *** [9h 3s Jd]
superiorsl: checks
tapouttazz9: checks
Superman4164: bets $0.02
superiorsl: calls $0.02
tapouttazz9: calls $0.02
*** TURN *** [9h 3s Jd] [8s]
superiorsl: checks
tapouttazz9: checks
Superman4164: bets $0.02
superiorsl: folds
tapouttazz9: calls $0.02
*** RIVER *** [9h 3s Jd 8s] [Jc]
tapouttazz9: checks
Superman4164: checks
*** SHOW DOWN ***
tapouttazz9: shows [Ks Qc] (a pair of Jacks)
Superman4164: shows [Qd 9c] (two pair, Jacks and Nines)
Superman4164 collected $0.15 from pot
*** SUMMARY ***
Total pot $0.16 | Rake $0.01
Board [9h 3s Jd 8s Jc]
Seat 2: superiorsl (small blind) folded on the Turn
Seat 3: tapouttazz9 (big blind) showed [Ks Qc] and lost with a pair of Jacks
Seat 4: Superman4164 showed [Qd 9c] and won ($0.15) with two pair, Jacks and Nines
Seat 6: colinsdad16 (button) folded before Flop (didn't bet)


PokerStars Hand #152940089913:  Hold'em No Limit ($0.01/$0.02 USD) - 2016/05/16 16:51:00 ET
Table 'Draco' 6-max Seat #2 is the button
Seat 2: superiorsl ($1.93 in chips)
Seat 3: tapouttazz9 ($1.91 in chips)
Seat 4: Superman4164 ($3.72 in chips)
Seat 6: colinsdad16 ($1.93 in chips)
tapouttazz9: posts small blind $0.01
Superman4164: posts big blind $0.02
*** HOLE CARDS ***
Dealt to tapouttazz9 [Kc Kd]
colinsdad16: folds
superiorsl: folds
tapouttazz9: raises $0.04 to $0.06
Superman4164: calls $0.04
*** FLOP *** [Th Qs 5s]
tapouttazz9: bets $0.11
Superman4164: calls $0.11
*** TURN *** [Th Qs 5s] [Ac]
tapouttazz9: checks
Steelfox7 joins the table at seat #5
Superman4164: bets $0.08
tapouttazz9: calls $0.08
*** RIVER *** [Th Qs 5s Ac] [Jc]
tapouttazz9: bets $1.66 and is all-in
Superman4164: folds
Uncalled bet ($1.66) returned to tapouttazz9
tapouttazz9 collected $0.48 from pot
tapouttazz9: doesn't show hand
*** SUMMARY ***
Total pot $0.50 | Rake $0.02
Board [Th Qs 5s Ac Jc]
Seat 2: superiorsl (button) folded before Flop (didn't bet)
Seat 3: tapouttazz9 (small blind) collected ($0.48)
Seat 4: Superman4164 (big blind) folded on the River
Seat 6: colinsdad16 folded before Flop (didn't bet)


PokerStars Hand #152941739099:  Hold'em No Limit ($0.01/$0.02 USD) - 2016/05/16 16:52:00 ET
Table 'Draco' 6-max Seat #3 is the button
Seat 2: superiorsl ($1.93 in chips)
Seat 3: tapouttazz9 ($2.14 in chips)
Seat 4: Superman4164 ($3.47 in chips)
Seat 5: Steelfox7 ($2 in chips)
Seat 6: colinsdad16 ($1.93 in chips)
Superman4164: posts small blind $0.01
Steelfox7: posts big blind $0.02
*** HOLE CARDS ***
Dealt to tapouttazz9 [4s Jd]
colinsdad16: calls $0.02
superiorsl: raises $0.07 to $0.09
tapouttazz9: folds
Superman4164: folds
Steelfox7: folds
colinsdad16: folds
Uncalled bet ($0.07) returned to superiorsl
superiorsl collected $0.07 from pot
superiorsl: doesn't show hand
*** SUMMARY ***
Total pot $0.07 | Rake $0
Seat 2: superiorsl collected ($0.07)
Seat 3: tapouttazz9 (button) folded before Flop (didn't bet)
Seat 4: Superman4164 (small blind) folded before Flop
Seat 5: Steelfox7 (big blind) folded before Flop
Seat 6: colinsdad16 folded before Flop


PokerStars Hand #152941739155:  Hold'em No Limit ($0.01/$0.02 USD) - 2016/05/16 16:52:17 ET
Table 'Draco' 6-max Seat #4 is the button
Seat 2: superiorsl ($1.98 in chips)
Seat 3: tapouttazz9 ($2.14 in chips)
Seat 4: Superman4164 ($3.46 in chips)
Seat 5: Steelfox7 ($1.98 in chips)
Seat 6: colinsdad16 ($1.91 in chips)
Steelfox7: posts small blind $0.01
colinsdad16: posts big blind $0.02
*** HOLE CARDS ***
Dealt to tapouttazz9 [7c 7d]
superiorsl: folds
tapouttazz9: raises $0.02 to $0.04
Superman4164: calls $0.04
Steelfox7: folds
colinsdad16: folds
*** FLOP *** [Qd 8d 5d]
tapouttazz9: bets $0.05
Superman4164: calls $0.05
*** TURN *** [Qd 8d 5d] [Kc]
tapouttazz9: checks
Superman4164: checks
*** RIVER *** [Qd 8d 5d Kc] [4c]
tapouttazz9: checks
Superman4164: checks
*** SHOW DOWN ***
tapouttazz9: shows [7c 7d] (a pair of Sevens)
Superman4164: shows [Qh 9d] (a pair of Queens)
Superman4164 collected $0.20 from pot
*** SUMMARY ***
Total pot $0.21 | Rake $0.01
Board [Qd 8d 5d Kc 4c]
Seat 2: superiorsl folded before Flop (didn't bet)
Seat 3: tapouttazz9 showed [7c 7d] and lost with a pair of Sevens
Seat 4: Superman4164 (button) showed [Qh 9d] and won ($0.20) with a pair of Queens
Seat 5: Steelfox7 (small blind) folded before Flop
Seat 6: colinsdad16 (big blind) folded before Flop


PokerStars Hand #152941739255:  Hold'em No Limit ($0.01/$0.02 USD) - 2016/05/16 16:52:48 ET
Table 'Draco' 6-max Seat #5 is the button
Seat 2: superiorsl ($1.98 in chips)
Seat 3: tapouttazz9 ($2.05 in chips)
Seat 4: Superman4164 ($3.57 in chips)
Seat 5: Steelfox7 ($1.97 in chips)
Seat 6: colinsdad16 ($1.89 in chips)
colinsdad16: posts small blind $0.01
superiorsl: posts big blind $0.02
*** HOLE CARDS ***
Dealt to tapouttazz9 [Ac Ks]
tapouttazz9: raises $0.03 to $0.05
pinnocio joins the table at seat #1
Superman4164: folds
Steelfox7: raises $0.10 to $0.15
colinsdad16: folds
superiorsl: folds
tapouttazz9: raises $0.19 to $0.34
Steelfox7: folds
Uncalled bet ($0.19) returned to tapouttazz9
tapouttazz9 collected $0.33 from pot
tapouttazz9: doesn't show hand
*** SUMMARY ***
Total pot $0.33 | Rake $0
Seat 2: superiorsl (big blind) folded before Flop
Seat 3: tapouttazz9 collected ($0.33)
Seat 4: Superman4164 folded before Flop (didn't bet)
Seat 5: Steelfox7 (button) folded before Flop
Seat 6: colinsdad16 (small blind) folded before Flop


PokerStars Hand #152941739393:  Hold'em No Limit ($0.01/$0.02 USD) - 2016/05/16 16:53:33 ET
Table 'Draco' 6-max Seat #6 is the button
Seat 2: superiorsl ($1.96 in chips)
Seat 3: tapouttazz9 ($2.23 in chips)
Seat 4: Superman4164 ($3.57 in chips)
Seat 5: Steelfox7 ($2 in chips)
Seat 6: colinsdad16 ($1.88 in chips)
pinnocio will be allowed to play after the button
superiorsl: posts small blind $0.01
tapouttazz9: posts big blind $0.02
*** HOLE CARDS ***
Dealt to tapouttazz9 [Ks 2h]
Superman4164: calls $0.02
Steelfox7: folds
colinsdad16: raises $0.04 to $0.06
superiorsl: folds
tapouttazz9: folds
Superman4164: calls $0.04
*** FLOP *** [6h 8c 3s]
Superman4164: checks
colinsdad16: bets $0.10
Superman4164: folds
Uncalled bet ($0.10) returned to colinsdad16
colinsdad16 collected $0.14 from pot
colinsdad16: doesn't show hand
*** SUMMARY ***
Total pot $0.15 | Rake $0.01
Board [6h 8c 3s]
Seat 2: superiorsl (small blind) folded before Flop
Seat 3: tapouttazz9 (big blind) folded before Flop
Seat 4: Superman4164 folded on the Flop
Seat 5: Steelfox7 folded before Flop (didn't bet)
Seat 6: colinsdad16 (button) collected ($0.14)


PokerStars Hand #152941739530:  Hold'em No Limit ($0.01/$0.02 USD) - 2016/05/16 16:54:10 ET
Table 'Draco' 6-max Seat #2 is the button
Seat 1: pinnocio ($1.60 in chips)
Seat 2: superiorsl ($1.95 in chips)
Seat 3: tapouttazz9 ($2.21 in chips)
Seat 4: Superman4164 ($3.51 in chips)
Seat 5: Steelfox7 ($2 in chips)
Seat 6: colinsdad16 ($1.96 in chips)
tapouttazz9: posts small blind $0.01
Superman4164: posts big blind $0.02
pinnocio: posts big blind $0.02
*** HOLE CARDS ***
Dealt to tapouttazz9 [6d 8d]
Steelfox7: folds
colinsdad16: calls $0.02
pinnocio: checks
superiorsl: folds
tapouttazz9: folds
Superman4164: checks
*** FLOP *** [Ad 4h 4s]
Superman4164: bets $0.02
colinsdad16: folds
pinnocio: folds
Uncalled bet ($0.02) returned to Superman4164
Superman4164 collected $0.07 from pot
Superman4164: doesn't show hand
*** SUMMARY ***
Total pot $0.07 | Rake $0
Board [Ad 4h 4s]
Seat 1: pinnocio folded on the Flop
Seat 2: superiorsl (button) folded before Flop (didn't bet)
Seat 3: tapouttazz9 (small blind) folded before Flop
Seat 4: Superman4164 (big blind) collected ($0.07)
Seat 5: Steelfox7 folded before Flop (didn't bet)
Seat 6: colinsdad16 folded on the Flop


PokerStars Hand #152941739655:  Hold'em No Limit ($0.01/$0.02 USD) - 2016/05/16 16:54:48 ET
Table 'Draco' 6-max Seat #3 is the button
Seat 1: pinnocio ($1.58 in chips)
Seat 2: superiorsl ($1.95 in chips)
Seat 3: tapouttazz9 ($2.20 in chips)
Seat 4: Superman4164 ($3.56 in chips)
Seat 5: Steelfox7 ($2 in chips)
Seat 6: colinsdad16 ($1.94 in chips)
Superman4164: posts small blind $0.01
Steelfox7: posts big blind $0.02
*** HOLE CARDS ***
Dealt to tapouttazz9 [2d Kd]
colinsdad16: folds
pinnocio: calls $0.02
superiorsl: calls $0.02
tapouttazz9: raises $0.04 to $0.06
Superman4164: folds
Steelfox7: folds
pinnocio: calls $0.04
superiorsl: calls $0.04
*** FLOP *** [2s Qh 8c]
pinnocio: checks
superiorsl: checks
tapouttazz9: bets $0.10
pinnocio: folds
superiorsl: calls $0.10
*** TURN *** [2s Qh 8c] [5c]
superiorsl: checks
tapouttazz9: checks
*** RIVER *** [2s Qh 8c 5c] [Ad]
superiorsl: checks
tapouttazz9: checks
*** SHOW DOWN ***
superiorsl: shows [Td Kc] (high card Ace)
tapouttazz9: shows [2d Kd] (a pair of Deuces)
tapouttazz9 collected $0.39 from pot
*** SUMMARY ***
Total pot $0.41 | Rake $0.02
Board [2s Qh 8c 5c Ad]
Seat 1: pinnocio folded on the Flop
Seat 2: superiorsl showed [Td Kc] and lost with high card Ace
Seat 3: tapouttazz9 (button) showed [2d Kd] and won ($0.39) with a pair of Deuces
Seat 4: Superman4164 (small blind) folded before Flop
Seat 5: Steelfox7 (big blind) folded before Flop
Seat 6: colinsdad16 folded before Flop (didn't bet)


PokerStars Hand #152941739791:  Hold'em No Limit ($0.01/$0.02 USD) - 2016/05/16 16:55:35 ET
Table 'Draco' 6-max Seat #4 is the button
Seat 1: pinnocio ($1.52 in chips)
Seat 2: superiorsl ($1.79 in chips)
Seat 3: tapouttazz9 ($2.43 in chips)
Seat 4: Superman4164 ($3.55 in chips)
Seat 5: Steelfox7 ($1.98 in chips)
Seat 6: colinsdad16 ($1.94 in chips)
Steelfox7: posts small blind $0.01
colinsdad16: posts big blind $0.02
*** HOLE CARDS ***
Dealt to tapouttazz9 [6h 9d]
pinnocio: folds
superiorsl: folds
tapouttazz9: folds
Superman4164: calls $0.02
Steelfox7: folds
colinsdad16: checks
*** FLOP *** [Jc Th Js]
colinsdad16: checks
Superman4164: bets $0.02
colinsdad16: folds
Uncalled bet ($0.02) returned to Superman4164
Superman4164 collected $0.05 from pot
Superman4164: doesn't show hand
*** SUMMARY ***
Total pot $0.05 | Rake $0
Board [Jc Th Js]
Seat 1: pinnocio folded before Flop (didn't bet)
Seat 2: superiorsl folded before Flop (didn't bet)
Seat 3: tapouttazz9 folded before Flop (didn't bet)
Seat 4: Superman4164 (button) collected ($0.05)
Seat 5: Steelfox7 (small blind) folded before Flop
Seat 6: colinsdad16 (big blind) folded on the Flop


PokerStars Hand #152941739847:  Hold'em No Limit ($0.01/$0.02 USD) - 2016/05/16 16:55:58 ET
Table 'Draco' 6-max Seat #5 is the button
Seat 1: pinnocio ($1.52 in chips)
Seat 2: superiorsl ($1.79 in chips)
Seat 3: tapouttazz9 ($2.43 in chips)
Seat 4: Superman4164 ($3.58 in chips)
Seat 5: Steelfox7 ($1.97 in chips)
Seat 6: colinsdad16 ($1.92 in chips)
colinsdad16: posts small blind $0.01
pinnocio: posts big blind $0.02
*** HOLE CARDS ***
Dealt to tapouttazz9 [Ad Ks]
superiorsl: folds
tapouttazz9: raises $0.02 to $0.04
Superman4164: folds
Steelfox7: calls $0.04
colinsdad16: calls $0.03
pinnocio: folds
*** FLOP *** [7s Js 8h]
colinsdad16: checks
tapouttazz9: checks
Steelfox7: bets $0.06
colinsdad16: folds
tapouttazz9: calls $0.06
*** TURN *** [7s Js 8h] [Jh]
tapouttazz9: checks
Steelfox7: bets $0.16
tapouttazz9: folds
Uncalled bet ($0.16) returned to Steelfox7
Steelfox7 collected $0.25 from pot
Steelfox7: doesn't show hand
*** SUMMARY ***
Total pot $0.26 | Rake $0.01
Board [7s Js 8h Jh]
Seat 1: pinnocio (big blind) folded before Flop
Seat 2: superiorsl folded before Flop (didn't bet)
Seat 3: tapouttazz9 folded on the Turn
Seat 4: Superman4164 folded before Flop (didn't bet)
Seat 5: Steelfox7 (button) collected ($0.25)
Seat 6: colinsdad16 (small blind) folded on the Flop


PokerStars Hand #152941739993:  Hold'em No Limit ($0.01/$0.02 USD) - 2016/05/16 16:56:52 ET
Table 'Draco' 6-max Seat #6 is the button
Seat 1: pinnocio ($1.50 in chips)
Seat 2: superiorsl ($1.79 in chips)
Seat 3: tapouttazz9 ($2.33 in chips)
Seat 4: Superman4164 ($3.58 in chips)
Seat 5: Steelfox7 ($2.12 in chips)
Seat 6: colinsdad16 ($1.88 in chips)
pinnocio: posts small blind $0.01
superiorsl: posts big blind $0.02
*** HOLE CARDS ***
Dealt to tapouttazz9 [4d 3d]
tapouttazz9: folds
Superman4164: folds
Steelfox7: folds
colinsdad16: calls $0.02
pinnocio: calls $0.01
superiorsl: checks
*** FLOP *** [8h 5h 9h]
pinnocio: checks
superiorsl: checks
colinsdad16: checks
*** TURN *** [8h 5h 9h] [6c]
pinnocio: checks
superiorsl: checks
colinsdad16: checks
*** RIVER *** [8h 5h 9h 6c] [Qs]
pinnocio: checks
superiorsl: checks
colinsdad16: checks
*** SHOW DOWN ***
pinnocio: shows [6s 2h] (a pair of Sixes)
superiorsl: shows [8c Ts] (a pair of Eights)
colinsdad16: mucks hand
superiorsl collected $0.06 from pot
*** SUMMARY ***
Total pot $0.06 | Rake $0
Board [8h 5h 9h 6c Qs]
Seat 1: pinnocio (small blind) showed [6s 2h] and lost with a pair of Sixes
Seat 2: superiorsl (big blind) showed [8c Ts] and won ($0.06) with a pair of Eights
Seat 3: tapouttazz9 folded before Flop (didn't bet)
Seat 4: Superman4164 folded before Flop (didn't bet)
Seat 5: Steelfox7 folded before Flop (didn't bet)
Seat 6: colinsdad16 (button) mucked [Kd 5d]


PokerStars Hand #152942079892:  Hold'em No Limit ($0.01/$0.02 USD) - 2016/05/16 16:57:24 ET
Table 'Draco' 6-max Seat #1 is the button
Seat 1: pinnocio ($1.48 in chips)
Seat 2: superiorsl ($1.83 in chips)
Seat 3: tapouttazz9 ($2.33 in chips)
Seat 4: Superman4164 ($3.58 in chips)
Seat 5: Steelfox7 ($2.12 in chips)
Seat 6: colinsdad16 ($1.86 in chips)
superiorsl: posts small blind $0.01
tapouttazz9: posts big blind $0.02
*** HOLE CARDS ***
Dealt to tapouttazz9 [Ks Kc]
Superman4164: calls $0.02
Steelfox7: folds
colinsdad16: folds
pinnocio: calls $0.02
superiorsl: calls $0.01
tapouttazz9: raises $0.03 to $0.05
Superman4164: calls $0.03
pinnocio: calls $0.03
superiorsl: calls $0.03
*** FLOP *** [Js Jd Ts]
superiorsl: checks
tapouttazz9: checks
Superman4164: checks
pinnocio: checks
*** TURN *** [Js Jd Ts] [7h]
superiorsl: checks
tapouttazz9: bets $0.14
Superman4164: folds
pinnocio: calls $0.14
superiorsl: calls $0.14
*** RIVER *** [Js Jd Ts 7h] [4h]
superiorsl: checks
tapouttazz9: checks
pinnocio: checks
*** SHOW DOWN ***
superiorsl: shows [5s 9s] (a pair of Jacks)
tapouttazz9: shows [Ks Kc] (two pair, Kings and Jacks)
pinnocio: shows [Kh Kd] (two pair, Kings and Jacks)
tapouttazz9 collected $0.30 from pot
pinnocio collected $0.29 from pot
*** SUMMARY ***
Total pot $0.62 | Rake $0.03
Board [Js Jd Ts 7h 4h]
Seat 1: pinnocio (button) showed [Kh Kd] and won ($0.29) with two pair, Kings and Jacks
Seat 2: superiorsl (small blind) showed [5s 9s] and lost with a pair of Jacks
Seat 3: tapouttazz9 (big blind) showed [Ks Kc] and won ($0.30) with two pair, Kings and Jacks
Seat 4: Superman4164 folded on the Turn
Seat 5: Steelfox7 folded before Flop (didn't bet)
Seat 6: colinsdad16 folded before Flop (didn't bet)


PokerStars Hand #152942147981:  Hold'em No Limit ($0.01/$0.02 USD) - 2016/05/16 16:58:40 ET
Table 'Draco' 6-max Seat #2 is the button
Seat 1: pinnocio ($1.58 in chips)
Seat 2: superiorsl ($1.64 in chips)
Seat 3: tapouttazz9 ($2.44 in chips)
Seat 4: Superman4164 ($3.53 in chips)
Seat 5: Steelfox7 ($2.12 in chips)
Seat 6: colinsdad16 ($1.86 in chips)
tapouttazz9: posts small blind $0.01
Superman4164: posts big blind $0.02
*** HOLE CARDS ***
Dealt to tapouttazz9 [9s Ad]
Steelfox7: folds
colinsdad16: folds
pinnocio: folds
superiorsl: folds
tapouttazz9: raises $0.03 to $0.05
Superman4164: calls $0.03
*** FLOP *** [6h Js 9d]
tapouttazz9: bets $0.05
Superman4164: calls $0.05
*** TURN *** [6h Js 9d] [Tc]
tapouttazz9: checks
Superman4164: checks
*** RIVER *** [6h Js 9d Tc] [Kh]
tapouttazz9: checks
Superman4164: checks
*** SHOW DOWN ***
tapouttazz9: shows [9s Ad] (a pair of Nines)
Superman4164: mucks hand
tapouttazz9 collected $0.19 from pot
*** SUMMARY ***
Total pot $0.20 | Rake $0.01
Board [6h Js 9d Tc Kh]
Seat 1: pinnocio folded before Flop (didn't bet)
Seat 2: superiorsl (button) folded before Flop (didn't bet)
Seat 3: tapouttazz9 (small blind) showed [9s Ad] and won ($0.19) with a pair of Nines
Seat 4: Superman4164 (big blind) mucked [7h 7d]
Seat 5: Steelfox7 folded before Flop (didn't bet)
Seat 6: colinsdad16 folded before Flop (didn't bet)


PokerStars Hand #152942148082:  Hold'em No Limit ($0.01/$0.02 USD) - 2016/05/16 16:59:17 ET
Table 'Draco' 6-max Seat #3 is the button
Seat 1: pinnocio ($1.58 in chips)
Seat 2: superiorsl ($1.64 in chips)
Seat 3: tapouttazz9 ($2.53 in chips)
Seat 4: Superman4164 ($3.43 in chips)
Seat 5: Steelfox7 ($2.12 in chips)
Seat 6: colinsdad16 ($1.86 in chips)
Superman4164: posts small blind $0.01
Steelfox7: posts big blind $0.02
*** HOLE CARDS ***
Dealt to tapouttazz9 [Kh Tc]
colinsdad16: calls $0.02
pinnocio: calls $0.02
superiorsl: calls $0.02
tapouttazz9: raises $0.02 to $0.04
Superman4164: folds
Steelfox7: calls $0.02
colinsdad16: folds
pinnocio: calls $0.02
superiorsl: calls $0.02
*** FLOP *** [6h Td 6c]
Steelfox7: checks
pinnocio: checks
superiorsl: checks
tapouttazz9: bets $0.13
Steelfox7: folds
pinnocio: folds
superiorsl: calls $0.13
*** TURN *** [6h Td 6c] [7c]
superiorsl: checks
tapouttazz9: checks
*** RIVER *** [6h Td 6c 7c] [As]
superiorsl: checks
tapouttazz9: checks
*** SHOW DOWN ***
superiorsl: shows [Ks Js] (a pair of Sixes)
tapouttazz9: shows [Kh Tc] (two pair, Tens and Sixes)
tapouttazz9 collected $0.43 from pot
*** SUMMARY ***
Total pot $0.45 | Rake $0.02
Board [6h Td 6c 7c As]
Seat 1: pinnocio folded on the Flop
Seat 2: superiorsl showed [Ks Js] and lost with a pair of Sixes
Seat 3: tapouttazz9 (button) showed [Kh Tc] and won ($0.43) with two pair, Tens and Sixes
Seat 4: Superman4164 (small blind) folded before Flop
Seat 5: Steelfox7 (big blind) folded on the Flop
Seat 6: colinsdad16 folded before Flop


PokerStars Hand #152942148239:  Hold'em No Limit ($0.01/$0.02 USD) - 2016/05/16 17:00:10 ET
Table 'Draco' 6-max Seat #4 is the button
Seat 1: pinnocio ($1.54 in chips)
Seat 2: superiorsl ($1.47 in chips)
Seat 3: tapouttazz9 ($2.79 in chips)
Seat 4: Superman4164 ($3.42 in chips)
Seat 5: Steelfox7 ($2.08 in chips)
Seat 6: colinsdad16 ($1.84 in chips)
Steelfox7: posts small blind $0.01
colinsdad16: posts big blind $0.02
*** HOLE CARDS ***
Dealt to tapouttazz9 [6h 2s]
pinnocio: calls $0.02
superiorsl: folds
tapouttazz9: folds
Superman4164: calls $0.02
Steelfox7: calls $0.01
colinsdad16: checks
*** FLOP *** [7h Ad Ks]
Steelfox7: checks
colinsdad16: checks
pinnocio: checks
Superman4164: checks
*** TURN *** [7h Ad Ks] [8d]
Steelfox7: bets $0.04
colinsdad16: folds
pinnocio: calls $0.04
Superman4164: calls $0.04
*** RIVER *** [7h Ad Ks 8d] [9h]
Steelfox7: checks
pinnocio: checks
Superman4164: checks
*** SHOW DOWN ***
Steelfox7: shows [7d 8c] (two pair, Eights and Sevens)
pinnocio: mucks hand
Superman4164: mucks hand
Steelfox7 collected $0.19 from pot
*** SUMMARY ***
Total pot $0.20 | Rake $0.01
Board [7h Ad Ks 8d 9h]
Seat 1: pinnocio mucked [Tc Ac]
Seat 2: superiorsl folded before Flop (didn't bet)
Seat 3: tapouttazz9 folded before Flop (didn't bet)
Seat 4: Superman4164 (button) mucked [8h Qd]
Seat 5: Steelfox7 (small blind) showed [7d 8c] and won ($0.19) with two pair, Eights and Sevens
Seat 6: colinsdad16 (big blind) folded on the Turn


PokerStars Hand #152942148387:  Hold'em No Limit ($0.01/$0.02 USD) - 2016/05/16 17:00:49 ET
Table 'Draco' 6-max Seat #5 is the button
Seat 1: pinnocio ($1.48 in chips)
Seat 2: superiorsl ($1.47 in chips)
Seat 3: tapouttazz9 ($2.79 in chips)
Seat 4: Superman4164 ($3.36 in chips)
Seat 5: Steelfox7 ($2.21 in chips)
Seat 6: colinsdad16 ($1.82 in chips)
colinsdad16: posts small blind $0.01
pinnocio: posts big blind $0.02
*** HOLE CARDS ***
Dealt to tapouttazz9 [5s Ad]
superiorsl: folds
tapouttazz9: folds
Superman4164: calls $0.02
Steelfox7: folds
colinsdad16: calls $0.01
pinnocio: checks
*** FLOP *** [As 6c 3h]
colinsdad16: bets $0.02
pinnocio: folds
Superman4164: calls $0.02
*** TURN *** [As 6c 3h] [3s]
colinsdad16: checks
Superman4164: checks
*** RIVER *** [As 6c 3h 3s] [Jh]
colinsdad16: bets $0.10
Superman4164: folds
Uncalled bet ($0.10) returned to colinsdad16
colinsdad16 collected $0.10 from pot
colinsdad16: doesn't show hand
*** SUMMARY ***
Total pot $0.10 | Rake $0
Board [As 6c 3h 3s Jh]
Seat 1: pinnocio (big blind) folded on the Flop
Seat 2: superiorsl folded before Flop (didn't bet)
Seat 3: tapouttazz9 folded before Flop (didn't bet)
Seat 4: Superman4164 folded on the River
Seat 5: Steelfox7 (button) folded before Flop (didn't bet)
Seat 6: colinsdad16 (small blind) collected ($0.10)


PokerStars Hand #152942148524:  Hold'em No Limit ($0.01/$0.02 USD) - 2016/05/16 17:01:20 ET
Table 'Draco' 6-max Seat #6 is the button
Seat 1: pinnocio ($1.46 in chips)
Seat 2: superiorsl ($1.47 in chips)
Seat 3: tapouttazz9 ($2.79 in chips)
Seat 4: Superman4164 ($3.32 in chips)
Seat 5: Steelfox7 ($2.21 in chips)
Seat 6: colinsdad16 ($1.88 in chips)
pinnocio: posts small blind $0.01
superiorsl: posts big blind $0.02
*** HOLE CARDS ***
Dealt to tapouttazz9 [3c Ks]
tapouttazz9: folds
Superman4164: folds
Steelfox7: folds
colinsdad16: folds
pinnocio: calls $0.01
superiorsl: checks
*** FLOP *** [Jd 5d 8d]
pinnocio: checks
superiorsl: checks
*** TURN *** [Jd 5d 8d] [5h]
pinnocio: checks
superiorsl: checks
*** RIVER *** [Jd 5d 8d 5h] [3d]
pinnocio: checks
superiorsl: bets $0.04
pinnocio: folds
Uncalled bet ($0.04) returned to superiorsl
superiorsl collected $0.04 from pot
superiorsl: doesn't show hand
*** SUMMARY ***
Total pot $0.04 | Rake $0
Board [Jd 5d 8d 5h 3d]
Seat 1: pinnocio (small blind) folded on the River
Seat 2: superiorsl (big blind) collected ($0.04)
Seat 3: tapouttazz9 folded before Flop (didn't bet)
Seat 4: Superman4164 folded before Flop (didn't bet)
Seat 5: Steelfox7 folded before Flop (didn't bet)
Seat 6: colinsdad16 (button) folded before Flop (didn't bet)


PokerStars Hand #152942148638:  Hold'em No Limit ($0.01/$0.02 USD) - 2016/05/16 17:01:49 ET
Table 'Draco' 6-max Seat #1 is the button
Seat 1: pinnocio ($1.44 in chips)
Seat 2: superiorsl ($1.49 in chips)
Seat 3: tapouttazz9 ($2.79 in chips)
Seat 4: Superman4164 ($3.32 in chips)
Seat 5: Steelfox7 ($2.21 in chips)
Seat 6: colinsdad16 ($1.88 in chips)
superiorsl: posts small blind $0.01
tapouttazz9: posts big blind $0.02
*** HOLE CARDS ***
Dealt to tapouttazz9 [5s 8s]
Superman4164: folds
Steelfox7: folds
colinsdad16: folds
pinnocio: calls $0.02
superiorsl: calls $0.01
tapouttazz9: checks
*** FLOP *** [Qs Jc 5c]
superiorsl: checks
tapouttazz9: checks
pinnocio: checks
*** TURN *** [Qs Jc 5c] [4s]
superiorsl: checks
tapouttazz9: checks
pinnocio: checks
*** RIVER *** [Qs Jc 5c 4s] [As]
superiorsl: checks
tapouttazz9: bets $0.03
pinnocio: calls $0.03
superiorsl: folds
*** SHOW DOWN ***
tapouttazz9: shows [5s 8s] (a flush, Ace high)
pinnocio: mucks hand
tapouttazz9 collected $0.11 from pot
*** SUMMARY ***
Total pot $0.12 | Rake $0.01
Board [Qs Jc 5c 4s As]
Seat 1: pinnocio (button) mucked [Ac Qd]
Seat 2: superiorsl (small blind) folded on the River
Seat 3: tapouttazz9 (big blind) showed [5s 8s] and won ($0.11) with a flush, Ace high
Seat 4: Superman4164 folded before Flop (didn't bet)
Seat 5: Steelfox7 folded before Flop (didn't bet)
Seat 6: colinsdad16 folded before Flop (didn't bet)


PokerStars Hand #152942148865:  Hold'em No Limit ($0.01/$0.02 USD) - 2016/05/16 17:02:48 ET
Table 'Draco' 6-max Seat #2 is the button
Seat 1: pinnocio ($1.39 in chips)
Seat 2: superiorsl ($1.47 in chips)
Seat 3: tapouttazz9 ($2.85 in chips)
Seat 4: Superman4164 ($3.32 in chips)
Seat 5: Steelfox7 ($2.21 in chips)
Seat 6: colinsdad16 ($1.88 in chips)
tapouttazz9: posts small blind $0.01
Superman4164: posts big blind $0.02
*** HOLE CARDS ***
Dealt to tapouttazz9 [5c 4s]
Steelfox7: folds
colinsdad16: folds
pinnocio: folds
superiorsl: folds
tapouttazz9: folds
Uncalled bet ($0.01) returned to Superman4164
Superman4164 collected $0.02 from pot
Superman4164: doesn't show hand
*** SUMMARY ***
Total pot $0.02 | Rake $0
Seat 1: pinnocio folded before Flop (didn't bet)
Seat 2: superiorsl (button) folded before Flop (didn't bet)
Seat 3: tapouttazz9 (small blind) folded before Flop
Seat 4: Superman4164 (big blind) collected ($0.02)
Seat 5: Steelfox7 folded before Flop (didn't bet)
Seat 6: colinsdad16 folded before Flop (didn't bet)


PokerStars Hand #152942148896:  Hold'em No Limit ($0.01/$0.02 USD) - 2016/05/16 17:02:58 ET
Table 'Draco' 6-max Seat #3 is the button
Seat 1: pinnocio ($1.39 in chips)
Seat 2: superiorsl ($1.47 in chips)
Seat 3: tapouttazz9 ($2.84 in chips)
Seat 4: Superman4164 ($3.33 in chips)
Seat 5: Steelfox7 ($2.21 in chips)
Seat 6: colinsdad16 ($1.88 in chips)
Superman4164: posts small blind $0.01
Steelfox7: posts big blind $0.02
*** HOLE CARDS ***
Dealt to tapouttazz9 [9d Jd]
colinsdad16: folds
pinnocio: folds
superiorsl: folds
tapouttazz9: folds
Superman4164: calls $0.01
Steelfox7: raises $0.04 to $0.06
Superman4164: calls $0.04
*** FLOP *** [2c 5h Kc]
Superman4164: checks
Steelfox7: bets $0.06
Superman4164: folds
Uncalled bet ($0.06) returned to Steelfox7
Steelfox7 collected $0.11 from pot
Steelfox7: doesn't show hand
*** SUMMARY ***
Total pot $0.12 | Rake $0.01
Board [2c 5h Kc]
Seat 1: pinnocio folded before Flop (didn't bet)
Seat 2: superiorsl folded before Flop (didn't bet)
Seat 3: tapouttazz9 (button) folded before Flop (didn't bet)
Seat 4: Superman4164 (small blind) folded on the Flop
Seat 5: Steelfox7 (big blind) collected ($0.11)
Seat 6: colinsdad16 folded before Flop (didn't bet)


PokerStars Hand #152942149032:  Hold'em No Limit ($0.01/$0.02 USD) - 2016/05/16 17:03:35 ET
Table 'Draco' 6-max Seat #4 is the button
Seat 1: pinnocio ($1.39 in chips)
Seat 2: superiorsl ($1.47 in chips)
Seat 3: tapouttazz9 ($2.84 in chips)
Seat 4: Superman4164 ($3.27 in chips)
Seat 5: Steelfox7 ($2.26 in chips)
Seat 6: colinsdad16 ($1.88 in chips)
Steelfox7: posts small blind $0.01
colinsdad16: posts big blind $0.02
*** HOLE CARDS ***
Dealt to tapouttazz9 [5c Ac]
pinnocio: folds
superiorsl: calls $0.02
tapouttazz9: raises $0.02 to $0.04
Superman4164: calls $0.04
Steelfox7: folds
colinsdad16: folds
superiorsl: calls $0.02
*** FLOP *** [Qs 7c Td]
superiorsl: checks
tapouttazz9: checks
Superman4164: bets $0.08
superiorsl: calls $0.08
tapouttazz9: folds
*** TURN *** [Qs 7c Td] [Jc]
superiorsl: checks
Superman4164: bets $0.04
superiorsl: raises $0.19 to $0.23
Superman4164: calls $0.19
*** RIVER *** [Qs 7c Td Jc] [5d]
superiorsl: checks
Superman4164: checks
*** SHOW DOWN ***
superiorsl: shows [9h Js] (a pair of Jacks)
Superman4164: shows [Qc 8c] (a pair of Queens)
Superman4164 collected $0.74 from pot
*** SUMMARY ***
Total pot $0.77 | Rake $0.03
Board [Qs 7c Td Jc 5d]
Seat 1: pinnocio folded before Flop (didn't bet)
Seat 2: superiorsl showed [9h Js] and lost with a pair of Jacks
Seat 3: tapouttazz9 folded on the Flop
Seat 4: Superman4164 (button) showed [Qc 8c] and won ($0.74) with a pair of Queens
Seat 5: Steelfox7 (small blind) folded before Flop
Seat 6: colinsdad16 (big blind) folded before Flop


PokerStars Hand #152942149352:  Hold'em No Limit ($0.01/$0.02 USD) - 2016/05/16 17:04:58 ET
Table 'Draco' 6-max Seat #5 is the button
Seat 1: pinnocio ($1.39 in chips)
Seat 2: superiorsl ($1.12 in chips)
Seat 3: tapouttazz9 ($2.80 in chips)
Seat 4: Superman4164 ($3.66 in chips)
Seat 5: Steelfox7 ($2.25 in chips)
Seat 6: colinsdad16 ($1.86 in chips)
colinsdad16: posts small blind $0.01
pinnocio: posts big blind $0.02
*** HOLE CARDS ***
Dealt to tapouttazz9 [2s 4s]
superiorsl: folds
tapouttazz9: folds
Superman4164: folds
Steelfox7: folds
colinsdad16: folds
Uncalled bet ($0.01) returned to pinnocio
pinnocio collected $0.02 from pot
pinnocio: doesn't show hand
*** SUMMARY ***
Total pot $0.02 | Rake $0
Seat 1: pinnocio (big blind) collected ($0.02)
Seat 2: superiorsl folded before Flop (didn't bet)
Seat 3: tapouttazz9 folded before Flop (didn't bet)
Seat 4: Superman4164 folded before Flop (didn't bet)
Seat 5: Steelfox7 (button) folded before Flop (didn't bet)
Seat 6: colinsdad16 (small blind) folded before Flop


PokerStars Hand #152942149434:  Hold'em No Limit ($0.01/$0.02 USD) - 2016/05/16 17:05:19 ET
Table 'Draco' 6-max Seat #6 is the button
Seat 1: pinnocio ($1.40 in chips)
Seat 2: superiorsl ($1.12 in chips)
Seat 3: tapouttazz9 ($2.80 in chips)
Seat 4: Superman4164 ($3.66 in chips)
Seat 5: Steelfox7 ($2.25 in chips)
Seat 6: colinsdad16 ($1.85 in chips)
pinnocio: posts small blind $0.01
superiorsl: posts big blind $0.02
*** HOLE CARDS ***
Dealt to tapouttazz9 [8h 3h]
tapouttazz9: folds
Superman4164: calls $0.02
Steelfox7: folds
colinsdad16: folds
pinnocio: calls $0.01
superiorsl: checks
*** FLOP *** [Th 7c 5s]
pinnocio: checks
superiorsl: checks
Superman4164: bets $0.02
pinnocio: folds
superiorsl: calls $0.02
*** TURN *** [Th 7c 5s] [Kc]
superiorsl: checks
Superman4164: bets $0.06
superiorsl: folds
Uncalled bet ($0.06) returned to Superman4164
Superman4164 collected $0.10 from pot
Superman4164: doesn't show hand
*** SUMMARY ***
Total pot $0.10 | Rake $0
Board [Th 7c 5s Kc]
Seat 1: pinnocio (small blind) folded on the Flop
Seat 2: superiorsl (big blind) folded on the Turn
Seat 3: tapouttazz9 folded before Flop (didn't bet)
Seat 4: Superman4164 collected ($0.10)
Seat 5: Steelfox7 folded before Flop (didn't bet)
Seat 6: colinsdad16 (button) folded before Flop (didn't bet)


PokerStars Hand #152942149701:  Hold'em No Limit ($0.01/$0.02 USD) - 2016/05/16 17:06:31 ET
Table 'Draco' 6-max Seat #1 is the button
Seat 1: pinnocio ($1.38 in chips)
Seat 2: superiorsl ($1.08 in chips)
Seat 3: tapouttazz9 ($2.80 in chips)
Seat 4: Superman4164 ($3.72 in chips)
Seat 5: Steelfox7 ($2.25 in chips)
Seat 6: colinsdad16 ($1.85 in chips)
superiorsl: posts small blind $0.01
tapouttazz9: posts big blind $0.02
*** HOLE CARDS ***
Dealt to tapouttazz9 [5h 9d]
Superman4164: calls $0.02
Steelfox7: folds
colinsdad16: folds
pinnocio: calls $0.02
superiorsl: calls $0.01
tapouttazz9: checks
*** FLOP *** [7d 6s 4h]
superiorsl: checks
tapouttazz9: bets $0.06
Superman4164: folds
pinnocio: folds
superiorsl: folds
Uncalled bet ($0.06) returned to tapouttazz9
tapouttazz9 collected $0.08 from pot
tapouttazz9: doesn't show hand
*** SUMMARY ***
Total pot $0.08 | Rake $0
Board [7d 6s 4h]
Seat 1: pinnocio (button) folded on the Flop
Seat 2: superiorsl (small blind) folded on the Flop
Seat 3: tapouttazz9 (big blind) collected ($0.08)
Seat 4: Superman4164 folded on the Flop
Seat 5: Steelfox7 folded before Flop (didn't bet)
Seat 6: colinsdad16 folded before Flop (didn't bet)


PokerStars Hand #152942149867:  Hold'em No Limit ($0.01/$0.02 USD) - 2016/05/16 17:07:24 ET
Table 'Draco' 6-max Seat #2 is the button
Seat 1: pinnocio ($1.36 in chips)
Seat 2: superiorsl ($1.06 in chips)
Seat 3: tapouttazz9 ($2.86 in chips)
Seat 4: Superman4164 ($3.70 in chips)
Seat 5: Steelfox7 ($2.25 in chips)
Seat 6: colinsdad16 ($1.85 in chips)
tapouttazz9: posts small blind $0.01
Superman4164: posts big blind $0.02
*** HOLE CARDS ***
Dealt to tapouttazz9 [Kh Qc]
Steelfox7: folds
colinsdad16: calls $0.02
pinnocio: folds
superiorsl: folds
tapouttazz9: raises $0.04 to $0.06
Superman4164: calls $0.04
colinsdad16: calls $0.04
*** FLOP *** [5c Ah Kc]
tapouttazz9: bets $0.08
Superman4164: folds
colinsdad16: folds
Uncalled bet ($0.08) returned to tapouttazz9
tapouttazz9 collected $0.17 from pot
tapouttazz9: doesn't show hand
*** SUMMARY ***
Total pot $0.18 | Rake $0.01
Board [5c Ah Kc]
Seat 1: pinnocio folded before Flop (didn't bet)
Seat 2: superiorsl (button) folded before Flop (didn't bet)
Seat 3: tapouttazz9 (small blind) collected ($0.17)
Seat 4: Superman4164 (big blind) folded on the Flop
Seat 5: Steelfox7 folded before Flop (didn't bet)
Seat 6: colinsdad16 folded on the Flop


PokerStars Hand #152942149963:  Hold'em No Limit ($0.01/$0.02 USD) - 2016/05/16 17:07:55 ET
Table 'Draco' 6-max Seat #3 is the button
Seat 1: pinnocio ($1.36 in chips)
Seat 2: superiorsl ($1.06 in chips)
Seat 3: tapouttazz9 ($2.97 in chips)
Seat 4: Superman4164 ($3.64 in chips)
Seat 5: Steelfox7 ($2.25 in chips)
Superman4164: posts small blind $0.01
Steelfox7: posts big blind $0.02
*** HOLE CARDS ***
Dealt to tapouttazz9 [Kh 2c]
pinnocio: folds
superiorsl: calls $0.02
tapouttazz9: folds
Superman4164: calls $0.01
Steelfox7: checks
*** FLOP *** [4s Jh 4h]
Superman4164: bets $0.02
Steelfox7: folds
superiorsl: calls $0.02
*** TURN *** [4s Jh 4h] [Tc]
Superman4164: bets $0.04
superiorsl: calls $0.04
*** RIVER *** [4s Jh 4h Tc] [Qh]
Superman4164: bets $0.02
superiorsl: raises $0.10 to $0.12
Superman4164: folds
Uncalled bet ($0.10) returned to superiorsl
superiorsl collected $0.21 from pot
superiorsl: doesn't show hand
*** SUMMARY ***
Total pot $0.22 | Rake $0.01
Board [4s Jh 4h Tc Qh]
Seat 1: pinnocio folded before Flop (didn't bet)
Seat 2: superiorsl collected ($0.21)
Seat 3: tapouttazz9 (button) folded before Flop (didn't bet)
Seat 4: Superman4164 (small blind) folded on the River
Seat 5: Steelfox7 (big blind) folded on the Flop


PokerStars Hand #152942789229:  Hold'em No Limit ($0.01/$0.02 USD) - 2016/05/16 17:08:47 ET
Table 'Draco' 6-max Seat #4 is the button
Seat 1: pinnocio ($1.36 in chips)
Seat 2: superiorsl ($1.17 in chips)
Seat 3: tapouttazz9 ($2.97 in chips)
Seat 4: Superman4164 ($3.54 in chips)
Seat 5: Steelfox7 ($2.23 in chips)
Steelfox7: posts small blind $0.01
pinnocio: posts big blind $0.02
*** HOLE CARDS ***
Dealt to tapouttazz9 [3h 3d]
superiorsl: folds
tapouttazz9: calls $0.02
Superman4164: calls $0.02
Steelfox7: folds
pinnocio: checks
*** FLOP *** [9h Jc Tc]
pinnocio: checks
tapouttazz9: checks
Superman4164: bets $0.02
pinnocio: calls $0.02
tapouttazz9: folds
*** TURN *** [9h Jc Tc] [5s]
pinnocio: checks
Superman4164: bets $0.02
pinnocio: calls $0.02
*** RIVER *** [9h Jc Tc 5s] [Kh]
pinnocio: checks
Superman4164: bets $0.04
pinnocio: folds
Uncalled bet ($0.04) returned to Superman4164
Superman4164 collected $0.14 from pot
Superman4164: doesn't show hand
*** SUMMARY ***
Total pot $0.15 | Rake $0.01
Board [9h Jc Tc 5s Kh]
Seat 1: pinnocio (big blind) folded on the River
Seat 2: superiorsl folded before Flop (didn't bet)
Seat 3: tapouttazz9 folded on the Flop
Seat 4: Superman4164 (button) collected ($0.14)
Seat 5: Steelfox7 (small blind) folded before Flop


PokerStars Hand #152942789481:  Hold'em No Limit ($0.01/$0.02 USD) - 2016/05/16 17:10:04 ET
Table 'Draco' 6-max Seat #5 is the button
Seat 1: pinnocio ($1.30 in chips)
Seat 2: superiorsl ($1.17 in chips)
Seat 3: tapouttazz9 ($2.95 in chips)
Seat 4: Superman4164 ($3.62 in chips)
Seat 5: Steelfox7 ($2.22 in chips)
colinsdad16 will be allowed to play after the button
pinnocio: posts small blind $0.01
superiorsl: posts big blind $0.02
*** HOLE CARDS ***
Dealt to tapouttazz9 [Ks As]
tapouttazz9: raises $0.03 to $0.05
Superman4164: calls $0.05
Steelfox7: folds
pinnocio: calls $0.04
superiorsl: calls $0.03
*** FLOP *** [9d 2d 3d]
pinnocio: checks
superiorsl: checks
tapouttazz9: checks
Superman4164: bets $0.02
pinnocio: folds
superiorsl: folds
pinnocio leaves the table
tapouttazz9: calls $0.02
*** TURN *** [9d 2d 3d] [7d]
tapouttazz9: checks
Superman4164: checks
*** RIVER *** [9d 2d 3d 7d] [4s]
tapouttazz9: checks
Superman4164: checks
*** SHOW DOWN ***
tapouttazz9: shows [Ks As] (high card Ace)
Superman4164: shows [Ah Kc] (high card Ace)
tapouttazz9 collected $0.12 from pot
Superman4164 collected $0.11 from pot
*** SUMMARY ***
Total pot $0.24 | Rake $0.01
Board [9d 2d 3d 7d 4s]
Seat 1: pinnocio (small blind) folded on the Flop
Seat 2: superiorsl (big blind) folded on the Flop
Seat 3: tapouttazz9 showed [Ks As] and won ($0.12) with high card Ace
Seat 4: Superman4164 showed [Ah Kc] and won ($0.11) with high card Ace
Seat 5: Steelfox7 (button) folded before Flop (didn't bet)


PokerStars Hand #152942789663:  Hold'em No Limit ($0.01/$0.02 USD) - 2016/05/16 17:11:09 ET
Table 'Draco' 6-max Seat #2 is the button
Seat 2: superiorsl ($1.12 in chips)
Seat 3: tapouttazz9 ($3 in chips)
Seat 4: Superman4164 ($3.66 in chips)
Seat 5: Steelfox7 ($2.22 in chips)
Seat 6: colinsdad16 ($1.79 in chips)
tapouttazz9: posts small blind $0.01
Superman4164: posts big blind $0.02
colinsdad16: posts small & big blinds $0.03
*** HOLE CARDS ***
Dealt to tapouttazz9 [Ad Qc]
Steelfox7: folds
colinsdad16: checks
superiorsl: raises $0.08 to $0.10
tapouttazz9: calls $0.09
Superman4164: folds
colinsdad16: folds
*** FLOP *** [7h 8s 4s]
tapouttazz9: bets $0.18
superiorsl: calls $0.18
*** TURN *** [7h 8s 4s] [Qh]
tapouttazz9: bets $2.72 and is all-in
superiorsl: folds
Uncalled bet ($2.72) returned to tapouttazz9
tapouttazz9 collected $0.58 from pot
tapouttazz9: doesn't show hand
*** SUMMARY ***
Total pot $0.61 | Rake $0.03
Board [7h 8s 4s Qh]
Seat 2: superiorsl (button) folded on the Turn
Seat 3: tapouttazz9 (small blind) collected ($0.58)
Seat 4: Superman4164 (big blind) folded before Flop
Seat 5: Steelfox7 folded before Flop (didn't bet)
Seat 6: colinsdad16 folded before Flop


PokerStars Hand #152942789836:  Hold'em No Limit ($0.01/$0.02 USD) - 2016/05/16 17:12:12 ET
Table 'Draco' 6-max Seat #3 is the button
Seat 2: superiorsl ($0.84 in chips)
Seat 3: tapouttazz9 ($3.30 in chips)
Seat 4: Superman4164 ($3.64 in chips)
Seat 5: Steelfox7 ($2.22 in chips)
Seat 6: colinsdad16 ($1.76 in chips)
Superman4164: posts small blind $0.01
Steelfox7: posts big blind $0.02
*** HOLE CARDS ***
Dealt to tapouttazz9 [2c Td]
colinsdad16: folds
superiorsl: folds
tapouttazz9: folds
Superman4164: calls $0.01
Steelfox7: raises $0.04 to $0.06
Superman4164: calls $0.04
*** FLOP *** [Qh 2h Jh]
Superman4164: checks
Steelfox7: bets $0.08
Superman4164: folds
Uncalled bet ($0.08) returned to Steelfox7
Steelfox7 collected $0.11 from pot
Steelfox7: doesn't show hand
*** SUMMARY ***
Total pot $0.12 | Rake $0.01
Board [Qh 2h Jh]
Seat 2: superiorsl folded before Flop (didn't bet)
Seat 3: tapouttazz9 (button) folded before Flop (didn't bet)
Seat 4: Superman4164 (small blind) folded on the Flop
Seat 5: Steelfox7 (big blind) collected ($0.11)
Seat 6: colinsdad16 folded before Flop (didn't bet)


PokerStars Hand #152942789932:  Hold'em No Limit ($0.01/$0.02 USD) - 2016/05/16 17:12:49 ET
Table 'Draco' 6-max Seat #4 is the button
Seat 2: superiorsl ($0.84 in chips)
Seat 3: tapouttazz9 ($3.30 in chips)
Seat 4: Superman4164 ($3.58 in chips)
Seat 5: Steelfox7 ($2.27 in chips)
Seat 6: colinsdad16 ($1.76 in chips)
Steelfox7: posts small blind $0.01
colinsdad16: posts big blind $0.02
*** HOLE CARDS ***
Dealt to tapouttazz9 [7c 4h]
superiorsl: calls $0.02
tapouttazz9: folds
Superman4164: calls $0.02
Steelfox7: folds
colinsdad16: checks
*** FLOP *** [Kh Js 5s]
colinsdad16: checks
superiorsl: checks
Superman4164: checks
*** TURN *** [Kh Js 5s] [2h]
colinsdad16: checks
superiorsl: bets $0.07
Superman4164: folds
colinsdad16: folds
Uncalled bet ($0.07) returned to superiorsl
superiorsl collected $0.07 from pot
superiorsl: doesn't show hand
*** SUMMARY ***
Total pot $0.07 | Rake $0
Board [Kh Js 5s 2h]
Seat 2: superiorsl collected ($0.07)
Seat 3: tapouttazz9 folded before Flop (didn't bet)
Seat 4: Superman4164 (button) folded on the Turn
Seat 5: Steelfox7 (small blind) folded before Flop
Seat 6: colinsdad16 (big blind) folded on the Turn


PokerStars Hand #152943045563:  Hold'em No Limit ($0.01/$0.02 USD) - 2016/05/16 17:13:36 ET
Table 'Draco' 6-max Seat #5 is the button
Seat 2: superiorsl ($0.89 in chips)
Seat 3: tapouttazz9 ($3.30 in chips)
Seat 4: Superman4164 ($3.56 in chips)
Seat 5: Steelfox7 ($2.26 in chips)
Seat 6: colinsdad16 ($1.74 in chips)
colinsdad16: posts small blind $0.01
superiorsl: posts big blind $0.02
*** HOLE CARDS ***
Dealt to tapouttazz9 [8c 5d]
tapouttazz9: folds
Superman4164: raises $0.02 to $0.04
Steelfox7: raises $0.08 to $0.12
colinsdad16: folds
superiorsl: folds
Superman4164: calls $0.08
*** FLOP *** [Ks 3h 4d]
Superman4164: checks
Steelfox7: bets $0.18
Superman4164: folds
Uncalled bet ($0.18) returned to Steelfox7
Steelfox7 collected $0.26 from pot
Steelfox7: doesn't show hand
*** SUMMARY ***
Total pot $0.27 | Rake $0.01
Board [Ks 3h 4d]
Seat 2: superiorsl (big blind) folded before Flop
Seat 3: tapouttazz9 folded before Flop (didn't bet)
Seat 4: Superman4164 folded on the Flop
Seat 5: Steelfox7 (button) collected ($0.26)
Seat 6: colinsdad16 (small blind) folded before Flop


PokerStars Hand #152943045704:  Hold'em No Limit ($0.01/$0.02 USD) - 2016/05/16 17:14:25 ET
Table 'Draco' 6-max Seat #6 is the button
Seat 2: superiorsl ($0.87 in chips)
Seat 3: tapouttazz9 ($3.30 in chips)
Seat 4: Superman4164 ($3.44 in chips)
Seat 5: Steelfox7 ($2.40 in chips)
Seat 6: colinsdad16 ($1.73 in chips)
superiorsl: posts small blind $0.01
tapouttazz9: posts big blind $0.02
*** HOLE CARDS ***
Dealt to tapouttazz9 [6c 5h]
Superman4164: folds
Steelfox7: folds
colinsdad16: raises $0.05 to $0.07
superiorsl: folds
tapouttazz9: folds
Uncalled bet ($0.05) returned to colinsdad16
colinsdad16 collected $0.05 from pot
colinsdad16: doesn't show hand
*** SUMMARY ***
Total pot $0.05 | Rake $0
Seat 2: superiorsl (small blind) folded before Flop
Seat 3: tapouttazz9 (big blind) folded before Flop
Seat 4: Superman4164 folded before Flop (didn't bet)
Seat 5: Steelfox7 folded before Flop (didn't bet)
Seat 6: colinsdad16 (button) collected ($0.05)


PokerStars Hand #152943045776:  Hold'em No Limit ($0.01/$0.02 USD) - 2016/05/16 17:14:51 ET
Table 'Draco' 6-max Seat #2 is the button
Seat 2: superiorsl ($0.86 in chips)
Seat 3: tapouttazz9 ($3.28 in chips)
Seat 4: Superman4164 ($3.44 in chips)
Seat 5: Steelfox7 ($2.40 in chips)
Seat 6: colinsdad16 ($1.76 in chips)
tapouttazz9: posts small blind $0.01
Superman4164: posts big blind $0.02
*** HOLE CARDS ***
Dealt to tapouttazz9 [5c Qd]
Steelfox7: folds
colinsdad16: folds
superiorsl: calls $0.02
tapouttazz9: folds
Superman4164: checks
*** FLOP *** [4c 3d As]
Superman4164: checks
superiorsl: bets $0.02
Superman4164: calls $0.02
*** TURN *** [4c 3d As] [5s]
Superman4164: checks
superiorsl: bets $0.04
Superman4164: calls $0.04
*** RIVER *** [4c 3d As 5s] [Jh]
Superman4164: checks
superiorsl: bets $0.07
Superman4164: folds
Uncalled bet ($0.07) returned to superiorsl
superiorsl collected $0.16 from pot
superiorsl: doesn't show hand
*** SUMMARY ***
Total pot $0.17 | Rake $0.01
Board [4c 3d As 5s Jh]
Seat 2: superiorsl (button) collected ($0.16)
Seat 3: tapouttazz9 (small blind) folded before Flop
Seat 4: Superman4164 (big blind) folded on the River
Seat 5: Steelfox7 folded before Flop (didn't bet)
Seat 6: colinsdad16 folded before Flop (didn't bet)


PokerStars Hand #152943045919:  Hold'em No Limit ($0.01/$0.02 USD) - 2016/05/16 17:15:39 ET
Table 'Draco' 6-max Seat #3 is the button
Seat 2: superiorsl ($0.94 in chips)
Seat 3: tapouttazz9 ($3.27 in chips)
Seat 4: Superman4164 ($3.36 in chips)
Seat 5: Steelfox7 ($2.40 in chips)
Seat 6: colinsdad16 ($1.76 in chips)
Superman4164: posts small blind $0.01
Steelfox7: posts big blind $0.02
*** HOLE CARDS ***
Dealt to tapouttazz9 [4s Jh]
colinsdad16: folds
superiorsl: calls $0.02
tapouttazz9: folds
Superman4164: calls $0.01
Steelfox7: checks
*** FLOP *** [2d 8c 7h]
Superman4164: bets $0.02
Steelfox7: folds
superiorsl: calls $0.02
*** TURN *** [2d 8c 7h] [Kc]
Superman4164: bets $0.02
superiorsl: raises $0.07 to $0.09
Superman4164: calls $0.07
*** RIVER *** [2d 8c 7h Kc] [6h]
Superman4164: checks
superiorsl: bets $0.81 and is all-in
Superman4164: folds
Uncalled bet ($0.81) returned to superiorsl
superiorsl collected $0.27 from pot
superiorsl: doesn't show hand
*** SUMMARY ***
Total pot $0.28 | Rake $0.01
Board [2d 8c 7h Kc 6h]
Seat 2: superiorsl collected ($0.27)
Seat 3: tapouttazz9 (button) folded before Flop (didn't bet)
Seat 4: Superman4164 (small blind) folded on the River
Seat 5: Steelfox7 (big blind) folded on the Flop
Seat 6: colinsdad16 folded before Flop (didn't bet)


PokerStars Hand #152943046078:  Hold'em No Limit ($0.01/$0.02 USD) - 2016/05/16 17:16:31 ET
Table 'Draco' 6-max Seat #4 is the button
Seat 2: superiorsl ($1.08 in chips)
Seat 3: tapouttazz9 ($3.27 in chips)
Seat 4: Superman4164 ($3.23 in chips)
Seat 5: Steelfox7 ($2.38 in chips)
Seat 6: colinsdad16 ($1.76 in chips)
Steelfox7: posts small blind $0.01
colinsdad16: posts big blind $0.02
*** HOLE CARDS ***
Dealt to tapouttazz9 [Tc Ad]
superiorsl: calls $0.02
tapouttazz9: raises $0.04 to $0.06
Superman4164: folds
Steelfox7: folds
colinsdad16: folds
superiorsl: calls $0.04
*** FLOP *** [Qh 3c 2h]
superiorsl: checks
tapouttazz9: bets $0.07
superiorsl: calls $0.07
*** TURN *** [Qh 3c 2h] [Jc]
superiorsl: checks
tapouttazz9: checks
*** RIVER *** [Qh 3c 2h Jc] [4s]
superiorsl: checks
tapouttazz9: checks
*** SHOW DOWN ***
superiorsl: shows [Ks 5d] (high card King)
tapouttazz9: shows [Tc Ad] (high card Ace)
tapouttazz9 collected $0.28 from pot
*** SUMMARY ***
Total pot $0.29 | Rake $0.01
Board [Qh 3c 2h Jc 4s]
Seat 2: superiorsl showed [Ks 5d] and lost with high card King
Seat 3: tapouttazz9 showed [Tc Ad] and won ($0.28) with high card Ace
Seat 4: Superman4164 (button) folded before Flop (didn't bet)
Seat 5: Steelfox7 (small blind) folded before Flop
Seat 6: colinsdad16 (big blind) folded before Flop


PokerStars Hand #152943046182:  Hold'em No Limit ($0.01/$0.02 USD) - 2016/05/16 17:17:06 ET
Table 'Draco' 6-max Seat #5 is the button
Seat 2: superiorsl ($0.95 in chips)
Seat 3: tapouttazz9 ($3.42 in chips)
Seat 4: Superman4164 ($3.23 in chips)
Seat 5: Steelfox7 ($2.37 in chips)
Seat 6: colinsdad16 ($1.74 in chips)
colinsdad16: posts small blind $0.01
superiorsl: posts big blind $0.02
*** HOLE CARDS ***
Dealt to tapouttazz9 [Qc Kd]
tapouttazz9: raises $0.04 to $0.06
Superman4164: folds
Steelfox7: folds
colinsdad16: folds
superiorsl: folds
Uncalled bet ($0.04) returned to tapouttazz9
tapouttazz9 collected $0.05 from pot
tapouttazz9: doesn't show hand
*** SUMMARY ***
Total pot $0.05 | Rake $0
Seat 2: superiorsl (big blind) folded before Flop
Seat 3: tapouttazz9 collected ($0.05)
Seat 4: Superman4164 folded before Flop (didn't bet)
Seat 5: Steelfox7 (button) folded before Flop (didn't bet)
Seat 6: colinsdad16 (small blind) folded before Flop


PokerStars Hand #152943046219:  Hold'em No Limit ($0.01/$0.02 USD) - 2016/05/16 17:17:19 ET
Table 'Draco' 6-max Seat #6 is the button
Seat 2: superiorsl ($0.93 in chips)
Seat 3: tapouttazz9 ($3.45 in chips)
Seat 4: Superman4164 ($3.23 in chips)
Seat 5: Steelfox7 ($2.37 in chips)
Seat 6: colinsdad16 ($1.73 in chips)
superiorsl: posts small blind $0.01
tapouttazz9: posts big blind $0.02
*** HOLE CARDS ***
Dealt to tapouttazz9 [7d 7h]
Superman4164: calls $0.02
Steelfox7: raises $0.06 to $0.08
colinsdad16: calls $0.08
superiorsl: folds
tapouttazz9: calls $0.06
Superman4164: calls $0.06
*** FLOP *** [4h 8h 7c]
tapouttazz9: bets $0.24
Superman4164: folds
Steelfox7: folds
colinsdad16: folds
Uncalled bet ($0.24) returned to tapouttazz9
tapouttazz9 collected $0.32 from pot
tapouttazz9: doesn't show hand
*** SUMMARY ***
Total pot $0.33 | Rake $0.01
Board [4h 8h 7c]
Seat 2: superiorsl (small blind) folded before Flop
Seat 3: tapouttazz9 (big blind) collected ($0.32)
Seat 4: Superman4164 folded on the Flop
Seat 5: Steelfox7 folded on the Flop
Seat 6: colinsdad16 (button) folded on the Flop


PokerStars Hand #152943046324:  Hold'em No Limit ($0.01/$0.02 USD) - 2016/05/16 17:17:55 ET
Table 'Draco' 6-max Seat #2 is the button
Seat 2: superiorsl ($0.92 in chips)
Seat 3: tapouttazz9 ($3.69 in chips)
Seat 4: Superman4164 ($3.15 in chips)
Seat 5: Steelfox7 ($2.29 in chips)
Seat 6: colinsdad16 ($1.65 in chips)
tapouttazz9: posts small blind $0.01
Superman4164: posts big blind $0.02
*** HOLE CARDS ***
Dealt to tapouttazz9 [Kc 7s]
Steelfox7: folds
colinsdad16: folds
superiorsl: folds
tapouttazz9: folds
Uncalled bet ($0.01) returned to Superman4164
Superman4164 collected $0.02 from pot
Superman4164: doesn't show hand
*** SUMMARY ***
Total pot $0.02 | Rake $0
Seat 2: superiorsl (button) folded before Flop (didn't bet)
Seat 3: tapouttazz9 (small blind) folded before Flop
Seat 4: Superman4164 (big blind) collected ($0.02)
Seat 5: Steelfox7 folded before Flop (didn't bet)
Seat 6: colinsdad16 folded before Flop (didn't bet)


PokerStars Hand #152943046373:  Hold'em No Limit ($0.01/$0.02 USD) - 2016/05/16 17:18:08 ET
Table 'Draco' 6-max Seat #3 is the button
Seat 2: superiorsl ($0.92 in chips)
Seat 3: tapouttazz9 ($3.68 in chips)
Seat 4: Superman4164 ($3.16 in chips)
Seat 5: Steelfox7 ($2.29 in chips)
Seat 6: colinsdad16 ($1.65 in chips)
Superman4164: posts small blind $0.01
Steelfox7: posts big blind $0.02
*** HOLE CARDS ***
Dealt to tapouttazz9 [2d 7h]
colinsdad16: calls $0.02
superiorsl: calls $0.02
tapouttazz9: folds
Superman4164: calls $0.01
Steelfox7: checks
*** FLOP *** [Ah 3c Qd]
Superman4164: checks
Steelfox7: checks
colinsdad16: checks
superiorsl: checks
*** TURN *** [Ah 3c Qd] [3d]
Superman4164: bets $0.02
Steelfox7: folds
colinsdad16: calls $0.02
superiorsl: calls $0.02
*** RIVER *** [Ah 3c Qd 3d] [8c]
Superman4164: bets $0.02
colinsdad16: folds
superiorsl: calls $0.02
*** SHOW DOWN ***
Superman4164: shows [Js Kh] (a pair of Threes)
superiorsl: shows [9h Qc] (two pair, Queens and Threes)
superiorsl collected $0.17 from pot
*** SUMMARY ***
Total pot $0.18 | Rake $0.01
Board [Ah 3c Qd 3d 8c]
Seat 2: superiorsl showed [9h Qc] and won ($0.17) with two pair, Queens and Threes
Seat 3: tapouttazz9 (button) folded before Flop (didn't bet)
Seat 4: Superman4164 (small blind) showed [Js Kh] and lost with a pair of Threes
Seat 5: Steelfox7 (big blind) folded on the Turn
Seat 6: colinsdad16 folded on the River


PokerStars Hand #152943046541:  Hold'em No Limit ($0.01/$0.02 USD) - 2016/05/16 17:19:10 ET
Table 'Draco' 6-max Seat #4 is the button
Seat 2: superiorsl ($1.03 in chips)
Seat 3: tapouttazz9 ($3.68 in chips)
Seat 4: Superman4164 ($3.10 in chips)
Seat 5: Steelfox7 ($2.27 in chips)
Seat 6: colinsdad16 ($1.61 in chips)
Steelfox7: posts small blind $0.01
colinsdad16: posts big blind $0.02
*** HOLE CARDS ***
Dealt to tapouttazz9 [Th 8h]
superiorsl: folds
tapouttazz9: folds
Superman4164: raises $0.02 to $0.04
Steelfox7: folds
colinsdad16: calls $0.02
*** FLOP *** [2c Ah 4c]
colinsdad16: checks
Superman4164: bets $0.02
colinsdad16: calls $0.02
*** TURN *** [2c Ah 4c] [2h]
colinsdad16: checks
Superman4164: bets $0.10
colinsdad16: raises $0.16 to $0.26
Superman4164: calls $0.16
*** RIVER *** [2c Ah 4c 2h] [3c]
colinsdad16: bets $0.62
Superman4164: folds
Uncalled bet ($0.62) returned to colinsdad16
colinsdad16 collected $0.62 from pot
colinsdad16: doesn't show hand
*** SUMMARY ***
Total pot $0.65 | Rake $0.03
Board [2c Ah 4c 2h 3c]
Seat 2: superiorsl folded before Flop (didn't bet)
Seat 3: tapouttazz9 folded before Flop (didn't bet)
Seat 4: Superman4164 (button) folded on the River
Seat 5: Steelfox7 (small blind) folded before Flop
Seat 6: colinsdad16 (big blind) collected ($0.62)


PokerStars Hand #152943046716:  Hold'em No Limit ($0.01/$0.02 USD) - 2016/05/16 17:20:05 ET
Table 'Draco' 6-max Seat #5 is the button
Seat 2: superiorsl ($1.03 in chips)
Seat 3: tapouttazz9 ($3.68 in chips)
Seat 4: Superman4164 ($2.78 in chips)
Seat 5: Steelfox7 ($2.26 in chips)
Seat 6: colinsdad16 ($1.91 in chips)
colinsdad16: posts small blind $0.01
superiorsl: posts big blind $0.02
*** HOLE CARDS ***
Dealt to tapouttazz9 [Jc Js]
tapouttazz9: raises $0.04 to $0.06
Superman4164: folds
Steelfox7: folds
colinsdad16: calls $0.05
Comeback609 joins the table at seat #1
superiorsl: folds
*** FLOP *** [Kh 9d Th]
colinsdad16: checks
tapouttazz9: checks
*** TURN *** [Kh 9d Th] [Td]
colinsdad16: checks
tapouttazz9: checks
*** RIVER *** [Kh 9d Th Td] [2c]
colinsdad16: bets $0.02
tapouttazz9: calls $0.02
*** SHOW DOWN ***
colinsdad16: shows [6c 6h] (two pair, Tens and Sixes)
tapouttazz9: shows [Jc Js] (two pair, Jacks and Tens)
tapouttazz9 collected $0.17 from pot
*** SUMMARY ***
Total pot $0.18 | Rake $0.01
Board [Kh 9d Th Td 2c]
Seat 2: superiorsl (big blind) folded before Flop
Seat 3: tapouttazz9 showed [Jc Js] and won ($0.17) with two pair, Jacks and Tens
Seat 4: Superman4164 folded before Flop (didn't bet)
Seat 5: Steelfox7 (button) folded before Flop (didn't bet)
Seat 6: colinsdad16 (small blind) showed [6c 6h] and lost with two pair, Tens and Sixes


PokerStars Hand #152943046830:  Hold'em No Limit ($0.01/$0.02 USD) - 2016/05/16 17:20:40 ET
Table 'Draco' 6-max Seat #6 is the button
Seat 2: superiorsl ($1.01 in chips)
Seat 3: tapouttazz9 ($3.77 in chips)
Seat 4: Superman4164 ($2.78 in chips)
Seat 5: Steelfox7 ($2.26 in chips)
Seat 6: colinsdad16 ($1.83 in chips)
Comeback609 will be allowed to play after the button
superiorsl: posts small blind $0.01
tapouttazz9: posts big blind $0.02
*** HOLE CARDS ***
Dealt to tapouttazz9 [Jh 3d]
Superman4164: calls $0.02
Steelfox7: folds
colinsdad16: calls $0.02
superiorsl: calls $0.01
tapouttazz9: checks
*** FLOP *** [6h Ts 9d]
superiorsl: checks
tapouttazz9: checks
Superman4164: checks
colinsdad16: bets $0.08
superiorsl: folds
tapouttazz9: folds
Superman4164: folds
Uncalled bet ($0.08) returned to colinsdad16
colinsdad16 collected $0.08 from pot
colinsdad16: doesn't show hand
*** SUMMARY ***
Total pot $0.08 | Rake $0
Board [6h Ts 9d]
Seat 2: superiorsl (small blind) folded on the Flop
Seat 3: tapouttazz9 (big blind) folded on the Flop
Seat 4: Superman4164 folded on the Flop
Seat 5: Steelfox7 folded before Flop (didn't bet)
Seat 6: colinsdad16 (button) collected ($0.08)


PokerStars Hand #152943046977:  Hold'em No Limit ($0.01/$0.02 USD) - 2016/05/16 17:21:24 ET
Table 'Draco' 6-max Seat #2 is the button
Seat 1: Comeback609 ($2 in chips)
Seat 2: superiorsl ($0.99 in chips)
Seat 3: tapouttazz9 ($3.75 in chips)
Seat 4: Superman4164 ($2.76 in chips)
Seat 5: Steelfox7 ($2.26 in chips)
Seat 6: colinsdad16 ($1.89 in chips)
tapouttazz9: posts small blind $0.01
Superman4164: posts big blind $0.02
Comeback609: posts big blind $0.02
*** HOLE CARDS ***
Dealt to tapouttazz9 [Ac Kd]
Steelfox7: raises $0.06 to $0.08
colinsdad16: folds
Comeback609: folds
superiorsl: folds
tapouttazz9: calls $0.07
Superman4164: folds
*** FLOP *** [5s 4d Jc]
tapouttazz9: bets $0.09
Steelfox7: calls $0.09
*** TURN *** [5s 4d Jc] [5h]
tapouttazz9: bets $0.18
Steelfox7: folds
Uncalled bet ($0.18) returned to tapouttazz9
tapouttazz9 collected $0.36 from pot
tapouttazz9: doesn't show hand
*** SUMMARY ***
Total pot $0.38 | Rake $0.02
Board [5s 4d Jc 5h]
Seat 1: Comeback609 folded before Flop
Seat 2: superiorsl (button) folded before Flop (didn't bet)
Seat 3: tapouttazz9 (small blind) collected ($0.36)
Seat 4: Superman4164 (big blind) folded before Flop
Seat 5: Steelfox7 folded on the Turn
Seat 6: colinsdad16 folded before Flop (didn't bet)


PokerStars Hand #152943047144:  Hold'em No Limit ($0.01/$0.02 USD) - 2016/05/16 17:22:23 ET
Table 'Draco' 6-max Seat #3 is the button
Seat 1: Comeback609 ($1.98 in chips)
Seat 2: superiorsl ($0.99 in chips)
Seat 3: tapouttazz9 ($3.94 in chips)
Seat 4: Superman4164 ($2.74 in chips)
Seat 5: Steelfox7 ($2.09 in chips)
Seat 6: colinsdad16 ($1.89 in chips)
Superman4164: posts small blind $0.01
Steelfox7: posts big blind $0.02
*** HOLE CARDS ***
Dealt to tapouttazz9 [Kc Ad]
colinsdad16: raises $0.02 to $0.04
Comeback609: folds
superiorsl: folds
tapouttazz9: calls $0.04
Superman4164: calls $0.03
Steelfox7: calls $0.02
*** FLOP *** [2h 7h Tc]
Superman4164: checks
Steelfox7: checks
colinsdad16: bets $0.06
tapouttazz9: calls $0.06
Superman4164: calls $0.06
Steelfox7: folds
*** TURN *** [2h 7h Tc] [Qc]
Superman4164: checks
colinsdad16: bets $0.16
tapouttazz9: calls $0.16
Superman4164: calls $0.16
*** RIVER *** [2h 7h Tc Qc] [6c]
Superman4164: checks
colinsdad16: bets $0.40
tapouttazz9: folds
Superman4164: folds
Uncalled bet ($0.40) returned to colinsdad16
colinsdad16 collected $0.78 from pot
colinsdad16: doesn't show hand
*** SUMMARY ***
Total pot $0.82 | Rake $0.04
Board [2h 7h Tc Qc 6c]
Seat 1: Comeback609 folded before Flop (didn't bet)
Seat 2: superiorsl folded before Flop (didn't bet)
Seat 3: tapouttazz9 (button) folded on the River
Seat 4: Superman4164 (small blind) folded on the River
Seat 5: Steelfox7 (big blind) folded on the Flop
Seat 6: colinsdad16 collected ($0.78)


PokerStars Hand #152943047453:  Hold'em No Limit ($0.01/$0.02 USD) - 2016/05/16 17:24:05 ET
Table 'Draco' 6-max Seat #4 is the button
Seat 1: Comeback609 ($1.98 in chips)
Seat 2: superiorsl ($0.99 in chips)
Seat 3: tapouttazz9 ($3.68 in chips)
Seat 4: Superman4164 ($2.48 in chips)
Seat 5: Steelfox7 ($2.05 in chips)
Seat 6: colinsdad16 ($2.41 in chips)
Steelfox7: posts small blind $0.01
colinsdad16: posts big blind $0.02
*** HOLE CARDS ***
Dealt to tapouttazz9 [9d 2c]
Comeback609: folds
superiorsl: folds
tapouttazz9: folds
Superman4164: calls $0.02
Steelfox7: folds
colinsdad16: raises $0.06 to $0.08
Superman4164: calls $0.06
*** FLOP *** [8h 3c 9h]
colinsdad16: bets $0.20
Superman4164: folds
Uncalled bet ($0.20) returned to colinsdad16
colinsdad16 collected $0.16 from pot
colinsdad16: doesn't show hand
*** SUMMARY ***
Total pot $0.17 | Rake $0.01
Board [8h 3c 9h]
Seat 1: Comeback609 folded before Flop (didn't bet)
Seat 2: superiorsl folded before Flop (didn't bet)
Seat 3: tapouttazz9 folded before Flop (didn't bet)
Seat 4: Superman4164 (button) folded on the Flop
Seat 5: Steelfox7 (small blind) folded before Flop
Seat 6: colinsdad16 (big blind) collected ($0.16)


PokerStars Hand #152943047537:  Hold'em No Limit ($0.01/$0.02 USD) - 2016/05/16 17:24:33 ET
Table 'Draco' 6-max Seat #5 is the button
Seat 1: Comeback609 ($1.98 in chips)
Seat 2: superiorsl ($0.99 in chips)
Seat 3: tapouttazz9 ($3.68 in chips)
Seat 4: Superman4164 ($2.40 in chips)
Seat 5: Steelfox7 ($2.04 in chips)
Seat 6: colinsdad16 ($2.49 in chips)
colinsdad16: posts small blind $0.01
Comeback609: posts big blind $0.02
*** HOLE CARDS ***
Dealt to tapouttazz9 [8s 2d]
superiorsl: calls $0.02
tapouttazz9: folds
Superman4164: calls $0.02
Steelfox7: folds
colinsdad16: calls $0.01
Comeback609: checks
*** FLOP *** [3c 4h 9c]
colinsdad16: checks
Comeback609: checks
superiorsl: checks
Superman4164: bets $0.06
colinsdad16: folds
Comeback609: folds
superiorsl: calls $0.06
*** TURN *** [3c 4h 9c] [Kc]
superiorsl: checks
Superman4164: bets $0.08
superiorsl: calls $0.08
*** RIVER *** [3c 4h 9c Kc] [Js]
superiorsl: checks
Superman4164: checks
*** SHOW DOWN ***
superiorsl: shows [2c 2s] (a pair of Deuces)
Superman4164: shows [Kh 9s] (two pair, Kings and Nines)
Superman4164 collected $0.34 from pot
*** SUMMARY ***
Total pot $0.36 | Rake $0.02
Board [3c 4h 9c Kc Js]
Seat 1: Comeback609 (big blind) folded on the Flop
Seat 2: superiorsl showed [2c 2s] and lost with a pair of Deuces
Seat 3: tapouttazz9 folded before Flop (didn't bet)
Seat 4: Superman4164 showed [Kh 9s] and won ($0.34) with two pair, Kings and Nines
Seat 5: Steelfox7 (button) folded before Flop (didn't bet)
Seat 6: colinsdad16 (small blind) folded on the Flop


PokerStars Hand #152943047707:  Hold'em No Limit ($0.01/$0.02 USD) - 2016/05/16 17:25:26 ET
Table 'Draco' 6-max Seat #6 is the button
Seat 1: Comeback609 ($1.96 in chips)
Seat 2: superiorsl ($0.83 in chips)
Seat 3: tapouttazz9 ($3.68 in chips)
Seat 4: Superman4164 ($2.58 in chips)
Seat 5: Steelfox7 ($2.04 in chips)
Seat 6: colinsdad16 ($2.47 in chips)
Comeback609: posts small blind $0.01
superiorsl: posts big blind $0.02
*** HOLE CARDS ***
Dealt to tapouttazz9 [Th 8h]
tapouttazz9: folds
Superman4164: folds
Steelfox7: folds
colinsdad16: folds
Comeback609: raises $0.04 to $0.06
superiorsl: folds
Uncalled bet ($0.04) returned to Comeback609
Comeback609 collected $0.04 from pot
Comeback609: doesn't show hand
*** SUMMARY ***
Total pot $0.04 | Rake $0
Seat 1: Comeback609 (small blind) collected ($0.04)
Seat 2: superiorsl (big blind) folded before Flop
Seat 3: tapouttazz9 folded before Flop (didn't bet)
Seat 4: Superman4164 folded before Flop (didn't bet)
Seat 5: Steelfox7 folded before Flop (didn't bet)
Seat 6: colinsdad16 (button) folded before Flop (didn't bet)


PokerStars Hand #152943047762:  Hold'em No Limit ($0.01/$0.02 USD) - 2016/05/16 17:25:43 ET
Table 'Draco' 6-max Seat #1 is the button
Seat 1: Comeback609 ($1.98 in chips)
Seat 2: superiorsl ($0.81 in chips)
Seat 3: tapouttazz9 ($3.68 in chips)
Seat 4: Superman4164 ($2.58 in chips)
Seat 5: Steelfox7 ($2.04 in chips)
Seat 6: colinsdad16 ($2.47 in chips)
superiorsl: posts small blind $0.01
tapouttazz9: posts big blind $0.02
*** HOLE CARDS ***
Dealt to tapouttazz9 [2d 9s]
Superman4164: raises $0.02 to $0.04
Steelfox7: folds
colinsdad16: calls $0.04
Comeback609: folds
superiorsl: raises $0.14 to $0.18
tapouttazz9: folds
Superman4164: calls $0.14
colinsdad16: calls $0.14
*** FLOP *** [Kh 9d 7c]
superiorsl: bets $0.63 and is all-in
Superman4164: folds
colinsdad16: calls $0.63
*** TURN *** [Kh 9d 7c] [Tc]
*** RIVER *** [Kh 9d 7c Tc] [As]
*** SHOW DOWN ***
superiorsl: shows [Ad Qd] (a pair of Aces)
colinsdad16: shows [Ks Qs] (a pair of Kings)
superiorsl collected $1.74 from pot
*** SUMMARY ***
Total pot $1.82 | Rake $0.08
Board [Kh 9d 7c Tc As]
Seat 1: Comeback609 (button) folded before Flop (didn't bet)
Seat 2: superiorsl (small blind) showed [Ad Qd] and won ($1.74) with a pair of Aces
Seat 3: tapouttazz9 (big blind) folded before Flop
Seat 4: Superman4164 folded on the Flop
Seat 5: Steelfox7 folded before Flop (didn't bet)
Seat 6: colinsdad16 showed [Ks Qs] and lost with a pair of Kings


PokerStars Hand #152943047926:  Hold'em No Limit ($0.01/$0.02 USD) - 2016/05/16 17:26:31 ET
Table 'Draco' 6-max Seat #2 is the button
Seat 1: Comeback609 ($1.98 in chips)
Seat 2: superiorsl ($1.74 in chips)
Seat 3: tapouttazz9 ($3.66 in chips)
Seat 4: Superman4164 ($2.40 in chips)
Seat 5: Steelfox7 ($2.04 in chips)
Seat 6: colinsdad16 ($1.66 in chips)
tapouttazz9: posts small blind $0.01
Superman4164: posts big blind $0.02
*** HOLE CARDS ***
Dealt to tapouttazz9 [6s 7s]
Steelfox7: folds
colinsdad16: folds
Comeback609: raises $0.04 to $0.06
superiorsl: folds
tapouttazz9: folds
Superman4164: folds
Uncalled bet ($0.04) returned to Comeback609
Comeback609 collected $0.05 from pot
Comeback609: doesn't show hand
*** SUMMARY ***
Total pot $0.05 | Rake $0
Seat 1: Comeback609 collected ($0.05)
Seat 2: superiorsl (button) folded before Flop (didn't bet)
Seat 3: tapouttazz9 (small blind) folded before Flop
Seat 4: Superman4164 (big blind) folded before Flop
Seat 5: Steelfox7 folded before Flop (didn't bet)
Seat 6: colinsdad16 folded before Flop (didn't bet)


PokerStars Hand #152943047983:  Hold'em No Limit ($0.01/$0.02 USD) - 2016/05/16 17:26:50 ET
Table 'Draco' 6-max Seat #3 is the button
Seat 1: Comeback609 ($2.01 in chips)
Seat 2: superiorsl ($1.74 in chips)
Seat 3: tapouttazz9 ($3.65 in chips)
Seat 4: Superman4164 ($2.38 in chips)
Seat 5: Steelfox7 ($2.04 in chips)
Seat 6: colinsdad16 ($1.66 in chips)
Superman4164: posts small blind $0.01
Steelfox7: posts big blind $0.02
*** HOLE CARDS ***
Dealt to tapouttazz9 [Td Ts]
colinsdad16: folds
Comeback609: calls $0.02
superiorsl: calls $0.02
tapouttazz9: raises $0.03 to $0.05
Superman4164: calls $0.04
Steelfox7: raises $0.13 to $0.18
Comeback609: folds
superiorsl: folds
tapouttazz9: calls $0.13
Superman4164: calls $0.13
*** FLOP *** [7c 3d Qs]
Superman4164: checks
Steelfox7: bets $0.20
tapouttazz9: calls $0.20
Superman4164: calls $0.20
*** TURN *** [7c 3d Qs] [5c]
Superman4164: checks
Steelfox7: bets $0.75
tapouttazz9: folds
Superman4164: folds
Uncalled bet ($0.75) returned to Steelfox7
Steelfox7 collected $1.13 from pot
Steelfox7: doesn't show hand
*** SUMMARY ***
Total pot $1.18 | Rake $0.05
Board [7c 3d Qs 5c]
Seat 1: Comeback609 folded before Flop
Seat 2: superiorsl folded before Flop
Seat 3: tapouttazz9 (button) folded on the Turn
Seat 4: Superman4164 (small blind) folded on the Turn
Seat 5: Steelfox7 (big blind) collected ($1.13)
Seat 6: colinsdad16 folded before Flop (didn't bet)


PokerStars Hand #152943048229:  Hold'em No Limit ($0.01/$0.02 USD) - 2016/05/16 17:28:07 ET
Table 'Draco' 6-max Seat #4 is the button
Seat 1: Comeback609 ($1.99 in chips)
Seat 2: superiorsl ($1.72 in chips)
Seat 3: tapouttazz9 ($3.27 in chips)
Seat 4: Superman4164 ($2 in chips)
Seat 5: Steelfox7 ($2.79 in chips)
Seat 6: colinsdad16 ($1.66 in chips)
Steelfox7: posts small blind $0.01
colinsdad16: posts big blind $0.02
*** HOLE CARDS ***
Dealt to tapouttazz9 [7h 9d]
Comeback609: folds
superiorsl: folds
tapouttazz9: folds
Superman4164: calls $0.02
Steelfox7: folds
colinsdad16: raises $0.02 to $0.04
Superman4164: calls $0.02
*** FLOP *** [5s Td Kd]
colinsdad16: checks
Superman4164: bets $0.06
colinsdad16: folds
Uncalled bet ($0.06) returned to Superman4164
Superman4164 collected $0.09 from pot
Superman4164: doesn't show hand
*** SUMMARY ***
Total pot $0.09 | Rake $0
Board [5s Td Kd]
Seat 1: Comeback609 folded before Flop (didn't bet)
Seat 2: superiorsl folded before Flop (didn't bet)
Seat 3: tapouttazz9 folded before Flop (didn't bet)
Seat 4: Superman4164 (button) collected ($0.09)
Seat 5: Steelfox7 (small blind) folded before Flop
Seat 6: colinsdad16 (big blind) folded on the Flop


PokerStars Hand #152943048514:  Hold'em No Limit ($0.01/$0.02 USD) - 2016/05/16 17:29:26 ET
Table 'Draco' 6-max Seat #5 is the button
Seat 1: Comeback609 ($1.99 in chips)
Seat 2: superiorsl ($1.72 in chips)
Seat 3: tapouttazz9 ($3.27 in chips)
Seat 4: Superman4164 ($2.05 in chips)
Seat 5: Steelfox7 ($2.78 in chips)
Seat 6: colinsdad16 ($1.62 in chips)
colinsdad16: posts small blind $0.01
Comeback609: posts big blind $0.02
*** HOLE CARDS ***
Dealt to tapouttazz9 [5d Ts]
superiorsl: calls $0.02
tapouttazz9: folds
Superman4164: folds
Steelfox7: raises $0.06 to $0.08
colinsdad16: folds
Comeback609: folds
superiorsl: calls $0.06
*** FLOP *** [Qd 6c 9d]
superiorsl: checks
Steelfox7: bets $0.10
superiorsl: calls $0.10
*** TURN *** [Qd 6c 9d] [8c]
superiorsl: checks
Steelfox7: checks
*** RIVER *** [Qd 6c 9d 8c] [8d]
superiorsl: checks
Steelfox7: bets $0.11
superiorsl: calls $0.11
*** SHOW DOWN ***
Steelfox7: shows [Jd 8s] (three of a kind, Eights)
superiorsl: mucks hand
Steelfox7 collected $0.58 from pot
*** SUMMARY ***
Total pot $0.61 | Rake $0.03
Board [Qd 6c 9d 8c 8d]
Seat 1: Comeback609 (big blind) folded before Flop
Seat 2: superiorsl mucked [Ad 3c]
Seat 3: tapouttazz9 folded before Flop (didn't bet)
Seat 4: Superman4164 folded before Flop (didn't bet)
Seat 5: Steelfox7 (button) showed [Jd 8s] and won ($0.58) with three of a kind, Eights
Seat 6: colinsdad16 (small blind) folded before Flop


PokerStars Hand #152501305824:  Hold'em No Limit ($0.01/$0.02 USD) - 2016/05/06 22:08:09 ET
Table 'Alcyone' 6-max Seat #5 is the button
Seat 1: tapouttazz9 ($2 in chips)
Seat 2: BMCG77 ($1.75 in chips)
Seat 3: JZappa ($1.90 in chips)
Seat 4: Ind1ctable ($4.05 in chips)
Seat 5: tattooed66 ($0.71 in chips)
Seat 6: slowrollerNJ ($0.87 in chips)
slowrollerNJ: posts small blind $0.01
tapouttazz9: posts big blind $0.02
*** HOLE CARDS ***
Dealt to tapouttazz9 [Ad 5s]
BMCG77: folds
JZappa: folds
Ind1ctable: raises $0.04 to $0.06
tattooed66: folds
slowrollerNJ: folds
tapouttazz9: folds
Uncalled bet ($0.04) returned to Ind1ctable
Ind1ctable collected $0.05 from pot
Ind1ctable: doesn't show hand
*** SUMMARY ***
Total pot $0.05 | Rake $0
Seat 1: tapouttazz9 (big blind) folded before Flop
Seat 2: BMCG77 folded before Flop (didn't bet)
Seat 3: JZappa folded before Flop (didn't bet)
Seat 4: Ind1ctable collected ($0.05)
Seat 5: tattooed66 (button) folded before Flop (didn't bet)
Seat 6: slowrollerNJ (small blind) folded before Flop


PokerStars Hand #152501305928:  Hold'em No Limit ($0.01/$0.02 USD) - 2016/05/06 22:08:25 ET
Table 'Alcyone' 6-max Seat #6 is the button
Seat 1: tapouttazz9 ($1.98 in chips)
Seat 2: BMCG77 ($1.75 in chips)
Seat 3: JZappa ($1.90 in chips)
Seat 4: Ind1ctable ($4.08 in chips)
Seat 5: tattooed66 ($0.71 in chips)
Seat 6: slowrollerNJ ($0.86 in chips)
tapouttazz9: posts small blind $0.01
BMCG77: posts big blind $0.02
*** HOLE CARDS ***
Dealt to tapouttazz9 [4s Jc]
JZappa: folds
Ind1ctable: raises $0.02 to $0.04
tattooed66: calls $0.04
slowrollerNJ: folds
tapouttazz9: folds
BMCG77: calls $0.02
*** FLOP *** [4h 6s Jd]
BMCG77: checks
Ind1ctable: checks
tattooed66: bets $0.12
BMCG77: folds
Ind1ctable: folds
Uncalled bet ($0.12) returned to tattooed66
tattooed66 collected $0.12 from pot
tattooed66: doesn't show hand
*** SUMMARY ***
Total pot $0.13 | Rake $0.01
Board [4h 6s Jd]
Seat 1: tapouttazz9 (small blind) folded before Flop
Seat 2: BMCG77 (big blind) folded on the Flop
Seat 3: JZappa folded before Flop (didn't bet)
Seat 4: Ind1ctable folded on the Flop
Seat 5: tattooed66 collected ($0.12)
Seat 6: slowrollerNJ (button) folded before Flop (didn't bet)


PokerStars Hand #152501306069:  Hold'em No Limit ($0.01/$0.02 USD) - 2016/05/06 22:08:50 ET
Table 'Alcyone' 6-max Seat #1 is the button
Seat 1: tapouttazz9 ($1.97 in chips)
Seat 2: BMCG77 ($1.71 in chips)
Seat 3: JZappa ($1.90 in chips)
Seat 4: Ind1ctable ($4.04 in chips)
Seat 5: tattooed66 ($0.79 in chips)
Seat 6: slowrollerNJ ($0.86 in chips)
BMCG77: posts small blind $0.01
JZappa: posts big blind $0.02
*** HOLE CARDS ***
Dealt to tapouttazz9 [2h 7d]
Ind1ctable: folds
tattooed66: calls $0.02
slowrollerNJ: folds
tapouttazz9: folds
BMCG77: calls $0.01
JZappa: raises $0.10 to $0.12
tattooed66: calls $0.10
BMCG77: folds
*** FLOP *** [As 2d Qc]
JZappa: bets $0.25
tattooed66: folds
Uncalled bet ($0.25) returned to JZappa
JZappa collected $0.25 from pot
JZappa: doesn't show hand
*** SUMMARY ***
Total pot $0.26 | Rake $0.01
Board [As 2d Qc]
Seat 1: tapouttazz9 (button) folded before Flop (didn't bet)
Seat 2: BMCG77 (small blind) folded before Flop
Seat 3: JZappa (big blind) collected ($0.25)
Seat 4: Ind1ctable folded before Flop (didn't bet)
Seat 5: tattooed66 folded on the Flop
Seat 6: slowrollerNJ folded before Flop (didn't bet)


PokerStars Hand #152501306236:  Hold'em No Limit ($0.01/$0.02 USD) - 2016/05/06 22:09:21 ET
Table 'Alcyone' 6-max Seat #2 is the button
Seat 1: tapouttazz9 ($1.97 in chips)
Seat 2: BMCG77 ($1.69 in chips)
Seat 3: JZappa ($2.03 in chips)
Seat 4: Ind1ctable ($4.04 in chips)
Seat 5: tattooed66 ($0.67 in chips)
Seat 6: slowrollerNJ ($0.86 in chips)
JZappa: posts small blind $0.01
Ind1ctable: posts big blind $0.02
*** HOLE CARDS ***
Dealt to tapouttazz9 [Kd 7d]
tattooed66: folds
slowrollerNJ: folds
tapouttazz9: folds
BMCG77: folds
JZappa: calls $0.01
Ind1ctable: checks
*** FLOP *** [Td 7c Ts]
JZappa: checks
Ind1ctable: bets $0.04
JZappa: calls $0.04
*** TURN *** [Td 7c Ts] [Ad]
JZappa: checks
Ind1ctable: bets $0.10
JZappa: calls $0.10
*** RIVER *** [Td 7c Ts Ad] [Qc]
JZappa: checks
Ind1ctable: bets $0.30
JZappa: calls $0.30
*** SHOW DOWN ***
Ind1ctable: shows [9s Th] (three of a kind, Tens)
JZappa: mucks hand
Ind1ctable collected $0.88 from pot
*** SUMMARY ***
Total pot $0.92 | Rake $0.04
Board [Td 7c Ts Ad Qc]
Seat 1: tapouttazz9 folded before Flop (didn't bet)
Seat 2: BMCG77 (button) folded before Flop (didn't bet)
Seat 3: JZappa (small blind) mucked [Qd Ac]
Seat 4: Ind1ctable (big blind) showed [9s Th] and won ($0.88) with three of a kind, Tens
Seat 5: tattooed66 folded before Flop (didn't bet)
Seat 6: slowrollerNJ folded before Flop (didn't bet)


PokerStars Hand #152501306431:  Hold'em No Limit ($0.01/$0.02 USD) - 2016/05/06 22:09:53 ET
Table 'Alcyone' 6-max Seat #3 is the button
Seat 1: tapouttazz9 ($1.97 in chips)
Seat 2: BMCG77 ($1.69 in chips)
Seat 3: JZappa ($1.57 in chips)
Seat 4: Ind1ctable ($4.46 in chips)
Seat 5: tattooed66 ($0.67 in chips)
Seat 6: slowrollerNJ ($0.86 in chips)
Ind1ctable: posts small blind $0.01
tattooed66: posts big blind $0.02
*** HOLE CARDS ***
Dealt to tapouttazz9 [4d Jd]
slowrollerNJ: folds
tapouttazz9: folds
BMCG77: raises $0.07 to $0.09
JZappa: folds
Ind1ctable: folds
tattooed66: calls $0.07
*** FLOP *** [7d 4c 8d]
tattooed66: checks
BMCG77: bets $0.16
tattooed66: folds
Uncalled bet ($0.16) returned to BMCG77
BMCG77 collected $0.18 from pot
*** SUMMARY ***
Total pot $0.19 | Rake $0.01
Board [7d 4c 8d]
Seat 1: tapouttazz9 folded before Flop (didn't bet)
Seat 2: BMCG77 collected ($0.18)
Seat 3: JZappa (button) folded before Flop (didn't bet)
Seat 4: Ind1ctable (small blind) folded before Flop
Seat 5: tattooed66 (big blind) folded on the Flop
Seat 6: slowrollerNJ folded before Flop (didn't bet)


PokerStars Hand #152501306604:  Hold'em No Limit ($0.01/$0.02 USD) - 2016/05/06 22:10:27 ET
Table 'Alcyone' 6-max Seat #4 is the button
Seat 1: tapouttazz9 ($1.97 in chips)
Seat 2: BMCG77 ($1.78 in chips)
Seat 3: JZappa ($1.57 in chips)
Seat 4: Ind1ctable ($4.45 in chips)
Seat 5: tattooed66 ($0.58 in chips)
Seat 6: slowrollerNJ ($0.86 in chips)
tattooed66: posts small blind $0.01
slowrollerNJ: posts big blind $0.02
*** HOLE CARDS ***
Dealt to tapouttazz9 [4c 5d]
tapouttazz9: folds
BMCG77: raises $0.07 to $0.09
JZappa: folds
Ind1ctable: folds
tattooed66: calls $0.08
slowrollerNJ: folds
*** FLOP *** [9c 5s 6d]
tattooed66: checks
BMCG77: checks
*** TURN *** [9c 5s 6d] [3c]
tattooed66: checks
BMCG77: checks
*** RIVER *** [9c 5s 6d 3c] [2s]
tattooed66: checks
BMCG77: checks
*** SHOW DOWN ***
tattooed66: shows [Ad 2h] (a pair of Deuces)
BMCG77: mucks hand
tattooed66 collected $0.19 from pot
*** SUMMARY ***
Total pot $0.20 | Rake $0.01
Board [9c 5s 6d 3c 2s]
Seat 1: tapouttazz9 folded before Flop (didn't bet)
Seat 2: BMCG77 mucked [Kh As]
Seat 3: JZappa folded before Flop (didn't bet)
Seat 4: Ind1ctable (button) folded before Flop (didn't bet)
Seat 5: tattooed66 (small blind) showed [Ad 2h] and won ($0.19) with a pair of Deuces
Seat 6: slowrollerNJ (big blind) folded before Flop


PokerStars Hand #152501306961:  Hold'em No Limit ($0.01/$0.02 USD) - 2016/05/06 22:11:22 ET
Table 'Alcyone' 6-max Seat #5 is the button
Seat 1: tapouttazz9 ($1.97 in chips)
Seat 2: BMCG77 ($1.69 in chips)
Seat 3: JZappa ($1.57 in chips)
Seat 4: Ind1ctable ($4.45 in chips)
Seat 5: tattooed66 ($0.68 in chips)
Seat 6: slowrollerNJ ($0.84 in chips)
slowrollerNJ: posts small blind $0.01
tapouttazz9: posts big blind $0.02
*** HOLE CARDS ***
Dealt to tapouttazz9 [2h 7s]
BMCG77: folds
JZappa: calls $0.02
Ind1ctable: folds
tattooed66: calls $0.02
slowrollerNJ: calls $0.01
tapouttazz9: checks
*** FLOP *** [4h 5d Kc]
slowrollerNJ: checks
tapouttazz9: checks
JZappa: checks
tattooed66: checks
*** TURN *** [4h 5d Kc] [4d]
slowrollerNJ: checks
tapouttazz9: checks
JZappa: checks
tattooed66: checks
*** RIVER *** [4h 5d Kc 4d] [Ac]
slowrollerNJ: checks
tapouttazz9: checks
JZappa: checks
tattooed66: checks
*** SHOW DOWN ***
slowrollerNJ: shows [7c 9c] (a pair of Fours)
tapouttazz9: mucks hand
JZappa: shows [Tc Js] (a pair of Fours - Ace+King+Jack kicker)
tattooed66: mucks hand
JZappa collected $0.08 from pot
*** SUMMARY ***
Total pot $0.08 | Rake $0
Board [4h 5d Kc 4d Ac]
Seat 1: tapouttazz9 (big blind) mucked [2h 7s]
Seat 2: BMCG77 folded before Flop (didn't bet)
Seat 3: JZappa showed [Tc Js] and won ($0.08) with a pair of Fours
Seat 4: Ind1ctable folded before Flop (didn't bet)
Seat 5: tattooed66 (button) mucked [Ts 6s]
Seat 6: slowrollerNJ (small blind) showed [7c 9c] and lost with a pair of Fours


PokerStars Hand #152501307516:  Hold'em No Limit ($0.01/$0.02 USD) - 2016/05/06 22:12:52 ET
Table 'Alcyone' 6-max Seat #6 is the button
Seat 1: tapouttazz9 ($1.95 in chips)
Seat 2: BMCG77 ($1.69 in chips)
Seat 3: JZappa ($1.63 in chips)
Seat 4: Ind1ctable ($4.45 in chips)
Seat 5: tattooed66 ($0.66 in chips)
Seat 6: slowrollerNJ ($0.82 in chips)
tapouttazz9: posts small blind $0.01
BMCG77: posts big blind $0.02
*** HOLE CARDS ***
Dealt to tapouttazz9 [Td Qd]
JZappa: raises $0.05 to $0.07
Ind1ctable: calls $0.07
tattooed66: folds
slowrollerNJ: folds
tapouttazz9: calls $0.06
BMCG77: calls $0.05
*** FLOP *** [Jc Kh 6d]
tapouttazz9: checks
BMCG77: checks
JZappa: bets $0.13
Ind1ctable: calls $0.13
tapouttazz9: calls $0.13
BMCG77: folds
*** TURN *** [Jc Kh 6d] [Ad]
tapouttazz9: checks
JZappa: bets $0.64
Ind1ctable: raises $3.61 to $4.25 and is all-in
tapouttazz9: calls $1.75 and is all-in
JZappa: calls $0.79 and is all-in
Uncalled bet ($2.50) returned to Ind1ctable
*** RIVER *** [Jc Kh 6d Ad] [Th]
*** SHOW DOWN ***
tapouttazz9: shows [Td Qd] (a straight, Ten to Ace)
Ind1ctable: shows [Ts Qs] (a straight, Ten to Ace)
tapouttazz9 collected $0.31 from side pot
Ind1ctable collected $0.30 from side pot
JZappa: shows [Ks Kc] (three of a kind, Kings)
tapouttazz9 collected $2.37 from main pot
Ind1ctable collected $2.37 from main pot
*** SUMMARY ***
Total pot $5.60 Main pot $4.74. Side pot $0.61. | Rake $0.25
Board [Jc Kh 6d Ad Th]
Seat 1: tapouttazz9 (small blind) showed [Td Qd] and won ($2.68) with a straight, Ten to Ace
Seat 2: BMCG77 (big blind) folded on the Flop
Seat 3: JZappa showed [Ks Kc] and lost with three of a kind, Kings
Seat 4: Ind1ctable showed [Ts Qs] and won ($2.67) with a straight, Ten to Ace
Seat 5: tattooed66 folded before Flop (didn't bet)
Seat 6: slowrollerNJ (button) folded before Flop (didn't bet)


PokerStars Hand #152501307942:  Hold'em No Limit ($0.01/$0.02 USD) - 2016/05/06 22:14:09 ET
Table 'Alcyone' 6-max Seat #1 is the button
Seat 1: tapouttazz9 ($2.68 in chips)
Seat 2: BMCG77 ($1.62 in chips)
Seat 4: Ind1ctable ($5.17 in chips)
Seat 5: tattooed66 ($0.66 in chips)
Seat 6: slowrollerNJ ($0.82 in chips)
BMCG77: posts small blind $0.01
Ind1ctable: posts big blind $0.02
*** HOLE CARDS ***
Dealt to tapouttazz9 [Tc Ah]
tattooed66: calls $0.02
JZappa leaves the table
slowrollerNJ: raises $0.02 to $0.04
tapouttazz9: raises $0.02 to $0.06
BMCG77: calls $0.05
Ind1ctable: calls $0.04
tattooed66: calls $0.04
slowrollerNJ: calls $0.02
*** FLOP *** [8c Ks Jd]
BMCG77: checks
Ind1ctable: checks
tattooed66: checks
slowrollerNJ: checks
tapouttazz9: checks
*** TURN *** [8c Ks Jd] [4h]
BMCG77: checks
Ind1ctable: checks
tattooed66: checks
slowrollerNJ: checks
tapouttazz9: checks
*** RIVER *** [8c Ks Jd 4h] [6d]
ImNotTilting joins the table at seat #3
BMCG77: checks
Ind1ctable: checks
tattooed66: checks
slowrollerNJ: bets $0.10
tapouttazz9: folds
BMCG77: folds
Ind1ctable: folds
tattooed66: calls $0.10
*** SHOW DOWN ***
slowrollerNJ: shows [9h 9s] (a pair of Nines)
tattooed66: mucks hand
slowrollerNJ collected $0.48 from pot
*** SUMMARY ***
Total pot $0.50 | Rake $0.02
Board [8c Ks Jd 4h 6d]
Seat 1: tapouttazz9 (button) folded on the River
Seat 2: BMCG77 (small blind) folded on the River
Seat 4: Ind1ctable (big blind) folded on the River
Seat 5: tattooed66 mucked [7c 8s]
Seat 6: slowrollerNJ showed [9h 9s] and won ($0.48) with a pair of Nines


PokerStars Hand #152501308513:  Hold'em No Limit ($0.01/$0.02 USD) - 2016/05/06 22:15:53 ET
Table 'Alcyone' 6-max Seat #2 is the button
Seat 1: tapouttazz9 ($2.62 in chips)
Seat 2: BMCG77 ($1.56 in chips)
Seat 4: Ind1ctable ($5.11 in chips)
Seat 5: tattooed66 ($0.50 in chips)
Seat 6: slowrollerNJ ($1.14 in chips)
ImNotTilting will be allowed to play after the button
Ind1ctable: posts small blind $0.01
tattooed66: posts big blind $0.02
*** HOLE CARDS ***
Dealt to tapouttazz9 [Tc 8c]
slowrollerNJ: folds
tapouttazz9: folds
BMCG77: folds
Ind1ctable: calls $0.01
tattooed66: checks
*** FLOP *** [6h Ad Qd]
Ind1ctable: bets $0.02
tattooed66: calls $0.02
*** TURN *** [6h Ad Qd] [As]
Ind1ctable: checks
tattooed66: bets $0.08
Ind1ctable: raises $0.08 to $0.16
tattooed66: folds
Uncalled bet ($0.08) returned to Ind1ctable
Ind1ctable collected $0.23 from pot
Ind1ctable: doesn't show hand
*** SUMMARY ***
Total pot $0.24 | Rake $0.01
Board [6h Ad Qd As]
Seat 1: tapouttazz9 folded before Flop (didn't bet)
Seat 2: BMCG77 (button) folded before Flop (didn't bet)
Seat 4: Ind1ctable (small blind) collected ($0.23)
Seat 5: tattooed66 (big blind) folded on the Turn
Seat 6: slowrollerNJ folded before Flop (didn't bet)


PokerStars Hand #152501308674:  Hold'em No Limit ($0.01/$0.02 USD) - 2016/05/06 22:16:20 ET
Table 'Alcyone' 6-max Seat #4 is the button
Seat 1: tapouttazz9 ($2.62 in chips)
Seat 2: BMCG77 ($1.56 in chips)
Seat 4: Ind1ctable ($5.22 in chips)
Seat 5: tattooed66 ($0.38 in chips)
Seat 6: slowrollerNJ ($1.14 in chips)
tattooed66: posts small blind $0.01
slowrollerNJ: posts big blind $0.02
ImNotTilting: sits out
*** HOLE CARDS ***
Dealt to tapouttazz9 [9h Qs]
tapouttazz9: folds
BMCG77: folds
Ind1ctable: raises $0.04 to $0.06
tattooed66: calls $0.05
slowrollerNJ: folds
*** FLOP *** [Ac 9c 8s]
tattooed66: bets $0.32 and is all-in
Ind1ctable: calls $0.32
*** TURN *** [Ac 9c 8s] [6c]
*** RIVER *** [Ac 9c 8s 6c] [Ts]
*** SHOW DOWN ***
tattooed66: shows [Ah 5s] (a pair of Aces)
Ind1ctable: shows [As 9d] (two pair, Aces and Nines)
Ind1ctable collected $0.74 from pot
*** SUMMARY ***
Total pot $0.78 | Rake $0.04
Board [Ac 9c 8s 6c Ts]
Seat 1: tapouttazz9 folded before Flop (didn't bet)
Seat 2: BMCG77 folded before Flop (didn't bet)
Seat 4: Ind1ctable (button) showed [As 9d] and won ($0.74) with two pair, Aces and Nines
Seat 5: tattooed66 (small blind) showed [Ah 5s] and lost with a pair of Aces
Seat 6: slowrollerNJ (big blind) folded before Flop


PokerStars Hand #152501308850:  Hold'em No Limit ($0.01/$0.02 USD) - 2016/05/06 22:16:51 ET
Table 'Alcyone' 6-max Seat #6 is the button
Seat 1: tapouttazz9 ($2.62 in chips)
Seat 2: BMCG77 ($1.56 in chips)
Seat 4: Ind1ctable ($5.58 in chips)
Seat 6: slowrollerNJ ($1.12 in chips)
tapouttazz9: posts small blind $0.01
BMCG77: posts big blind $0.02
ImNotTilting: sits out
*** HOLE CARDS ***
Dealt to tapouttazz9 [As 2d]
tattooed66 leaves the table
Ind1ctable: raises $0.02 to $0.04
slowrollerNJ: raises $0.11 to $0.15
tapouttazz9: folds
BMCG77: folds
Ind1ctable: folds
Uncalled bet ($0.11) returned to slowrollerNJ
slowrollerNJ collected $0.11 from pot
*** SUMMARY ***
Total pot $0.11 | Rake $0
Seat 1: tapouttazz9 (small blind) folded before Flop
Seat 2: BMCG77 (big blind) folded before Flop
Seat 4: Ind1ctable folded before Flop
Seat 6: slowrollerNJ (button) collected ($0.11)


PokerStars Hand #152501308959:  Hold'em No Limit ($0.01/$0.02 USD) - 2016/05/06 22:17:10 ET
Table 'Alcyone' 6-max Seat #1 is the button
Seat 1: tapouttazz9 ($2.61 in chips)
Seat 2: BMCG77 ($1.54 in chips)
Seat 3: ImNotTilting ($2.57 in chips)
Seat 4: Ind1ctable ($5.54 in chips)
Seat 6: slowrollerNJ ($1.19 in chips)
BMCG77: posts small blind $0.01
ImNotTilting: posts big blind $0.02
*** HOLE CARDS ***
Dealt to tapouttazz9 [5c 7c]
Ind1ctable: folds
Ind1ctable leaves the table
slowrollerNJ: folds
tapouttazz9: folds
BMCG77: folds
Uncalled bet ($0.01) returned to ImNotTilting
ImNotTilting collected $0.02 from pot
ImNotTilting: doesn't show hand
*** SUMMARY ***
Total pot $0.02 | Rake $0
Seat 1: tapouttazz9 (button) folded before Flop (didn't bet)
Seat 2: BMCG77 (small blind) folded before Flop
Seat 3: ImNotTilting (big blind) collected ($0.02)
Seat 4: Ind1ctable folded before Flop (didn't bet)
Seat 6: slowrollerNJ folded before Flop (didn't bet)


PokerStars Hand #152501309041:  Hold'em No Limit ($0.01/$0.02 USD) - 2016/05/06 22:17:23 ET
Table 'Alcyone' 6-max Seat #2 is the button
Seat 1: tapouttazz9 ($2.61 in chips)
Seat 2: BMCG77 ($1.53 in chips)
Seat 3: ImNotTilting ($2.58 in chips)
Seat 6: slowrollerNJ ($1.19 in chips)
ImNotTilting: posts small blind $0.01
slowrollerNJ: posts big blind $0.02
*** HOLE CARDS ***
Dealt to tapouttazz9 [4c 6s]
tapouttazz9: folds
BMCG77: folds
ImNotTilting: calls $0.01
slowrollerNJ: checks
*** FLOP *** [2d Qh 6c]
ImNotTilting: bets $0.04
slowrollerNJ: folds
Uncalled bet ($0.04) returned to ImNotTilting
ImNotTilting collected $0.04 from pot
ImNotTilting: doesn't show hand
*** SUMMARY ***
Total pot $0.04 | Rake $0
Board [2d Qh 6c]
Seat 1: tapouttazz9 folded before Flop (didn't bet)
Seat 2: BMCG77 (button) folded before Flop (didn't bet)
Seat 3: ImNotTilting (small blind) collected ($0.04)
Seat 6: slowrollerNJ (big blind) folded on the Flop


PokerStars Hand #152501309154:  Hold'em No Limit ($0.01/$0.02 USD) - 2016/05/06 22:17:43 ET
Table 'Alcyone' 6-max Seat #3 is the button
Seat 1: tapouttazz9 ($2.61 in chips)
Seat 2: BMCG77 ($1.53 in chips)
Seat 3: ImNotTilting ($2.60 in chips)
Seat 6: slowrollerNJ ($1.17 in chips)
slowrollerNJ: posts small blind $0.01
tapouttazz9: posts big blind $0.02
*** HOLE CARDS ***
Dealt to tapouttazz9 [As Jd]
BMCG77: calls $0.02
ImNotTilting: calls $0.02
slowrollerNJ: calls $0.01
tapouttazz9: checks
*** FLOP *** [5h Ks 2d]
slowrollerNJ: checks
tapouttazz9: checks
BMCG77: checks
ImNotTilting: checks
*** TURN *** [5h Ks 2d] [4d]
slowrollerNJ: checks
tapouttazz9: checks
BMCG77: checks
ImNotTilting: checks
*** RIVER *** [5h Ks 2d 4d] [Ts]
slowrollerNJ: checks
tapouttazz9: checks
BMCG77: checks
ImNotTilting: checks
*** SHOW DOWN ***
slowrollerNJ: shows [7c Qh] (high card King)
tapouttazz9: shows [As Jd] (high card Ace)
BMCG77: shows [Ac 2h] (a pair of Deuces)
ImNotTilting: mucks hand
BMCG77 collected $0.08 from pot
*** SUMMARY ***
Total pot $0.08 | Rake $0
Board [5h Ks 2d 4d Ts]
Seat 1: tapouttazz9 (big blind) showed [As Jd] and lost with high card Ace
Seat 2: BMCG77 showed [Ac 2h] and won ($0.08) with a pair of Deuces
Seat 3: ImNotTilting (button) mucked [9h 8h]
Seat 6: slowrollerNJ (small blind) showed [7c Qh] and lost with high card King


PokerStars Hand #152501309393:  Hold'em No Limit ($0.01/$0.02 USD) - 2016/05/06 22:18:22 ET
Table 'Alcyone' 6-max Seat #6 is the button
Seat 1: tapouttazz9 ($2.59 in chips)
Seat 2: BMCG77 ($1.59 in chips)
Seat 3: ImNotTilting ($2.58 in chips)
Seat 6: slowrollerNJ ($1.15 in chips)
tapouttazz9: posts small blind $0.01
BMCG77: posts big blind $0.02
*** HOLE CARDS ***
Dealt to tapouttazz9 [9s Qs]
ImNotTilting: raises $0.06 to $0.08
slowrollerNJ: folds
tapouttazz9: calls $0.07
BMCG77: folds
*** FLOP *** [4h 8c 8s]
tapouttazz9: bets $0.08
ImNotTilting: calls $0.08
*** TURN *** [4h 8c 8s] [5c]
tapouttazz9: bets $0.16
ImNotTilting: calls $0.16
*** RIVER *** [4h 8c 8s 5c] [Jh]
tapouttazz9: bets $0.31
ImNotTilting: calls $0.31
*** SHOW DOWN ***
tapouttazz9: shows [9s Qs] (a pair of Eights)
ImNotTilting: shows [7d 7s] (two pair, Eights and Sevens)
ImNotTilting collected $1.22 from pot
*** SUMMARY ***
Total pot $1.28 | Rake $0.06
Board [4h 8c 8s 5c Jh]
Seat 1: tapouttazz9 (small blind) showed [9s Qs] and lost with a pair of Eights
Seat 2: BMCG77 (big blind) folded before Flop
Seat 3: ImNotTilting showed [7d 7s] and won ($1.22) with two pair, Eights and Sevens
Seat 6: slowrollerNJ (button) folded before Flop (didn't bet)


PokerStars Hand #152501309672:  Hold'em No Limit ($0.01/$0.02 USD) - 2016/05/06 22:19:09 ET
Table 'Alcyone' 6-max Seat #1 is the button
Seat 1: tapouttazz9 ($1.96 in chips)
Seat 2: BMCG77 ($1.57 in chips)
Seat 3: ImNotTilting ($3.17 in chips)
Seat 6: slowrollerNJ ($1.15 in chips)
BMCG77: posts small blind $0.01
ImNotTilting: posts big blind $0.02
*** HOLE CARDS ***
Dealt to tapouttazz9 [Jh Ac]
slowrollerNJ: folds
tapouttazz9: raises $0.03 to $0.05
BMCG77: folds
ImNotTilting: calls $0.03
*** FLOP *** [9h 8s 4d]
ImNotTilting: checks
tapouttazz9: checks
*** TURN *** [9h 8s 4d] [Ad]
ImNotTilting: checks
tapouttazz9: bets $0.05
ImNotTilting: folds
Uncalled bet ($0.05) returned to tapouttazz9
tapouttazz9 collected $0.11 from pot
tapouttazz9: doesn't show hand
*** SUMMARY ***
Total pot $0.11 | Rake $0
Board [9h 8s 4d Ad]
Seat 1: tapouttazz9 (button) collected ($0.11)
Seat 2: BMCG77 (small blind) folded before Flop
Seat 3: ImNotTilting (big blind) folded on the Turn
Seat 6: slowrollerNJ folded before Flop (didn't bet)


PokerStars Hand #152501309848:  Hold'em No Limit ($0.01/$0.02 USD) - 2016/05/06 22:19:37 ET
Table 'Alcyone' 6-max Seat #2 is the button
Seat 1: tapouttazz9 ($2.02 in chips)
Seat 2: BMCG77 ($1.56 in chips)
Seat 3: ImNotTilting ($3.12 in chips)
Seat 6: slowrollerNJ ($1.15 in chips)
ImNotTilting: posts small blind $0.01
slowrollerNJ: posts big blind $0.02
*** HOLE CARDS ***
Dealt to tapouttazz9 [3h 8h]
tapouttazz9: folds
BMCG77: folds
ImNotTilting: raises $0.04 to $0.06
slowrollerNJ: folds
Uncalled bet ($0.04) returned to ImNotTilting
ImNotTilting collected $0.04 from pot
ImNotTilting: doesn't show hand
*** SUMMARY ***
Total pot $0.04 | Rake $0
Seat 1: tapouttazz9 folded before Flop (didn't bet)
Seat 2: BMCG77 (button) folded before Flop (didn't bet)
Seat 3: ImNotTilting (small blind) collected ($0.04)
Seat 6: slowrollerNJ (big blind) folded before Flop


PokerStars Hand #152501309907:  Hold'em No Limit ($0.01/$0.02 USD) - 2016/05/06 22:19:48 ET
Table 'Alcyone' 6-max Seat #3 is the button
Seat 1: tapouttazz9 ($2.02 in chips)
Seat 2: BMCG77 ($1.56 in chips)
Seat 3: ImNotTilting ($3.14 in chips)
Seat 6: slowrollerNJ ($1.13 in chips)
slowrollerNJ: posts small blind $0.01
tapouttazz9: posts big blind $0.02
*** HOLE CARDS ***
Dealt to tapouttazz9 [8s Th]
BMCG77: calls $0.02
ImNotTilting: calls $0.02
slowrollerNJ: calls $0.01
tapouttazz9: checks
*** FLOP *** [Qs 8d 8h]
slowrollerNJ: checks
tapouttazz9: bets $0.06
BMCG77: folds
ImNotTilting: folds
slowrollerNJ: folds
Uncalled bet ($0.06) returned to tapouttazz9
tapouttazz9 collected $0.08 from pot
tapouttazz9: doesn't show hand
*** SUMMARY ***
Total pot $0.08 | Rake $0
Board [Qs 8d 8h]
Seat 1: tapouttazz9 (big blind) collected ($0.08)
Seat 2: BMCG77 folded on the Flop
Seat 3: ImNotTilting (button) folded on the Flop
Seat 6: slowrollerNJ (small blind) folded on the Flop


PokerStars Hand #152501798102:  Hold'em No Limit ($0.01/$0.02 USD) - 2016/05/06 22:20:20 ET
Table 'Alcyone' 6-max Seat #6 is the button
Seat 1: tapouttazz9 ($2.08 in chips)
Seat 2: BMCG77 ($1.54 in chips)
Seat 3: ImNotTilting ($3.12 in chips)
Seat 6: slowrollerNJ ($1.11 in chips)
tapouttazz9: posts small blind $0.01
BMCG77: posts big blind $0.02
*** HOLE CARDS ***
Dealt to tapouttazz9 [8d Ts]
ImNotTilting: folds
slowrollerNJ: folds
tapouttazz9: folds
Uncalled bet ($0.01) returned to BMCG77
BMCG77 collected $0.02 from pot
*** SUMMARY ***
Total pot $0.02 | Rake $0
Seat 1: tapouttazz9 (small blind) folded before Flop
Seat 2: BMCG77 (big blind) collected ($0.02)
Seat 3: ImNotTilting folded before Flop (didn't bet)
Seat 6: slowrollerNJ (button) folded before Flop (didn't bet)


PokerStars Hand #152501798167:  Hold'em No Limit ($0.01/$0.02 USD) - 2016/05/06 22:20:31 ET
Table 'Alcyone' 6-max Seat #1 is the button
Seat 1: tapouttazz9 ($2.07 in chips)
Seat 2: BMCG77 ($1.55 in chips)
Seat 3: ImNotTilting ($3.12 in chips)
Seat 6: slowrollerNJ ($1.11 in chips)
BMCG77: posts small blind $0.01
ImNotTilting: posts big blind $0.02
*** HOLE CARDS ***
Dealt to tapouttazz9 [4c 4h]
slowrollerNJ: folds
tapouttazz9: raises $0.02 to $0.04
BMCG77: calls $0.03
ImNotTilting: calls $0.02
*** FLOP *** [9h 5d 4s]
BMCG77: checks
ImNotTilting: checks
tapouttazz9: bets $0.08
BMCG77: folds
ImNotTilting: folds
Uncalled bet ($0.08) returned to tapouttazz9
tapouttazz9 collected $0.11 from pot
tapouttazz9: doesn't show hand
*** SUMMARY ***
Total pot $0.12 | Rake $0.01
Board [9h 5d 4s]
Seat 1: tapouttazz9 (button) collected ($0.11)
Seat 2: BMCG77 (small blind) folded on the Flop
Seat 3: ImNotTilting (big blind) folded on the Flop
Seat 6: slowrollerNJ folded before Flop (didn't bet)


PokerStars Hand #152501798353:  Hold'em No Limit ($0.01/$0.02 USD) - 2016/05/06 22:21:08 ET
Table 'Alcyone' 6-max Seat #2 is the button
Seat 1: tapouttazz9 ($2.14 in chips)
Seat 2: BMCG77 ($1.51 in chips)
Seat 3: ImNotTilting ($3.08 in chips)
Seat 6: slowrollerNJ ($1.11 in chips)
ImNotTilting: posts small blind $0.01
slowrollerNJ: posts big blind $0.02
*** HOLE CARDS ***
Dealt to tapouttazz9 [Tc Kc]
tapouttazz9: folds
BMCG77: folds
ImNotTilting: folds
Uncalled bet ($0.01) returned to slowrollerNJ
slowrollerNJ collected $0.02 from pot
*** SUMMARY ***
Total pot $0.02 | Rake $0
Seat 1: tapouttazz9 folded before Flop (didn't bet)
Seat 2: BMCG77 (button) folded before Flop (didn't bet)
Seat 3: ImNotTilting (small blind) folded before Flop
Seat 6: slowrollerNJ (big blind) collected ($0.02)


PokerStars Hand #152501798389:  Hold'em No Limit ($0.01/$0.02 USD) - 2016/05/06 22:21:15 ET
Table 'Alcyone' 6-max Seat #3 is the button
Seat 1: tapouttazz9 ($2.14 in chips)
Seat 2: BMCG77 ($1.51 in chips)
Seat 3: ImNotTilting ($3.07 in chips)
Seat 6: slowrollerNJ ($1.12 in chips)
slowrollerNJ: posts small blind $0.01
tapouttazz9: posts big blind $0.02
*** HOLE CARDS ***
Dealt to tapouttazz9 [8h 5s]
BMCG77: folds
ImNotTilting: calls $0.02
slowrollerNJ: calls $0.01
tapouttazz9: checks
*** FLOP *** [Ts 4s As]
slowrollerNJ: checks
tapouttazz9: checks
ImNotTilting: bets $0.06
slowrollerNJ: folds
tapouttazz9: folds
Uncalled bet ($0.06) returned to ImNotTilting
ImNotTilting collected $0.06 from pot
ImNotTilting: doesn't show hand
*** SUMMARY ***
Total pot $0.06 | Rake $0
Board [Ts 4s As]
Seat 1: tapouttazz9 (big blind) folded on the Flop
Seat 2: BMCG77 folded before Flop (didn't bet)
Seat 3: ImNotTilting (button) collected ($0.06)
Seat 6: slowrollerNJ (small blind) folded on the Flop


PokerStars Hand #152501798524:  Hold'em No Limit ($0.01/$0.02 USD) - 2016/05/06 22:21:38 ET
Table 'Alcyone' 6-max Seat #6 is the button
Seat 1: tapouttazz9 ($2.12 in chips)
Seat 2: BMCG77 ($1.51 in chips)
Seat 3: ImNotTilting ($3.11 in chips)
Seat 6: slowrollerNJ ($1.10 in chips)
tapouttazz9: posts small blind $0.01
BMCG77: posts big blind $0.02
*** HOLE CARDS ***
Dealt to tapouttazz9 [Ad 6h]
ImNotTilting: folds
slowrollerNJ: raises $0.02 to $0.04
tapouttazz9: folds
BMCG77: calls $0.02
*** FLOP *** [3s 4s 5c]
BMCG77: bets $0.07
slowrollerNJ: calls $0.07
*** TURN *** [3s 4s 5c] [Kd]
BMCG77: checks
slowrollerNJ: checks
*** RIVER *** [3s 4s 5c Kd] [Kh]
BMCG77: bets $0.22
slowrollerNJ: folds
Uncalled bet ($0.22) returned to BMCG77
BMCG77 collected $0.22 from pot
*** SUMMARY ***
Total pot $0.23 | Rake $0.01
Board [3s 4s 5c Kd Kh]
Seat 1: tapouttazz9 (small blind) folded before Flop
Seat 2: BMCG77 (big blind) collected ($0.22)
Seat 3: ImNotTilting folded before Flop (didn't bet)
Seat 6: slowrollerNJ (button) folded on the River


PokerStars Hand #152501798883:  Hold'em No Limit ($0.01/$0.02 USD) - 2016/05/06 22:22:42 ET
Table 'Alcyone' 6-max Seat #1 is the button
Seat 1: tapouttazz9 ($2.11 in chips)
Seat 2: BMCG77 ($1.62 in chips)
Seat 6: slowrollerNJ ($0.99 in chips)
BMCG77: posts small blind $0.01
ImNotTilting: is sitting out
slowrollerNJ: posts big blind $0.02
*** HOLE CARDS ***
Dealt to tapouttazz9 [Ac Qs]
tapouttazz9: raises $0.02 to $0.04
BMCG77: calls $0.03
slowrollerNJ: calls $0.02
*** FLOP *** [7h Tc 4s]
BMCG77: checks
slowrollerNJ: checks
tapouttazz9: checks
*** TURN *** [7h Tc 4s] [8h]
BMCG77: checks
slowrollerNJ: checks
tapouttazz9: checks
*** RIVER *** [7h Tc 4s 8h] [Ts]
BMCG77: bets $0.02
slowrollerNJ: folds
tapouttazz9: folds
Uncalled bet ($0.02) returned to BMCG77
BMCG77 collected $0.11 from pot
*** SUMMARY ***
Total pot $0.12 | Rake $0.01
Board [7h Tc 4s 8h Ts]
Seat 1: tapouttazz9 (button) folded on the River
Seat 2: BMCG77 (small blind) collected ($0.11)
Seat 6: slowrollerNJ (big blind) folded on the River


PokerStars Hand #152501799195:  Hold'em No Limit ($0.01/$0.02 USD) - 2016/05/06 22:23:39 ET
Table 'Alcyone' 6-max Seat #2 is the button
Seat 1: tapouttazz9 ($2.07 in chips)
Seat 2: BMCG77 ($1.69 in chips)
Seat 6: slowrollerNJ ($0.95 in chips)
slowrollerNJ: posts small blind $0.01
tapouttazz9: posts big blind $0.02
*** HOLE CARDS ***
Dealt to tapouttazz9 [3s Th]
BMCG77: calls $0.02
slowrollerNJ: calls $0.01
tapouttazz9: checks
*** FLOP *** [5h Ah 7c]
slowrollerNJ: checks
tapouttazz9: checks
BMCG77: checks
*** TURN *** [5h Ah 7c] [9c]
slowrollerNJ: checks
tapouttazz9: checks
BMCG77: checks
*** RIVER *** [5h Ah 7c 9c] [Kd]
slowrollerNJ: checks
tapouttazz9: checks
BMCG77: checks
*** SHOW DOWN ***
slowrollerNJ: shows [5d 8h] (a pair of Fives)
tapouttazz9: mucks hand
BMCG77: shows [Qc 9s] (a pair of Nines)
BMCG77 collected $0.06 from pot
*** SUMMARY ***
Total pot $0.06 | Rake $0
Board [5h Ah 7c 9c Kd]
Seat 1: tapouttazz9 (big blind) mucked [3s Th]
Seat 2: BMCG77 (button) showed [Qc 9s] and won ($0.06) with a pair of Nines
Seat 6: slowrollerNJ (small blind) showed [5d 8h] and lost with a pair of Fives


PokerStars Hand #152501799474:  Hold'em No Limit ($0.01/$0.02 USD) - 2016/05/06 22:24:27 ET
Table 'Alcyone' 6-max Seat #1 is the button
Seat 1: tapouttazz9 ($2.05 in chips)
Seat 6: slowrollerNJ ($0.93 in chips)
tapouttazz9: posts small blind $0.01
BMCG77: is sitting out
slowrollerNJ: posts big blind $0.02
*** HOLE CARDS ***
Dealt to tapouttazz9 [7d Td]
BMCG77 leaves the table
tapouttazz9: folds
Uncalled bet ($0.01) returned to slowrollerNJ
slowrollerNJ collected $0.02 from pot
*** SUMMARY ***
Total pot $0.02 | Rake $0
Seat 1: tapouttazz9 (button) (small blind) folded before Flop
Seat 6: slowrollerNJ (big blind) collected ($0.02)


PokerStars Hand #155626602574:  Hold'em No Limit ($0.01/$0.02 USD) - 2016/07/11 16:05:03 ET
Table 'Alcyone' 6-max Seat #2 is the button
Seat 1: Scoop15 ($3.50 in chips)
Seat 2: erik51fun ($0.57 in chips)
Seat 3: vealshank ($1.86 in chips)
Seat 5: TraveIerr ($2.56 in chips)
vealshank: posts small blind $0.01
DONKLEDORK: is sitting out
TraveIerr: posts big blind $0.02
*** HOLE CARDS ***
Scoop15: folds
erik51fun: calls $0.02
vealshank: calls $0.01
TraveIerr: checks
*** FLOP *** [7h 8c Th]
vealshank: bets $0.04
TraveIerr: calls $0.04
tapouttazz9 joins the table at seat #6
erik51fun: calls $0.04
*** TURN *** [7h 8c Th] [6c]
vealshank: bets $0.08
TraveIerr: folds
erik51fun: calls $0.08
*** RIVER *** [7h 8c Th 6c] [5c]
vealshank: bets $0.02
erik51fun: calls $0.02
*** SHOW DOWN ***
vealshank: shows [Ts 2c] (a pair of Tens)
erik51fun: mucks hand
vealshank collected $0.36 from pot
*** SUMMARY ***
Total pot $0.38 | Rake $0.02
Board [7h 8c Th 6c 5c]
Seat 1: Scoop15 folded before Flop (didn't bet)
Seat 2: erik51fun (button) mucked
Seat 3: vealshank (small blind) showed [Ts 2c] and won ($0.36) with a pair of Tens
Seat 5: TraveIerr (big blind) folded on the Turn


PokerStars Hand #155626602907:  Hold'em No Limit ($0.01/$0.02 USD) - 2016/07/11 16:06:12 ET
Table 'Alcyone' 6-max Seat #3 is the button
Seat 1: Scoop15 ($3.50 in chips)
Seat 2: erik51fun ($0.41 in chips)
Seat 3: vealshank ($2.06 in chips)
Seat 5: TraveIerr ($2.50 in chips)
Seat 6: tapouttazz9 ($2 in chips)
TraveIerr: posts small blind $0.01
tapouttazz9: posts big blind $0.02
*** HOLE CARDS ***
Dealt to tapouttazz9 [Qh Ad]
Scoop15: raises $0.02 to $0.04
erik51fun: calls $0.04
vealshank: calls $0.04
TraveIerr: folds
tapouttazz9: raises $0.04 to $0.08
Scoop15: calls $0.04
erik51fun: calls $0.04
DONKLEDORK leaves the table
vealshank is disconnected
TY4PAYING joins the table at seat #4
vealshank is connected
vealshank: calls $0.04
*** FLOP *** [Ts 6c 4h]
tapouttazz9: bets $0.24
Scoop15: folds
erik51fun: folds
vealshank: calls $0.24
*** TURN *** [Ts 6c 4h] [2d]
tapouttazz9: checks
vealshank: bets $0.04
tapouttazz9: calls $0.04
*** RIVER *** [Ts 6c 4h 2d] [9d]
tapouttazz9: checks
vealshank: bets $0.10
tapouttazz9: folds
Uncalled bet ($0.10) returned to vealshank
vealshank collected $0.85 from pot
*** SUMMARY ***
Total pot $0.89 | Rake $0.04
Board [Ts 6c 4h 2d 9d]
Seat 1: Scoop15 folded on the Flop
Seat 2: erik51fun folded on the Flop
Seat 3: vealshank (button) collected ($0.85)
Seat 5: TraveIerr (small blind) folded before Flop
Seat 6: tapouttazz9 (big blind) folded on the River


PokerStars Hand #155626603368:  Hold'em No Limit ($0.01/$0.02 USD) - 2016/07/11 16:07:46 ET
Table 'Alcyone' 6-max Seat #5 is the button
Seat 1: Scoop15 ($3.42 in chips)
Seat 2: erik51fun ($0.33 in chips)
Seat 3: vealshank ($2.55 in chips)
Seat 5: TraveIerr ($2.49 in chips)
Seat 6: tapouttazz9 ($1.64 in chips)
tapouttazz9: posts small blind $0.01
Scoop15: posts big blind $0.02
TY4PAYING: sits out
*** HOLE CARDS ***
Dealt to tapouttazz9 [4c 4d]
erik51fun: folds
vealshank: calls $0.02
TraveIerr: raises $0.07 to $0.09
tapouttazz9: calls $0.08
Scoop15: folds
vealshank: calls $0.07
*** FLOP *** [5d Tc Kd]
tapouttazz9: checks
vealshank: checks
TraveIerr: bets $0.17
tapouttazz9: folds
vealshank: folds
Uncalled bet ($0.17) returned to TraveIerr
TraveIerr collected $0.28 from pot
TraveIerr: doesn't show hand
*** SUMMARY ***
Total pot $0.29 | Rake $0.01
Board [5d Tc Kd]
Seat 1: Scoop15 (big blind) folded before Flop
Seat 2: erik51fun folded before Flop (didn't bet)
Seat 3: vealshank folded on the Flop
Seat 5: TraveIerr (button) collected ($0.28)
Seat 6: tapouttazz9 (small blind) folded on the Flop


PokerStars Hand #155626603638:  Hold'em No Limit ($0.01/$0.02 USD) - 2016/07/11 16:08:38 ET
Table 'Alcyone' 6-max Seat #6 is the button
Seat 1: Scoop15 ($3.40 in chips)
Seat 2: erik51fun ($0.33 in chips)
Seat 3: vealshank ($2.46 in chips)
Seat 5: TraveIerr ($2.68 in chips)
Seat 6: tapouttazz9 ($1.91 in chips)
Scoop15: posts small blind $0.01
erik51fun: posts big blind $0.02
TY4PAYING: sits out
*** HOLE CARDS ***
Dealt to tapouttazz9 [Kh 7d]
vealshank: folds
TraveIerr: raises $0.04 to $0.06
tapouttazz9: folds
Scoop15: folds
erik51fun: calls $0.04
*** FLOP *** [Js 2h 3s]
erik51fun: checks
TraveIerr: bets $0.07
erik51fun: folds
Uncalled bet ($0.07) returned to TraveIerr
TraveIerr collected $0.12 from pot
TraveIerr: doesn't show hand
*** SUMMARY ***
Total pot $0.13 | Rake $0.01
Board [Js 2h 3s]
Seat 1: Scoop15 (small blind) folded before Flop
Seat 2: erik51fun (big blind) folded on the Flop
Seat 3: vealshank folded before Flop (didn't bet)
Seat 5: TraveIerr collected ($0.12)
Seat 6: tapouttazz9 (button) folded before Flop (didn't bet)


PokerStars Hand #155626603789:  Hold'em No Limit ($0.01/$0.02 USD) - 2016/07/11 16:09:18 ET
Table 'Alcyone' 6-max Seat #1 is the button
Seat 1: Scoop15 ($3.39 in chips)
Seat 2: erik51fun ($0.27 in chips)
Seat 3: vealshank ($2.46 in chips)
Seat 5: TraveIerr ($2.74 in chips)
Seat 6: tapouttazz9 ($1.91 in chips)
erik51fun: posts small blind $0.01
vealshank: posts big blind $0.02
TY4PAYING: sits out
*** HOLE CARDS ***
Dealt to tapouttazz9 [2d Js]
TraveIerr: folds
tapouttazz9: folds
Scoop15: folds
erik51fun: calls $0.01
vealshank: raises $0.02 to $0.04
erik51fun: calls $0.02
*** FLOP *** [5c Qc Kc]
erik51fun: bets $0.12
vealshank: folds
Uncalled bet ($0.12) returned to erik51fun
erik51fun collected $0.08 from pot
erik51fun: doesn't show hand
*** SUMMARY ***
Total pot $0.08 | Rake $0
Board [5c Qc Kc]
Seat 1: Scoop15 (button) folded before Flop (didn't bet)
Seat 2: erik51fun (small blind) collected ($0.08)
Seat 3: vealshank (big blind) folded on the Flop
Seat 5: TraveIerr folded before Flop (didn't bet)
Seat 6: tapouttazz9 folded before Flop (didn't bet)


PokerStars Hand #155626603983:  Hold'em No Limit ($0.01/$0.02 USD) - 2016/07/11 16:09:54 ET
Table 'Alcyone' 6-max Seat #2 is the button
Seat 1: Scoop15 ($3.39 in chips)
Seat 2: erik51fun ($0.31 in chips)
Seat 3: vealshank ($2.42 in chips)
Seat 4: TY4PAYING ($2 in chips)
Seat 5: TraveIerr ($2.74 in chips)
Seat 6: tapouttazz9 ($1.91 in chips)
vealshank: posts small blind $0.01
TY4PAYING: posts big blind $0.02
*** HOLE CARDS ***
Dealt to tapouttazz9 [Qc 4s]
TraveIerr: raises $0.05 to $0.07
tapouttazz9: folds
Scoop15: calls $0.07
erik51fun: folds
vealshank: folds
TY4PAYING: calls $0.05
*** FLOP *** [Ac Th 7h]
TY4PAYING: checks
TraveIerr: checks
Scoop15: bets $0.08
TY4PAYING: folds
TraveIerr: calls $0.08
*** TURN *** [Ac Th 7h] [6d]
TraveIerr: checks
Scoop15: bets $0.20
TraveIerr: calls $0.20
*** RIVER *** [Ac Th 7h 6d] [8s]
TraveIerr: checks
Scoop15: checks
*** SHOW DOWN ***
TraveIerr: shows [Ks Tc] (a pair of Tens)
Scoop15: mucks hand
TraveIerr collected $0.74 from pot
*** SUMMARY ***
Total pot $0.78 | Rake $0.04
Board [Ac Th 7h 6d 8s]
Seat 1: Scoop15 mucked [Jc Kh]
Seat 2: erik51fun (button) folded before Flop (didn't bet)
Seat 3: vealshank (small blind) folded before Flop
Seat 4: TY4PAYING (big blind) folded on the Flop
Seat 5: TraveIerr showed [Ks Tc] and won ($0.74) with a pair of Tens
Seat 6: tapouttazz9 folded before Flop (didn't bet)


PokerStars Hand #155626604375:  Hold'em No Limit ($0.01/$0.02 USD) - 2016/07/11 16:11:11 ET
Table 'Alcyone' 6-max Seat #3 is the button
Seat 1: Scoop15 ($3.04 in chips)
Seat 2: erik51fun ($0.31 in chips)
Seat 3: vealshank ($2.41 in chips)
Seat 4: TY4PAYING ($1.93 in chips)
Seat 5: TraveIerr ($3.13 in chips)
Seat 6: tapouttazz9 ($1.91 in chips)
TY4PAYING: posts small blind $0.01
TraveIerr: posts big blind $0.02
*** HOLE CARDS ***
Dealt to tapouttazz9 [6c 7s]
tapouttazz9: folds
Scoop15: folds
erik51fun: calls $0.02
vealshank: calls $0.02
TY4PAYING: folds
TraveIerr: checks
*** FLOP *** [2c 3d 6d]
TraveIerr: checks
erik51fun: checks
vealshank: bets $0.04
TraveIerr: folds
erik51fun: folds
Uncalled bet ($0.04) returned to vealshank
vealshank collected $0.07 from pot
*** SUMMARY ***
Total pot $0.07 | Rake $0
Board [2c 3d 6d]
Seat 1: Scoop15 folded before Flop (didn't bet)
Seat 2: erik51fun folded on the Flop
Seat 3: vealshank (button) collected ($0.07)
Seat 4: TY4PAYING (small blind) folded before Flop
Seat 5: TraveIerr (big blind) folded on the Flop
Seat 6: tapouttazz9 folded before Flop (didn't bet)


PokerStars Hand #155626604512:  Hold'em No Limit ($0.01/$0.02 USD) - 2016/07/11 16:11:38 ET
Table 'Alcyone' 6-max Seat #4 is the button
Seat 1: Scoop15 ($3.04 in chips)
Seat 2: erik51fun ($0.29 in chips)
Seat 3: vealshank ($2.46 in chips)
Seat 4: TY4PAYING ($1.92 in chips)
Seat 5: TraveIerr ($3.11 in chips)
Seat 6: tapouttazz9 ($1.91 in chips)
TraveIerr: posts small blind $0.01
tapouttazz9: posts big blind $0.02
*** HOLE CARDS ***
Dealt to tapouttazz9 [5d Th]
Scoop15: folds
erik51fun: calls $0.02
vealshank: calls $0.02
TY4PAYING: raises $0.03 to $0.05
TraveIerr: folds
tapouttazz9: folds
erik51fun: calls $0.03
vealshank: calls $0.03
*** FLOP *** [2d Td Jd]
erik51fun: checks
vealshank: checks
TY4PAYING: bets $0.08
erik51fun: folds
vealshank: folds
Uncalled bet ($0.08) returned to TY4PAYING
TY4PAYING collected $0.17 from pot
TY4PAYING: doesn't show hand
*** SUMMARY ***
Total pot $0.18 | Rake $0.01
Board [2d Td Jd]
Seat 1: Scoop15 folded before Flop (didn't bet)
Seat 2: erik51fun folded on the Flop
Seat 3: vealshank folded on the Flop
Seat 4: TY4PAYING (button) collected ($0.17)
Seat 5: TraveIerr (small blind) folded before Flop
Seat 6: tapouttazz9 (big blind) folded before Flop


PokerStars Hand #155626604789:  Hold'em No Limit ($0.01/$0.02 USD) - 2016/07/11 16:12:30 ET
Table 'Alcyone' 6-max Seat #5 is the button
Seat 1: Scoop15 ($3.04 in chips)
Seat 2: erik51fun ($0.24 in chips)
Seat 3: vealshank ($2.41 in chips)
Seat 4: TY4PAYING ($2.04 in chips)
Seat 5: TraveIerr ($3.10 in chips)
Seat 6: tapouttazz9 ($1.89 in chips)
tapouttazz9: posts small blind $0.01
Scoop15: posts big blind $0.02
*** HOLE CARDS ***
Dealt to tapouttazz9 [Jh 4d]
erik51fun: calls $0.02
vealshank: raises $0.02 to $0.04
TY4PAYING: folds
TraveIerr: folds
tapouttazz9: folds
Scoop15: calls $0.02
erik51fun: calls $0.02
*** FLOP *** [5s Ts 6c]
Scoop15: checks
erik51fun: checks
vealshank: bets $0.08
Scoop15: folds
erik51fun: folds
Uncalled bet ($0.08) returned to vealshank
vealshank collected $0.12 from pot
*** SUMMARY ***
Total pot $0.13 | Rake $0.01
Board [5s Ts 6c]
Seat 1: Scoop15 (big blind) folded on the Flop
Seat 2: erik51fun folded on the Flop
Seat 3: vealshank collected ($0.12)
Seat 4: TY4PAYING folded before Flop (didn't bet)
Seat 5: TraveIerr (button) folded before Flop (didn't bet)
Seat 6: tapouttazz9 (small blind) folded before Flop


PokerStars Hand #155626604951:  Hold'em No Limit ($0.01/$0.02 USD) - 2016/07/11 16:13:03 ET
Table 'Alcyone' 6-max Seat #6 is the button
Seat 1: Scoop15 ($3 in chips)
Seat 2: erik51fun ($0.20 in chips)
Seat 3: vealshank ($2.49 in chips)
Seat 4: TY4PAYING ($2.04 in chips)
Seat 5: TraveIerr ($3.10 in chips)
Seat 6: tapouttazz9 ($1.88 in chips)
Scoop15: posts small blind $0.01
erik51fun: posts big blind $0.02
*** HOLE CARDS ***
Dealt to tapouttazz9 [5h 4h]
vealshank: folds
TY4PAYING: folds
TraveIerr: folds
tapouttazz9: folds
Scoop15: raises $0.04 to $0.06
erik51fun: calls $0.04
*** FLOP *** [9d Ts 3h]
Scoop15: bets $0.14
erik51fun: folds
Uncalled bet ($0.14) returned to Scoop15
Scoop15 collected $0.11 from pot
Scoop15: doesn't show hand
*** SUMMARY ***
Total pot $0.12 | Rake $0.01
Board [9d Ts 3h]
Seat 1: Scoop15 (small blind) collected ($0.11)
Seat 2: erik51fun (big blind) folded on the Flop
Seat 3: vealshank folded before Flop (didn't bet)
Seat 4: TY4PAYING folded before Flop (didn't bet)
Seat 5: TraveIerr folded before Flop (didn't bet)
Seat 6: tapouttazz9 (button) folded before Flop (didn't bet)


PokerStars Hand #155626605117:  Hold'em No Limit ($0.01/$0.02 USD) - 2016/07/11 16:13:41 ET
Table 'Alcyone' 6-max Seat #1 is the button
Seat 1: Scoop15 ($3.05 in chips)
Seat 2: erik51fun ($0.14 in chips)
Seat 3: vealshank ($2.49 in chips)
Seat 4: TY4PAYING ($2.04 in chips)
Seat 5: TraveIerr ($3.10 in chips)
Seat 6: tapouttazz9 ($1.88 in chips)
erik51fun: posts small blind $0.01
vealshank: posts big blind $0.02
*** HOLE CARDS ***
Dealt to tapouttazz9 [9s Tc]
TY4PAYING: raises $0.04 to $0.06
TraveIerr has timed out
TraveIerr: folds
tapouttazz9: calls $0.06
Scoop15: folds
erik51fun: calls $0.05
vealshank: calls $0.04
*** FLOP *** [2s 3h 2d]
erik51fun: bets $0.08 and is all-in
vealshank: folds
TY4PAYING: calls $0.08
tapouttazz9: folds
*** TURN *** [2s 3h 2d] [8c]
*** RIVER *** [2s 3h 2d 8c] [7d]
*** SHOW DOWN ***
erik51fun: shows [9d 9h] (two pair, Nines and Deuces)
TY4PAYING: shows [5s 5c] (two pair, Fives and Deuces)
erik51fun collected $0.38 from pot
*** SUMMARY ***
Total pot $0.40 | Rake $0.02
Board [2s 3h 2d 8c 7d]
Seat 1: Scoop15 (button) folded before Flop (didn't bet)
Seat 2: erik51fun (small blind) showed [9d 9h] and won ($0.38) with two pair, Nines and Deuces
Seat 3: vealshank (big blind) folded on the Flop
Seat 4: TY4PAYING showed [5s 5c] and lost with two pair, Fives and Deuces
Seat 5: TraveIerr folded before Flop (didn't bet)
Seat 6: tapouttazz9 folded on the Flop


PokerStars Hand #155626605403:  Hold'em No Limit ($0.01/$0.02 USD) - 2016/07/11 16:14:38 ET
Table 'Alcyone' 6-max Seat #2 is the button
Seat 1: Scoop15 ($3.05 in chips)
Seat 2: erik51fun ($1.04 in chips)
Seat 3: vealshank ($2.43 in chips)
Seat 4: TY4PAYING ($1.90 in chips)
Seat 6: tapouttazz9 ($1.82 in chips)
vealshank: posts small blind $0.01
TY4PAYING: posts big blind $0.02
*** HOLE CARDS ***
Dealt to tapouttazz9 [Th 5c]
tapouttazz9: folds
Scoop15: folds
erik51fun: folds
vealshank: folds
Uncalled bet ($0.01) returned to TY4PAYING
TY4PAYING collected $0.02 from pot
TY4PAYING: doesn't show hand
*** SUMMARY ***
Total pot $0.02 | Rake $0
Seat 1: Scoop15 folded before Flop (didn't bet)
Seat 2: erik51fun (button) folded before Flop (didn't bet)
Seat 3: vealshank (small blind) folded before Flop
Seat 4: TY4PAYING (big blind) collected ($0.02)
Seat 6: tapouttazz9 folded before Flop (didn't bet)


PokerStars Hand #155626605467:  Hold'em No Limit ($0.01/$0.02 USD) - 2016/07/11 16:14:49 ET
Table 'Alcyone' 6-max Seat #3 is the button
Seat 1: Scoop15 ($3.05 in chips)
Seat 2: erik51fun ($1.04 in chips)
Seat 3: vealshank ($2.42 in chips)
Seat 4: TY4PAYING ($1.91 in chips)
Seat 6: tapouttazz9 ($1.82 in chips)
TY4PAYING: posts small blind $0.01
tapouttazz9: posts big blind $0.02
*** HOLE CARDS ***
Dealt to tapouttazz9 [9d Kd]
Scoop15: folds
erik51fun has timed out
erik51fun: folds
vealshank: folds
TY4PAYING: calls $0.01
tapouttazz9: checks
*** FLOP *** [Js Ad 8s]
TY4PAYING: checks
tapouttazz9: checks
*** TURN *** [Js Ad 8s] [Ks]
TY4PAYING: checks
tapouttazz9: checks
*** RIVER *** [Js Ad 8s Ks] [Qc]
TY4PAYING: checks
tapouttazz9: checks
*** SHOW DOWN ***
TY4PAYING: shows [5d 6h] (high card Ace)
tapouttazz9: shows [9d Kd] (a pair of Kings)
tapouttazz9 collected $0.04 from pot
*** SUMMARY ***
Total pot $0.04 | Rake $0
Board [Js Ad 8s Ks Qc]
Seat 1: Scoop15 folded before Flop (didn't bet)
Seat 2: erik51fun folded before Flop (didn't bet)
Seat 3: vealshank (button) folded before Flop (didn't bet)
Seat 4: TY4PAYING (small blind) showed [5d 6h] and lost with high card Ace
Seat 6: tapouttazz9 (big blind) showed [9d Kd] and won ($0.04) with a pair of Kings


PokerStars Hand #155626605698:  Hold'em No Limit ($0.01/$0.02 USD) - 2016/07/11 16:15:33 ET
Table 'Alcyone' 6-max Seat #4 is the button
Seat 1: Scoop15 ($3.05 in chips)
Seat 2: erik51fun ($1.04 in chips)
Seat 3: vealshank ($2.42 in chips)
Seat 4: TY4PAYING ($1.89 in chips)
Seat 6: tapouttazz9 ($1.84 in chips)
tapouttazz9: posts small blind $0.01
Scoop15: posts big blind $0.02
*** HOLE CARDS ***
Dealt to tapouttazz9 [3c 9s]
erik51fun: calls $0.02
vealshank: raises $0.02 to $0.04
TY4PAYING: folds
tapouttazz9: folds
Scoop15: calls $0.02
erik51fun: calls $0.02
*** FLOP *** [Ah 4d 8h]
Scoop15: checks
erik51fun: checks
vealshank: checks
*** TURN *** [Ah 4d 8h] [Th]
Scoop15: checks
erik51fun: checks
vealshank: bets $0.02
Scoop15: calls $0.02
erik51fun: calls $0.02
*** RIVER *** [Ah 4d 8h Th] [7s]
Scoop15: checks
erik51fun: checks
vealshank: bets $0.02
Scoop15: calls $0.02
erik51fun: calls $0.02
*** SHOW DOWN ***
vealshank: shows [Jc Qs] (high card Ace)
Scoop15: shows [Tc 9c] (a pair of Tens)
erik51fun: mucks hand
Scoop15 collected $0.24 from pot
*** SUMMARY ***
Total pot $0.25 | Rake $0.01
Board [Ah 4d 8h Th 7s]
Seat 1: Scoop15 (big blind) showed [Tc 9c] and won ($0.24) with a pair of Tens
Seat 2: erik51fun mucked [7d 6h]
Seat 3: vealshank showed [Jc Qs] and lost with high card Ace
Seat 4: TY4PAYING (button) folded before Flop (didn't bet)
Seat 6: tapouttazz9 (small blind) folded before Flop


PokerStars Hand #155626606034:  Hold'em No Limit ($0.01/$0.02 USD) - 2016/07/11 16:16:36 ET
Table 'Alcyone' 6-max Seat #6 is the button
Seat 1: Scoop15 ($3.21 in chips)
Seat 2: erik51fun ($0.96 in chips)
Seat 3: vealshank ($2.34 in chips)
Seat 4: TY4PAYING ($1.89 in chips)
Seat 6: tapouttazz9 ($1.83 in chips)
Scoop15: posts small blind $0.01
erik51fun: posts big blind $0.02
TraveIerr: sits out
*** HOLE CARDS ***
Dealt to tapouttazz9 [Ac Th]
vealshank: folds
TY4PAYING: folds
tapouttazz9: raises $0.04 to $0.06
Scoop15: folds
erik51fun: calls $0.04
*** FLOP *** [5c Ah Qs]
erik51fun: checks
tapouttazz9: bets $0.06
erik51fun: calls $0.06
*** TURN *** [5c Ah Qs] [Kc]
erik51fun: checks
tapouttazz9: checks
*** RIVER *** [5c Ah Qs Kc] [2c]
erik51fun: bets $0.84 and is all-in
tapouttazz9: calls $0.84
*** SHOW DOWN ***
erik51fun: shows [Jh As] (a pair of Aces)
tapouttazz9: shows [Ac Th] (a pair of Aces - lower kicker)
erik51fun collected $1.84 from pot
*** SUMMARY ***
Total pot $1.93 | Rake $0.09
Board [5c Ah Qs Kc 2c]
Seat 1: Scoop15 (small blind) folded before Flop
Seat 2: erik51fun (big blind) showed [Jh As] and won ($1.84) with a pair of Aces
Seat 3: vealshank folded before Flop (didn't bet)
Seat 4: TY4PAYING folded before Flop (didn't bet)
Seat 6: tapouttazz9 (button) showed [Ac Th] and lost with a pair of Aces


PokerStars Hand #155626606480:  Hold'em No Limit ($0.01/$0.02 USD) - 2016/07/11 16:17:58 ET
Table 'Alcyone' 6-max Seat #1 is the button
Seat 1: Scoop15 ($3.20 in chips)
Seat 2: erik51fun ($1.84 in chips)
Seat 3: vealshank ($2.34 in chips)
Seat 4: TY4PAYING ($1.89 in chips)
Seat 6: tapouttazz9 ($0.87 in chips)
erik51fun: posts small blind $0.01
vealshank: posts big blind $0.02
TraveIerr: sits out
*** HOLE CARDS ***
Dealt to tapouttazz9 [9s Qs]
TY4PAYING: raises $0.03 to $0.05
tapouttazz9: calls $0.05
Scoop15: folds
erik51fun: folds
vealshank: folds
*** FLOP *** [6s 8c 8d]
TY4PAYING: checks
tapouttazz9: checks
*** TURN *** [6s 8c 8d] [6d]
TY4PAYING: bets $0.08
tapouttazz9: calls $0.08
*** RIVER *** [6s 8c 8d 6d] [8h]
TY4PAYING: checks
tapouttazz9: checks
*** SHOW DOWN ***
TY4PAYING: shows [4s As] (a full house, Eights full of Sixes)
tapouttazz9: shows [9s Qs] (a full house, Eights full of Sixes)
TY4PAYING collected $0.14 from pot
tapouttazz9 collected $0.14 from pot
*** SUMMARY ***
Total pot $0.29 | Rake $0.01
Board [6s 8c 8d 6d 8h]
Seat 1: Scoop15 (button) folded before Flop (didn't bet)
Seat 2: erik51fun (small blind) folded before Flop
Seat 3: vealshank (big blind) folded before Flop
Seat 4: TY4PAYING showed [4s As] and won ($0.14) with a full house, Eights full of Sixes
Seat 6: tapouttazz9 showed [9s Qs] and won ($0.14) with a full house, Eights full of Sixes


PokerStars Hand #155626606735:  Hold'em No Limit ($0.01/$0.02 USD) - 2016/07/11 16:18:47 ET
Table 'Alcyone' 6-max Seat #2 is the button
Seat 1: Scoop15 ($3.20 in chips)
Seat 2: erik51fun ($1.83 in chips)
Seat 3: vealshank ($2.32 in chips)
Seat 4: TY4PAYING ($1.90 in chips)
Seat 6: tapouttazz9 ($2 in chips)
vealshank: posts small blind $0.01
TY4PAYING: posts big blind $0.02
TraveIerr: sits out
*** HOLE CARDS ***
Dealt to tapouttazz9 [7c Kc]
tapouttazz9: folds
Scoop15: folds
erik51fun: folds
vealshank: raises $0.02 to $0.04
TY4PAYING: folds
Uncalled bet ($0.02) returned to vealshank
vealshank collected $0.04 from pot
*** SUMMARY ***
Total pot $0.04 | Rake $0
Seat 1: Scoop15 folded before Flop (didn't bet)
Seat 2: erik51fun (button) folded before Flop (didn't bet)
Seat 3: vealshank (small blind) collected ($0.04)
Seat 4: TY4PAYING (big blind) folded before Flop
Seat 6: tapouttazz9 folded before Flop (didn't bet)


PokerStars Hand #155626606810:  Hold'em No Limit ($0.01/$0.02 USD) - 2016/07/11 16:18:59 ET
Table 'Alcyone' 6-max Seat #3 is the button
Seat 1: Scoop15 ($3.20 in chips)
Seat 2: erik51fun ($1.83 in chips)
Seat 3: vealshank ($2.34 in chips)
Seat 4: TY4PAYING ($1.88 in chips)
Seat 5: TraveIerr ($3.10 in chips)
Seat 6: tapouttazz9 ($2 in chips)
TY4PAYING: posts small blind $0.01
TraveIerr: posts big blind $0.02
*** HOLE CARDS ***
Dealt to tapouttazz9 [3h 5c]
tapouttazz9: folds
Scoop15: folds
erik51fun: folds
vealshank: folds
TY4PAYING: raises $0.02 to $0.04
TraveIerr: calls $0.02
*** FLOP *** [Kd 9s Tc]
TY4PAYING: bets $0.04
TraveIerr: folds
Uncalled bet ($0.04) returned to TY4PAYING
TY4PAYING collected $0.08 from pot
TY4PAYING: doesn't show hand
*** SUMMARY ***
Total pot $0.08 | Rake $0
Board [Kd 9s Tc]
Seat 1: Scoop15 folded before Flop (didn't bet)
Seat 2: erik51fun folded before Flop (didn't bet)
Seat 3: vealshank (button) folded before Flop (didn't bet)
Seat 4: TY4PAYING (small blind) collected ($0.08)
Seat 5: TraveIerr (big blind) folded on the Flop
Seat 6: tapouttazz9 folded before Flop (didn't bet)


PokerStars Hand #155626606972:  Hold'em No Limit ($0.01/$0.02 USD) - 2016/07/11 16:19:29 ET
Table 'Alcyone' 6-max Seat #4 is the button
Seat 1: Scoop15 ($3.20 in chips)
Seat 2: erik51fun ($1.83 in chips)
Seat 3: vealshank ($2.34 in chips)
Seat 4: TY4PAYING ($1.92 in chips)
Seat 5: TraveIerr ($3.06 in chips)
Seat 6: tapouttazz9 ($2 in chips)
TraveIerr: posts small blind $0.01
tapouttazz9: posts big blind $0.02
*** HOLE CARDS ***
Dealt to tapouttazz9 [Qs 4d]
Scoop15: raises $0.02 to $0.04
erik51fun: folds
vealshank: calls $0.04
TY4PAYING: folds
TraveIerr: folds
tapouttazz9: folds
*** FLOP *** [Ac 2d As]
Scoop15: bets $0.04
vealshank: calls $0.04
*** TURN *** [Ac 2d As] [3s]
Scoop15: bets $0.10
vealshank: folds
Uncalled bet ($0.10) returned to Scoop15
Scoop15 collected $0.18 from pot
Scoop15: doesn't show hand
*** SUMMARY ***
Total pot $0.19 | Rake $0.01
Board [Ac 2d As 3s]
Seat 1: Scoop15 collected ($0.18)
Seat 2: erik51fun folded before Flop (didn't bet)
Seat 3: vealshank folded on the Turn
Seat 4: TY4PAYING (button) folded before Flop (didn't bet)
Seat 5: TraveIerr (small blind) folded before Flop
Seat 6: tapouttazz9 (big blind) folded before Flop


PokerStars Hand #155626607178:  Hold'em No Limit ($0.01/$0.02 USD) - 2016/07/11 16:20:06 ET
Table 'Alcyone' 6-max Seat #5 is the button
Seat 1: Scoop15 ($3.30 in chips)
Seat 2: erik51fun ($1.83 in chips)
Seat 3: vealshank ($2.26 in chips)
Seat 4: TY4PAYING ($1.92 in chips)
Seat 5: TraveIerr ($3.05 in chips)
Seat 6: tapouttazz9 ($1.98 in chips)
tapouttazz9: posts small blind $0.01
Scoop15: posts big blind $0.02
*** HOLE CARDS ***
Dealt to tapouttazz9 [Qh 2s]
erik51fun: folds
vealshank: folds
vealshank leaves the table
TY4PAYING: raises $0.03 to $0.05
TraveIerr: folds
tapouttazz9: folds
Scoop15: folds
Uncalled bet ($0.03) returned to TY4PAYING
TY4PAYING collected $0.05 from pot
TY4PAYING: doesn't show hand
*** SUMMARY ***
Total pot $0.05 | Rake $0
Seat 1: Scoop15 (big blind) folded before Flop
Seat 2: erik51fun folded before Flop (didn't bet)
Seat 3: vealshank folded before Flop (didn't bet)
Seat 4: TY4PAYING collected ($0.05)
Seat 5: TraveIerr (button) folded before Flop (didn't bet)
Seat 6: tapouttazz9 (small blind) folded before Flop


PokerStars Hand #155626607265:  Hold'em No Limit ($0.01/$0.02 USD) - 2016/07/11 16:20:23 ET
Table 'Alcyone' 6-max Seat #6 is the button
Seat 1: Scoop15 ($3.28 in chips)
Seat 2: erik51fun ($1.83 in chips)
Seat 4: TY4PAYING ($1.95 in chips)
Seat 5: TraveIerr ($3.05 in chips)
Seat 6: tapouttazz9 ($1.97 in chips)
Scoop15: posts small blind $0.01
erik51fun: posts big blind $0.02
*** HOLE CARDS ***
Dealt to tapouttazz9 [5s Kh]
TY4PAYING: folds
TraveIerr has timed out
TraveIerr: folds
tapouttazz9: folds
Scoop15: folds
Uncalled bet ($0.01) returned to erik51fun
erik51fun collected $0.02 from pot
erik51fun: doesn't show hand
*** SUMMARY ***
Total pot $0.02 | Rake $0
Seat 1: Scoop15 (small blind) folded before Flop
Seat 2: erik51fun (big blind) collected ($0.02)
Seat 4: TY4PAYING folded before Flop (didn't bet)
Seat 5: TraveIerr folded before Flop (didn't bet)
Seat 6: tapouttazz9 (button) folded before Flop (didn't bet)


PokerStars Hand #155626607403:  Hold'em No Limit ($0.01/$0.02 USD) - 2016/07/11 16:20:49 ET
Table 'Alcyone' 6-max Seat #1 is the button
Seat 1: Scoop15 ($3.27 in chips)
Seat 2: erik51fun ($1.84 in chips)
Seat 6: tapouttazz9 ($1.97 in chips)
erik51fun: posts small blind $0.01
TY4PAYING: is sitting out
TY4PAYING leaves the table
tapouttazz9: posts big blind $0.02
*** HOLE CARDS ***
Dealt to tapouttazz9 [6s Qs]
Scoop15: folds
erik51fun: calls $0.01
tapouttazz9: checks
*** FLOP *** [3h Ad Qc]
erik51fun: checks
tapouttazz9: checks
*** TURN *** [3h Ad Qc] [Qd]
erik51fun: bets $0.10
tapouttazz9: calls $0.10
*** RIVER *** [3h Ad Qc Qd] [Ah]
erik51fun: bets $1.72 and is all-in
tapouttazz9: folds [Qs]
Uncalled bet ($1.72) returned to erik51fun
erik51fun collected $0.23 from pot
erik51fun: doesn't show hand
*** SUMMARY ***
Total pot $0.24 | Rake $0.01
Board [3h Ad Qc Qd Ah]
Seat 1: Scoop15 (button) folded before Flop (didn't bet)
Seat 2: erik51fun (small blind) collected ($0.23)
Seat 6: tapouttazz9 (big blind) folded on the River


PokerStars Hand #155626607653:  Hold'em No Limit ($0.01/$0.02 USD) - 2016/07/11 16:21:34 ET
Table 'Alcyone' 6-max Seat #2 is the button
Seat 1: Scoop15 ($3.27 in chips)
Seat 2: erik51fun ($1.95 in chips)
Seat 6: tapouttazz9 ($1.85 in chips)
TraveIerr will be allowed to play after the button
tapouttazz9: posts small blind $0.01
Scoop15: posts big blind $0.02
*** HOLE CARDS ***
Dealt to tapouttazz9 [3c Jh]
erik51fun: folds
tapouttazz9: folds
Uncalled bet ($0.01) returned to Scoop15
Scoop15 collected $0.02 from pot
Scoop15: doesn't show hand
*** SUMMARY ***
Total pot $0.02 | Rake $0
Seat 1: Scoop15 (big blind) collected ($0.02)
Seat 2: erik51fun (button) folded before Flop (didn't bet)
Seat 6: tapouttazz9 (small blind) folded before Flop


PokerStars Hand #155626607691:  Hold'em No Limit ($0.01/$0.02 USD) - 2016/07/11 16:21:44 ET
Table 'Alcyone' 6-max Seat #6 is the button
Seat 1: Scoop15 ($3.28 in chips)
Seat 2: erik51fun ($1.95 in chips)
Seat 6: tapouttazz9 ($1.84 in chips)
Scoop15: posts small blind $0.01
erik51fun: posts big blind $0.02
TraveIerr: sits out
*** HOLE CARDS ***
Dealt to tapouttazz9 [4c 3h]
tapouttazz9: folds
Scoop15: calls $0.01
erik51fun: checks
*** FLOP *** [5s Jd Jc]
Scoop15: checks
erik51fun: checks
*** TURN *** [5s Jd Jc] [3d]
Scoop15: checks
erik51fun: checks
*** RIVER *** [5s Jd Jc 3d] [4h]
Scoop15: bets $0.04
erik51fun: folds
Uncalled bet ($0.04) returned to Scoop15
Scoop15 collected $0.04 from pot
Scoop15: doesn't show hand
*** SUMMARY ***
Total pot $0.04 | Rake $0
Board [5s Jd Jc 3d 4h]
Seat 1: Scoop15 (small blind) collected ($0.04)
Seat 2: erik51fun (big blind) folded on the River
Seat 6: tapouttazz9 (button) folded before Flop (didn't bet)


PokerStars Hand #155626607816:  Hold'em No Limit ($0.01/$0.02 USD) - 2016/07/11 16:22:09 ET
Table 'Alcyone' 6-max Seat #1 is the button
Seat 1: Scoop15 ($3.30 in chips)
Seat 2: erik51fun ($1.93 in chips)
Seat 5: TraveIerr ($3.05 in chips)
Seat 6: tapouttazz9 ($1.84 in chips)
erik51fun: posts small blind $0.01
TraveIerr: posts big blind $0.02
*** HOLE CARDS ***
Dealt to tapouttazz9 [7h 3c]
tapouttazz9: folds
Scoop15: folds
erik51fun: calls $0.01
TraveIerr: checks
*** FLOP *** [2h 5c 8h]
erik51fun: bets $0.02
TraveIerr: calls $0.02
*** TURN *** [2h 5c 8h] [Td]
erik51fun: checks
TraveIerr: checks
*** RIVER *** [2h 5c 8h Td] [2c]
erik51fun: bets $0.02
TraveIerr: folds
Uncalled bet ($0.02) returned to erik51fun
erik51fun collected $0.08 from pot
erik51fun: doesn't show hand
*** SUMMARY ***
Total pot $0.08 | Rake $0
Board [2h 5c 8h Td 2c]
Seat 1: Scoop15 (button) folded before Flop (didn't bet)
Seat 2: erik51fun (small blind) collected ($0.08)
Seat 5: TraveIerr (big blind) folded on the River
Seat 6: tapouttazz9 folded before Flop (didn't bet)


PokerStars Hand #155626608054:  Hold'em No Limit ($0.01/$0.02 USD) - 2016/07/11 16:22:54 ET
Table 'Alcyone' 6-max Seat #2 is the button
Seat 1: Scoop15 ($3.30 in chips)
Seat 2: erik51fun ($1.97 in chips)
Seat 5: TraveIerr ($3.01 in chips)
Seat 6: tapouttazz9 ($1.84 in chips)
TraveIerr: posts small blind $0.01
tapouttazz9: posts big blind $0.02
*** HOLE CARDS ***
Dealt to tapouttazz9 [Ah As]
Scoop15: raises $0.02 to $0.04
erik51fun: calls $0.04
TraveIerr: calls $0.03
tapouttazz9: raises $0.06 to $0.10
Scoop15: calls $0.06
erik51fun: folds
TraveIerr: calls $0.06
*** FLOP *** [7s Kc 2d]
TraveIerr: checks
tapouttazz9: bets $0.32
Scoop15: folds
TraveIerr: folds
Uncalled bet ($0.32) returned to tapouttazz9
tapouttazz9 collected $0.32 from pot
tapouttazz9: doesn't show hand
*** SUMMARY ***
Total pot $0.34 | Rake $0.02
Board [7s Kc 2d]
Seat 1: Scoop15 folded on the Flop
Seat 2: erik51fun (button) folded before Flop
Seat 5: TraveIerr (small blind) folded on the Flop
Seat 6: tapouttazz9 (big blind) collected ($0.32)


PokerStars Hand #155626608347:  Hold'em No Limit ($0.01/$0.02 USD) - 2016/07/11 16:23:52 ET
Table 'Alcyone' 6-max Seat #5 is the button
Seat 2: erik51fun ($1.93 in chips)
Seat 5: TraveIerr ($2.91 in chips)
Seat 6: tapouttazz9 ($2.06 in chips)
tapouttazz9: posts small blind $0.01
erik51fun: posts big blind $0.02
*** HOLE CARDS ***
Dealt to tapouttazz9 [8d Kd]
TraveIerr: folds
tapouttazz9: raises $0.04 to $0.06
erik51fun: calls $0.04
*** FLOP *** [9d Tc 2d]
tapouttazz9: bets $0.05
erik51fun: folds
Uncalled bet ($0.05) returned to tapouttazz9
tapouttazz9 collected $0.11 from pot
tapouttazz9: doesn't show hand
*** SUMMARY ***
Total pot $0.12 | Rake $0.01
Board [9d Tc 2d]
Seat 2: erik51fun (big blind) folded on the Flop
Seat 5: TraveIerr (button) folded before Flop (didn't bet)
Seat 6: tapouttazz9 (small blind) collected ($0.11)


PokerStars Hand #155626608454:  Hold'em No Limit ($0.01/$0.02 USD) - 2016/07/11 16:24:11 ET
Table 'Alcyone' 6-max Seat #6 is the button
Seat 2: erik51fun ($1.87 in chips)
Seat 5: TraveIerr ($2.91 in chips)
Seat 6: tapouttazz9 ($2.11 in chips)
erik51fun: posts small blind $0.01
TraveIerr: posts big blind $0.02
*** HOLE CARDS ***
Dealt to tapouttazz9 [6d 6c]
tapouttazz9: raises $0.04 to $0.06
erik51fun: folds
TraveIerr: calls $0.04
*** FLOP *** [Qd 4s 9c]
TraveIerr: checks
tapouttazz9: checks
*** TURN *** [Qd 4s 9c] [3d]
TraveIerr: bets $0.07
tapouttazz9: calls $0.07
*** RIVER *** [Qd 4s 9c 3d] [Ts]
TraveIerr: bets $0.15
nicolew0320 joins the table at seat #4
tapouttazz9: folds
Uncalled bet ($0.15) returned to TraveIerr
TraveIerr collected $0.26 from pot
TraveIerr: doesn't show hand
*** SUMMARY ***
Total pot $0.27 | Rake $0.01
Board [Qd 4s 9c 3d Ts]
Seat 2: erik51fun (small blind) folded before Flop
Seat 5: TraveIerr (big blind) collected ($0.26)
Seat 6: tapouttazz9 (button) folded on the River


PokerStars Hand #155626608685:  Hold'em No Limit ($0.01/$0.02 USD) - 2016/07/11 16:24:52 ET
Table 'Alcyone' 6-max Seat #2 is the button
Seat 2: erik51fun ($1.86 in chips)
Seat 5: TraveIerr ($3.04 in chips)
Seat 6: tapouttazz9 ($1.98 in chips)
nicolew0320 will be allowed to play after the button
TraveIerr: posts small blind $0.01
tapouttazz9: posts big blind $0.02
*** HOLE CARDS ***
Dealt to tapouttazz9 [9s 6s]
erik51fun: folds
TraveIerr: folds
Uncalled bet ($0.01) returned to tapouttazz9
tapouttazz9 collected $0.02 from pot
tapouttazz9: doesn't show hand
*** SUMMARY ***
Total pot $0.02 | Rake $0
Seat 2: erik51fun (button) folded before Flop (didn't bet)
Seat 5: TraveIerr (small blind) folded before Flop
Seat 6: tapouttazz9 (big blind) collected ($0.02)


PokerStars Hand #155626608746:  Hold'em No Limit ($0.01/$0.02 USD) - 2016/07/11 16:25:05 ET
Table 'Alcyone' 6-max Seat #5 is the button
Seat 2: erik51fun ($1.86 in chips)
Seat 4: nicolew0320 ($2 in chips)
Seat 5: TraveIerr ($3.03 in chips)
Seat 6: tapouttazz9 ($1.99 in chips)
tapouttazz9: posts small blind $0.01
erik51fun: posts big blind $0.02
nicolew0320: posts big blind $0.02
*** HOLE CARDS ***
Dealt to tapouttazz9 [9s Th]
nicolew0320: checks
TraveIerr: calls $0.02
tapouttazz9: raises $0.02 to $0.04
JZappa joins the table at seat #3
erik51fun: folds
nicolew0320: calls $0.02
TraveIerr: calls $0.02
*** FLOP *** [7h 9h 9d]
tapouttazz9: checks
nicolew0320: checks
TraveIerr: checks
*** TURN *** [7h 9h 9d] [6d]
tapouttazz9: bets $0.09
nicolew0320: folds
TraveIerr: raises $0.18 to $0.27
nicolew0320 leaves the table
tapouttazz9: raises $0.43 to $0.70
TraveIerr: raises $2.29 to $2.99 and is all-in
tapouttazz9: calls $1.25 and is all-in
Uncalled bet ($1.04) returned to TraveIerr
*** RIVER *** [7h 9h 9d 6d] [3c]
*** SHOW DOWN ***
tapouttazz9: shows [9s Th] (three of a kind, Nines)
TraveIerr: shows [5d 8d] (a straight, Five to Nine)
TraveIerr collected $3.86 from pot
*** SUMMARY ***
Total pot $4.04 | Rake $0.18
Board [7h 9h 9d 6d 3c]
Seat 2: erik51fun (big blind) folded before Flop
Seat 4: nicolew0320 folded on the Turn
Seat 5: TraveIerr (button) showed [5d 8d] and won ($3.86) with a straight, Five to Nine
Seat 6: tapouttazz9 (small blind) showed [9s Th] and lost with three of a kind, Nines


PokerStars Hand #155626609005:  Hold'em No Limit ($0.01/$0.02 USD) - 2016/07/11 16:25:57 ET
Table 'Alcyone' 6-max Seat #5 is the button
Seat 2: erik51fun ($1.84 in chips)
Seat 5: TraveIerr ($4.90 in chips)
JZappa will be allowed to play after the button
TraveIerr: posts small blind $0.01
erik51fun: posts big blind $0.02
*** HOLE CARDS ***
TraveIerr: calls $0.01
erik51fun: checks
*** FLOP *** [Kh 4s 2h]
erik51fun: checks
TraveIerr: checks
*** TURN *** [Kh 4s 2h] [2s]
erik51fun: bets $0.02
TraveIerr: calls $0.02
*** RIVER *** [Kh 4s 2h 2s] [6c]
erik51fun: bets $0.02
TraveIerr: folds
Uncalled bet ($0.02) returned to erik51fun
erik51fun collected $0.08 from pot
erik51fun: doesn't show hand
*** SUMMARY ***
Total pot $0.08 | Rake $0
Board [Kh 4s 2h 2s 6c]
Seat 2: erik51fun (big blind) collected ($0.08)
Seat 5: TraveIerr (button) (small blind) folded on the River


PokerStars Hand #155626609198:  Hold'em No Limit ($0.01/$0.02 USD) - 2016/07/11 16:26:33 ET
Table 'Alcyone' 6-max Seat #5 is the button
Seat 2: erik51fun ($1.88 in chips)
Seat 3: JZappa ($1.60 in chips)
Seat 5: TraveIerr ($4.86 in chips)
erik51fun: posts small blind $0.01
JZappa: posts big blind $0.02
*** HOLE CARDS ***
TraveIerr: raises $0.05 to $0.07
erik51fun: calls $0.06
JZappa: folds
*** FLOP *** [9d 5c 7s]
erik51fun: bets $0.30
TraveIerr: folds
Uncalled bet ($0.30) returned to erik51fun
erik51fun collected $0.15 from pot
erik51fun: doesn't show hand
*** SUMMARY ***
Total pot $0.16 | Rake $0.01
Board [9d 5c 7s]
Seat 2: erik51fun (small blind) collected ($0.15)
Seat 3: JZappa (big blind) folded before Flop
Seat 5: TraveIerr (button) folded on the Flop


PokerStars Hand #155626609510:  Hold'em No Limit ($0.01/$0.02 USD) - 2016/07/11 16:27:34 ET
Table 'Alcyone' 6-max Seat #2 is the button
Seat 2: erik51fun ($1.96 in chips)
Seat 3: JZappa ($1.58 in chips)
Seat 5: TraveIerr ($4.79 in chips)
JZappa: posts small blind $0.01
TraveIerr: posts big blind $0.02
*** HOLE CARDS ***
erik51fun: folds
JZappa: calls $0.01
TraveIerr: checks
*** FLOP *** [4s 9h Qs]
JZappa: bets $0.04
TraveIerr: folds
Uncalled bet ($0.04) returned to JZappa
JZappa collected $0.04 from pot
JZappa: doesn't show hand
*** SUMMARY ***
Total pot $0.04 | Rake $0
Board [4s 9h Qs]
Seat 2: erik51fun (button) folded before Flop (didn't bet)
Seat 3: JZappa (small blind) collected ($0.04)
Seat 5: TraveIerr (big blind) folded on the Flop


PokerStars Hand #155626609583:  Hold'em No Limit ($0.01/$0.02 USD) - 2016/07/11 16:27:47 ET
Table 'Alcyone' 6-max Seat #3 is the button
Seat 2: erik51fun ($1.96 in chips)
Seat 3: JZappa ($1.60 in chips)
Seat 5: TraveIerr ($4.77 in chips)
TraveIerr: posts small blind $0.01
erik51fun: posts big blind $0.02
*** HOLE CARDS ***
JZappa: calls $0.02
TraveIerr: calls $0.01
erik51fun: checks
*** FLOP *** [Kh 2h Ks]
TraveIerr: checks
erik51fun: checks
JZappa: checks
*** TURN *** [Kh 2h Ks] [2c]
TraveIerr: checks
erik51fun: checks
JZappa: checks
*** RIVER *** [Kh 2h Ks 2c] [5d]
TraveIerr: bets $0.04
erik51fun: folds
JZappa: folds
Uncalled bet ($0.04) returned to TraveIerr
TraveIerr collected $0.06 from pot
TraveIerr: doesn't show hand
*** SUMMARY ***
Total pot $0.06 | Rake $0
Board [Kh 2h Ks 2c 5d]
Seat 2: erik51fun (big blind) folded on the River
Seat 3: JZappa (button) folded on the River
Seat 5: TraveIerr (small blind) collected ($0.06)


PokerStars Hand #155626609847:  Hold'em No Limit ($0.01/$0.02 USD) - 2016/07/11 16:28:42 ET
Table 'Alcyone' 6-max Seat #5 is the button
Seat 2: erik51fun ($1.94 in chips)
Seat 3: JZappa ($1.58 in chips)
Seat 5: TraveIerr ($4.81 in chips)
tapouttazz9 will be allowed to play after the button
erik51fun: posts small blind $0.01
JZappa: posts big blind $0.02
*** HOLE CARDS ***
TraveIerr: raises $0.04 to $0.06
erik51fun: folds
JZappa: calls $0.04
*** FLOP *** [5h As 5c]
JZappa: checks
PINGASSO201 joins the table at seat #4
TraveIerr: checks
*** TURN *** [5h As 5c] [Td]
JZappa: checks
TraveIerr: checks
*** RIVER *** [5h As 5c Td] [Qd]
JZappa: bets $0.12
TraveIerr: folds
Uncalled bet ($0.12) returned to JZappa
JZappa collected $0.12 from pot
JZappa: doesn't show hand
*** SUMMARY ***
Total pot $0.13 | Rake $0.01
Board [5h As 5c Td Qd]
Seat 2: erik51fun (small blind) folded before Flop
Seat 3: JZappa (big blind) collected ($0.12)
Seat 5: TraveIerr (button) folded on the River


PokerStars Hand #155627596300:  Hold'em No Limit ($0.01/$0.02 USD) - 2016/07/11 16:29:31 ET
Table 'Alcyone' 6-max Seat #2 is the button
Seat 2: erik51fun ($1.93 in chips)
Seat 3: JZappa ($1.64 in chips)
Seat 4: PINGASSO201 ($2 in chips)
Seat 5: TraveIerr ($4.75 in chips)
JZappa: posts small blind $0.01
PINGASSO201: posts big blind $0.02
tapouttazz9: sits out
*** HOLE CARDS ***
TraveIerr: raises $0.04 to $0.06
erik51fun: folds
JZappa: folds
PINGASSO201: folds
Uncalled bet ($0.04) returned to TraveIerr
TraveIerr collected $0.05 from pot
TraveIerr: doesn't show hand
*** SUMMARY ***
Total pot $0.05 | Rake $0
Seat 2: erik51fun (button) folded before Flop (didn't bet)
Seat 3: JZappa (small blind) folded before Flop
Seat 4: PINGASSO201 (big blind) folded before Flop
Seat 5: TraveIerr collected ($0.05)


PokerStars Hand #155627596399:  Hold'em No Limit ($0.01/$0.02 USD) - 2016/07/11 16:29:51 ET
Table 'Alcyone' 6-max Seat #3 is the button
Seat 2: erik51fun ($1.93 in chips)
Seat 3: JZappa ($1.63 in chips)
Seat 4: PINGASSO201 ($1.98 in chips)
Seat 5: TraveIerr ($4.78 in chips)
PINGASSO201: posts small blind $0.01
TraveIerr: posts big blind $0.02
tapouttazz9: sits out
*** HOLE CARDS ***
erik51fun: folds
JZappa: folds
PINGASSO201: calls $0.01
TraveIerr: checks
*** FLOP *** [8s 9s Jc]
PINGASSO201: checks
TraveIerr: checks
*** TURN *** [8s 9s Jc] [4c]
PINGASSO201: bets $0.02
TraveIerr: folds
Uncalled bet ($0.02) returned to PINGASSO201
PINGASSO201 collected $0.04 from pot
PINGASSO201: doesn't show hand
*** SUMMARY ***
Total pot $0.04 | Rake $0
Board [8s 9s Jc 4c]
Seat 2: erik51fun folded before Flop (didn't bet)
Seat 3: JZappa (button) folded before Flop (didn't bet)
Seat 4: PINGASSO201 (small blind) collected ($0.04)
Seat 5: TraveIerr (big blind) folded on the Turn


PokerStars Hand #155627596532:  Hold'em No Limit ($0.01/$0.02 USD) - 2016/07/11 16:30:23 ET
Table 'Alcyone' 6-max Seat #4 is the button
Seat 2: erik51fun ($1.93 in chips)
Seat 3: JZappa ($1.63 in chips)
Seat 4: PINGASSO201 ($2 in chips)
Seat 5: TraveIerr ($4.76 in chips)
Seat 6: tapouttazz9 ($2 in chips)
TraveIerr: posts small blind $0.01
tapouttazz9: posts big blind $0.02
*** HOLE CARDS ***
Dealt to tapouttazz9 [3h Ad]
erik51fun: folds
JZappa has timed out
JZappa: folds
PINGASSO201: folds
TraveIerr: calls $0.01
tapouttazz9: checks
*** FLOP *** [3s 2h Qd]
TraveIerr: checks
tapouttazz9: checks
*** TURN *** [3s 2h Qd] [3d]
TraveIerr: checks
tapouttazz9: bets $0.03
TraveIerr: folds
Uncalled bet ($0.03) returned to tapouttazz9
tapouttazz9 collected $0.04 from pot
tapouttazz9: doesn't show hand
*** SUMMARY ***
Total pot $0.04 | Rake $0
Board [3s 2h Qd 3d]
Seat 2: erik51fun folded before Flop (didn't bet)
Seat 3: JZappa folded before Flop (didn't bet)
Seat 4: PINGASSO201 (button) folded before Flop (didn't bet)
Seat 5: TraveIerr (small blind) folded on the Turn
Seat 6: tapouttazz9 (big blind) collected ($0.04)


PokerStars Hand #155627596759:  Hold'em No Limit ($0.01/$0.02 USD) - 2016/07/11 16:31:11 ET
Table 'Alcyone' 6-max Seat #5 is the button
Seat 2: erik51fun ($1.93 in chips)
Seat 3: JZappa ($1.63 in chips)
Seat 4: PINGASSO201 ($2 in chips)
Seat 5: TraveIerr ($4.74 in chips)
Seat 6: tapouttazz9 ($2.02 in chips)
tapouttazz9: posts small blind $0.01
erik51fun: posts big blind $0.02
*** HOLE CARDS ***
Dealt to tapouttazz9 [9d 4s]
JZappa: calls $0.02
PINGASSO201: folds
TraveIerr: raises $0.07 to $0.09
tapouttazz9: folds
erik51fun: folds
JZappa: calls $0.07
*** FLOP *** [5d 6s 5c]
JZappa: checks
TraveIerr: bets $0.12
JZappa: folds
Uncalled bet ($0.12) returned to TraveIerr
TraveIerr collected $0.20 from pot
TraveIerr: doesn't show hand
*** SUMMARY ***
Total pot $0.21 | Rake $0.01
Board [5d 6s 5c]
Seat 2: erik51fun (big blind) folded before Flop
Seat 3: JZappa folded on the Flop
Seat 4: PINGASSO201 folded before Flop (didn't bet)
Seat 5: TraveIerr (button) collected ($0.20)
Seat 6: tapouttazz9 (small blind) folded before Flop


PokerStars Hand #155627597012:  Hold'em No Limit ($0.01/$0.02 USD) - 2016/07/11 16:31:58 ET
Table 'Alcyone' 6-max Seat #6 is the button
Seat 2: erik51fun ($1.91 in chips)
Seat 3: JZappa ($1.54 in chips)
Seat 4: PINGASSO201 ($2 in chips)
Seat 5: TraveIerr ($4.85 in chips)
Seat 6: tapouttazz9 ($2.01 in chips)
erik51fun: posts small blind $0.01
JZappa: posts big blind $0.02
*** HOLE CARDS ***
Dealt to tapouttazz9 [Th 8s]
PINGASSO201: raises $0.04 to $0.06
TraveIerr: folds
tapouttazz9: folds
erik51fun: folds
JZappa: folds
Uncalled bet ($0.04) returned to PINGASSO201
PINGASSO201 collected $0.05 from pot
PINGASSO201: doesn't show hand
*** SUMMARY ***
Total pot $0.05 | Rake $0
Seat 2: erik51fun (small blind) folded before Flop
Seat 3: JZappa (big blind) folded before Flop
Seat 4: PINGASSO201 collected ($0.05)
Seat 5: TraveIerr folded before Flop (didn't bet)
Seat 6: tapouttazz9 (button) folded before Flop (didn't bet)


PokerStars Hand #155627597089:  Hold'em No Limit ($0.01/$0.02 USD) - 2016/07/11 16:32:18 ET
Table 'Alcyone' 6-max Seat #2 is the button
Seat 2: erik51fun ($1.90 in chips)
Seat 3: JZappa ($1.52 in chips)
Seat 4: PINGASSO201 ($2.03 in chips)
Seat 5: TraveIerr ($4.85 in chips)
Seat 6: tapouttazz9 ($2.01 in chips)
JZappa: posts small blind $0.01
PINGASSO201: posts big blind $0.02
*** HOLE CARDS ***
Dealt to tapouttazz9 [Jc 3h]
TraveIerr: folds
tapouttazz9: folds
erik51fun: calls $0.02
JZappa: raises $0.04 to $0.06
PINGASSO201: folds
erik51fun: folds
Uncalled bet ($0.04) returned to JZappa
JZappa collected $0.06 from pot
JZappa: doesn't show hand
*** SUMMARY ***
Total pot $0.06 | Rake $0
Seat 2: erik51fun (button) folded before Flop
Seat 3: JZappa (small blind) collected ($0.06)
Seat 4: PINGASSO201 (big blind) folded before Flop
Seat 5: TraveIerr folded before Flop (didn't bet)
Seat 6: tapouttazz9 folded before Flop (didn't bet)


PokerStars Hand #155627597182:  Hold'em No Limit ($0.01/$0.02 USD) - 2016/07/11 16:32:36 ET
Table 'Alcyone' 6-max Seat #3 is the button
Seat 2: erik51fun ($1.88 in chips)
Seat 3: JZappa ($1.56 in chips)
Seat 4: PINGASSO201 ($2.01 in chips)
Seat 5: TraveIerr ($4.85 in chips)
Seat 6: tapouttazz9 ($2.01 in chips)
PINGASSO201: posts small blind $0.01
TraveIerr: posts big blind $0.02
Scoop15: sits out
*** HOLE CARDS ***
Dealt to tapouttazz9 [3d 2c]
tapouttazz9: folds
erik51fun: calls $0.02
JZappa: folds
PINGASSO201: folds
TraveIerr: checks
*** FLOP *** [4h Th Tc]
TraveIerr: checks
erik51fun: bets $0.02
TraveIerr: folds
Uncalled bet ($0.02) returned to erik51fun
erik51fun collected $0.05 from pot
erik51fun: doesn't show hand
*** SUMMARY ***
Total pot $0.05 | Rake $0
Board [4h Th Tc]
Seat 2: erik51fun collected ($0.05)
Seat 3: JZappa (button) folded before Flop (didn't bet)
Seat 4: PINGASSO201 (small blind) folded before Flop
Seat 5: TraveIerr (big blind) folded on the Flop
Seat 6: tapouttazz9 folded before Flop (didn't bet)


PokerStars Hand #155627597314:  Hold'em No Limit ($0.01/$0.02 USD) - 2016/07/11 16:33:00 ET
Table 'Alcyone' 6-max Seat #4 is the button
Seat 2: erik51fun ($1.91 in chips)
Seat 3: JZappa ($1.56 in chips)
Seat 4: PINGASSO201 ($2 in chips)
Seat 5: TraveIerr ($4.83 in chips)
Seat 6: tapouttazz9 ($2.01 in chips)
TraveIerr: posts small blind $0.01
tapouttazz9: posts big blind $0.02
Scoop15: sits out
*** HOLE CARDS ***
Dealt to tapouttazz9 [Ah 9d]
erik51fun: folds
JZappa: folds
PINGASSO201: calls $0.02
TraveIerr: calls $0.01
tapouttazz9: checks
*** FLOP *** [Ts Qh 9s]
TraveIerr: checks
tapouttazz9: checks
PINGASSO201: bets $0.04
TraveIerr: raises $0.12 to $0.16
tapouttazz9: folds
PINGASSO201: raises $0.34 to $0.50
TraveIerr: raises $4.31 to $4.81 and is all-in
PINGASSO201: folds [Qd]
Uncalled bet ($4.31) returned to TraveIerr
TraveIerr collected $1.01 from pot
TraveIerr: doesn't show hand
*** SUMMARY ***
Total pot $1.06 | Rake $0.05
Board [Ts Qh 9s]
Seat 2: erik51fun folded before Flop (didn't bet)
Seat 3: JZappa folded before Flop (didn't bet)
Seat 4: PINGASSO201 (button) folded on the Flop
Seat 5: TraveIerr (small blind) collected ($1.01)
Seat 6: tapouttazz9 (big blind) folded on the Flop


PokerStars Hand #155627597794:  Hold'em No Limit ($0.01/$0.02 USD) - 2016/07/11 16:34:29 ET
Table 'Alcyone' 6-max Seat #5 is the button
Seat 1: Scoop15 ($3.20 in chips)
Seat 2: erik51fun ($1.91 in chips)
Seat 3: JZappa ($1.56 in chips)
Seat 4: PINGASSO201 ($1.48 in chips)
Seat 5: TraveIerr ($5.32 in chips)
Seat 6: tapouttazz9 ($1.99 in chips)
tapouttazz9: posts small blind $0.01
Scoop15: posts big blind $0.02
*** HOLE CARDS ***
Dealt to tapouttazz9 [Jh 8c]
erik51fun: calls $0.02
JZappa: folds
PINGASSO201: folds
TraveIerr: calls $0.02
tapouttazz9: folds
Scoop15: checks
*** FLOP *** [5d 2c 6d]
Scoop15: checks
erik51fun: checks
TraveIerr: bets $0.08
Scoop15: folds
erik51fun: folds
Uncalled bet ($0.08) returned to TraveIerr
TraveIerr collected $0.07 from pot
TraveIerr: doesn't show hand
*** SUMMARY ***
Total pot $0.07 | Rake $0
Board [5d 2c 6d]
Seat 1: Scoop15 (big blind) folded on the Flop
Seat 2: erik51fun folded on the Flop
Seat 3: JZappa folded before Flop (didn't bet)
Seat 4: PINGASSO201 folded before Flop (didn't bet)
Seat 5: TraveIerr (button) collected ($0.07)
Seat 6: tapouttazz9 (small blind) folded before Flop


PokerStars Hand #155627598014:  Hold'em No Limit ($0.01/$0.02 USD) - 2016/07/11 16:35:09 ET
Table 'Alcyone' 6-max Seat #6 is the button
Seat 1: Scoop15 ($3.18 in chips)
Seat 2: erik51fun ($1.89 in chips)
Seat 3: JZappa ($1.56 in chips)
Seat 4: PINGASSO201 ($1.48 in chips)
Seat 5: TraveIerr ($5.37 in chips)
Seat 6: tapouttazz9 ($1.98 in chips)
Scoop15: posts small blind $0.01
erik51fun: posts big blind $0.02
*** HOLE CARDS ***
Dealt to tapouttazz9 [Js Ks]
JZappa: folds
PINGASSO201: folds
TraveIerr: folds
tapouttazz9: raises $0.04 to $0.06
Scoop15: folds
erik51fun: calls $0.04
*** FLOP *** [9s Qc 7h]
erik51fun: bets $0.06
tapouttazz9: calls $0.06
*** TURN *** [9s Qc 7h] [Ad]
erik51fun: checks
tapouttazz9: bets $0.18
erik51fun: folds
Uncalled bet ($0.18) returned to tapouttazz9
tapouttazz9 collected $0.24 from pot
tapouttazz9: doesn't show hand
*** SUMMARY ***
Total pot $0.25 | Rake $0.01
Board [9s Qc 7h Ad]
Seat 1: Scoop15 (small blind) folded before Flop
Seat 2: erik51fun (big blind) folded on the Turn
Seat 3: JZappa folded before Flop (didn't bet)
Seat 4: PINGASSO201 folded before Flop (didn't bet)
Seat 5: TraveIerr folded before Flop (didn't bet)
Seat 6: tapouttazz9 (button) collected ($0.24)


PokerStars Hand #155627598209:  Hold'em No Limit ($0.01/$0.02 USD) - 2016/07/11 16:35:44 ET
Table 'Alcyone' 6-max Seat #1 is the button
Seat 1: Scoop15 ($3.17 in chips)
Seat 2: erik51fun ($1.77 in chips)
Seat 3: JZappa ($1.56 in chips)
Seat 4: PINGASSO201 ($1.48 in chips)
Seat 5: TraveIerr ($5.37 in chips)
Seat 6: tapouttazz9 ($2.10 in chips)
erik51fun: posts small blind $0.01
JZappa: posts big blind $0.02
*** HOLE CARDS ***
Dealt to tapouttazz9 [7s 3c]
PINGASSO201: folds
TraveIerr: folds
tapouttazz9: folds
Scoop15: calls $0.02
erik51fun: calls $0.01
JZappa: checks
*** FLOP *** [Ts 7c Qd]
erik51fun: checks
JZappa: checks
Scoop15: bets $0.02
erik51fun: folds
JZappa: folds
Uncalled bet ($0.02) returned to Scoop15
Scoop15 collected $0.06 from pot
Scoop15: doesn't show hand
*** SUMMARY ***
Total pot $0.06 | Rake $0
Board [Ts 7c Qd]
Seat 1: Scoop15 (button) collected ($0.06)
Seat 2: erik51fun (small blind) folded on the Flop
Seat 3: JZappa (big blind) folded on the Flop
Seat 4: PINGASSO201 folded before Flop (didn't bet)
Seat 5: TraveIerr folded before Flop (didn't bet)
Seat 6: tapouttazz9 folded before Flop (didn't bet)


PokerStars Hand #155627598399:  Hold'em No Limit ($0.01/$0.02 USD) - 2016/07/11 16:36:19 ET
Table 'Alcyone' 6-max Seat #2 is the button
Seat 1: Scoop15 ($3.21 in chips)
Seat 2: erik51fun ($1.75 in chips)
Seat 3: JZappa ($1.54 in chips)
Seat 4: PINGASSO201 ($1.48 in chips)
Seat 5: TraveIerr ($5.37 in chips)
Seat 6: tapouttazz9 ($2.10 in chips)
JZappa: posts small blind $0.01
PINGASSO201: posts big blind $0.02
*** HOLE CARDS ***
Dealt to tapouttazz9 [9c 4c]
TraveIerr: folds
tapouttazz9: folds
Scoop15: folds
erik51fun: calls $0.02
JZappa: calls $0.01
PINGASSO201: raises $0.08 to $0.10
erik51fun: calls $0.08
JZappa: folds
*** FLOP *** [7s 8s 9d]
PINGASSO201: bets $0.20
erik51fun: raises $1.45 to $1.65 and is all-in
PINGASSO201: calls $1.18 and is all-in
Uncalled bet ($0.27) returned to erik51fun
*** TURN *** [7s 8s 9d] [7d]
*** RIVER *** [7s 8s 9d 7d] [Th]
*** SHOW DOWN ***
PINGASSO201: shows [Jd Jc] (a straight, Seven to Jack)
erik51fun: shows [9h Kh] (two pair, Nines and Sevens)
PINGASSO201 collected $2.85 from pot
*** SUMMARY ***
Total pot $2.98 | Rake $0.13
Board [7s 8s 9d 7d Th]
Seat 1: Scoop15 folded before Flop (didn't bet)
Seat 2: erik51fun (button) showed [9h Kh] and lost with two pair, Nines and Sevens
Seat 3: JZappa (small blind) folded before Flop
Seat 4: PINGASSO201 (big blind) showed [Jd Jc] and won ($2.85) with a straight, Seven to Jack
Seat 5: TraveIerr folded before Flop (didn't bet)
Seat 6: tapouttazz9 folded before Flop (didn't bet)


PokerStars Hand #155627598678:  Hold'em No Limit ($0.01/$0.02 USD) - 2016/07/11 16:37:10 ET
Table 'Alcyone' 6-max Seat #3 is the button
Seat 1: Scoop15 ($3.21 in chips)
Seat 2: erik51fun ($0.27 in chips)
Seat 3: JZappa ($1.52 in chips)
Seat 4: PINGASSO201 ($2.85 in chips)
Seat 5: TraveIerr ($5.37 in chips)
Seat 6: tapouttazz9 ($2.10 in chips)
PINGASSO201: posts small blind $0.01
TraveIerr: posts big blind $0.02
*** HOLE CARDS ***
Dealt to tapouttazz9 [8c 2h]
tapouttazz9: folds
Scoop15: folds
erik51fun: calls $0.02
JZappa: folds
PINGASSO201: folds
TraveIerr: checks
*** FLOP *** [8s 4c 2s]
TraveIerr: checks
erik51fun: folds
erik51fun leaves the table
TraveIerr collected $0.05 from pot
TraveIerr: doesn't show hand
*** SUMMARY ***
Total pot $0.05 | Rake $0
Board [8s 4c 2s]
Seat 1: Scoop15 folded before Flop (didn't bet)
Seat 2: erik51fun folded on the Flop
Seat 3: JZappa (button) folded before Flop (didn't bet)
Seat 4: PINGASSO201 (small blind) folded before Flop
Seat 5: TraveIerr (big blind) collected ($0.05)
Seat 6: tapouttazz9 folded before Flop (didn't bet)


PokerStars Hand #155627598844:  Hold'em No Limit ($0.01/$0.02 USD) - 2016/07/11 16:37:44 ET
Table 'Alcyone' 6-max Seat #4 is the button
Seat 1: Scoop15 ($3.21 in chips)
Seat 3: JZappa ($1.52 in chips)
Seat 4: PINGASSO201 ($2.84 in chips)
Seat 5: TraveIerr ($5.40 in chips)
Seat 6: tapouttazz9 ($2.10 in chips)
TraveIerr: posts small blind $0.01
tapouttazz9: posts big blind $0.02
*** HOLE CARDS ***
Dealt to tapouttazz9 [Kh Qs]
Scoop15: folds
JZappa: calls $0.02
PINGASSO201: calls $0.02
TraveIerr: calls $0.01
tapouttazz9: raises $0.02 to $0.04
JZappa: calls $0.02
PINGASSO201: calls $0.02
TraveIerr: calls $0.02
*** FLOP *** [Js 8s Jh]
TraveIerr: checks
tapouttazz9: checks
JZappa: bets $0.15
PINGASSO201: calls $0.15
TraveIerr: folds
tapouttazz9: calls $0.15
*** TURN *** [Js 8s Jh] [5d]
tapouttazz9: checks
JZappa: bets $0.58
pinnocio joins the table at seat #2
PINGASSO201: folds
tapouttazz9: folds
Uncalled bet ($0.58) returned to JZappa
JZappa collected $0.58 from pot
JZappa: doesn't show hand
*** SUMMARY ***
Total pot $0.61 | Rake $0.03
Board [Js 8s Jh 5d]
Seat 1: Scoop15 folded before Flop (didn't bet)
Seat 3: JZappa collected ($0.58)
Seat 4: PINGASSO201 (button) folded on the Turn
Seat 5: TraveIerr (small blind) folded on the Flop
Seat 6: tapouttazz9 (big blind) folded on the Turn


PokerStars Hand #155627599341:  Hold'em No Limit ($0.01/$0.02 USD) - 2016/07/11 16:39:17 ET
Table 'Alcyone' 6-max Seat #5 is the button
Seat 1: Scoop15 ($3.21 in chips)
Seat 3: JZappa ($1.91 in chips)
Seat 4: PINGASSO201 ($2.65 in chips)
Seat 5: TraveIerr ($5.36 in chips)
Seat 6: tapouttazz9 ($1.91 in chips)
tapouttazz9: posts small blind $0.01
Scoop15: posts big blind $0.02
pinnocio: sits out
*** HOLE CARDS ***
Dealt to tapouttazz9 [6c 5c]
JZappa: calls $0.02
PINGASSO201: folds
TraveIerr: folds
tapouttazz9: folds
Scoop15: checks
*** FLOP *** [Jc Kh 2s]
Scoop15: checks
JZappa: checks
*** TURN *** [Jc Kh 2s] [3c]
Scoop15: checks
JZappa: checks
*** RIVER *** [Jc Kh 2s 3c] [8s]
Scoop15: checks
JZappa: checks
*** SHOW DOWN ***
Scoop15: shows [Qs 8c] (a pair of Eights)
JZappa: mucks hand
Scoop15 collected $0.05 from pot
*** SUMMARY ***
Total pot $0.05 | Rake $0
Board [Jc Kh 2s 3c 8s]
Seat 1: Scoop15 (big blind) showed [Qs 8c] and won ($0.05) with a pair of Eights
Seat 3: JZappa mucked [7c 9d]
Seat 4: PINGASSO201 folded before Flop (didn't bet)
Seat 5: TraveIerr (button) folded before Flop (didn't bet)
Seat 6: tapouttazz9 (small blind) folded before Flop


PokerStars Hand #155627599527:  Hold'em No Limit ($0.01/$0.02 USD) - 2016/07/11 16:39:54 ET
Table 'Alcyone' 6-max Seat #6 is the button
Seat 1: Scoop15 ($3.24 in chips)
Seat 2: pinnocio ($1.60 in chips)
Seat 3: JZappa ($1.89 in chips)
Seat 4: PINGASSO201 ($2.65 in chips)
Seat 5: TraveIerr ($5.36 in chips)
Seat 6: tapouttazz9 ($1.90 in chips)
Scoop15: posts small blind $0.01
pinnocio: posts big blind $0.02
*** HOLE CARDS ***
Dealt to tapouttazz9 [6h 4d]
JZappa: calls $0.02
PINGASSO201: folds
TraveIerr: raises $0.08 to $0.10
tapouttazz9: folds
Scoop15: folds
pinnocio: folds
JZappa: folds
Uncalled bet ($0.08) returned to TraveIerr
TraveIerr collected $0.07 from pot
TraveIerr: doesn't show hand
*** SUMMARY ***
Total pot $0.07 | Rake $0
Seat 1: Scoop15 (small blind) folded before Flop
Seat 2: pinnocio (big blind) folded before Flop
Seat 3: JZappa folded before Flop
Seat 4: PINGASSO201 folded before Flop (didn't bet)
Seat 5: TraveIerr collected ($0.07)
Seat 6: tapouttazz9 (button) folded before Flop (didn't bet)


PokerStars Hand #155627599678:  Hold'em No Limit ($0.01/$0.02 USD) - 2016/07/11 16:40:21 ET
Table 'Alcyone' 6-max Seat #1 is the button
Seat 1: Scoop15 ($3.23 in chips)
Seat 2: pinnocio ($1.58 in chips)
Seat 4: PINGASSO201 ($2.65 in chips)
Seat 5: TraveIerr ($5.41 in chips)
Seat 6: tapouttazz9 ($1.90 in chips)
pinnocio: posts small blind $0.01
JZappa: is sitting out
PINGASSO201: posts big blind $0.02
*** HOLE CARDS ***
Dealt to tapouttazz9 [5h Qd]
TraveIerr: raises $0.05 to $0.07
tapouttazz9: folds
Scoop15: folds
pinnocio: calls $0.06
PINGASSO201: folds
*** FLOP *** [Ad Th Kc]
pinnocio: checks
TraveIerr: bets $0.09
pinnocio: folds
Uncalled bet ($0.09) returned to TraveIerr
TraveIerr collected $0.15 from pot
TraveIerr: doesn't show hand
*** SUMMARY ***
Total pot $0.16 | Rake $0.01
Board [Ad Th Kc]
Seat 1: Scoop15 (button) folded before Flop (didn't bet)
Seat 2: pinnocio (small blind) folded on the Flop
Seat 4: PINGASSO201 (big blind) folded before Flop
Seat 5: TraveIerr collected ($0.15)
Seat 6: tapouttazz9 folded before Flop (didn't bet)


PokerStars Hand #155627599869:  Hold'em No Limit ($0.01/$0.02 USD) - 2016/07/11 16:40:54 ET
Table 'Alcyone' 6-max Seat #2 is the button
Seat 1: Scoop15 ($3.23 in chips)
Seat 2: pinnocio ($1.51 in chips)
Seat 4: PINGASSO201 ($2.63 in chips)
Seat 5: TraveIerr ($5.49 in chips)
Seat 6: tapouttazz9 ($1.90 in chips)
PINGASSO201: posts small blind $0.01
TraveIerr: posts big blind $0.02
*** HOLE CARDS ***
Dealt to tapouttazz9 [Kh Ac]
tapouttazz9: raises $0.04 to $0.06
Scoop15: folds
pinnocio: folds
PINGASSO201: folds
TraveIerr: folds
Uncalled bet ($0.04) returned to tapouttazz9
tapouttazz9 collected $0.05 from pot
tapouttazz9: doesn't show hand
*** SUMMARY ***
Total pot $0.05 | Rake $0
Seat 1: Scoop15 folded before Flop (didn't bet)
Seat 2: pinnocio (button) folded before Flop (didn't bet)
Seat 4: PINGASSO201 (small blind) folded before Flop
Seat 5: TraveIerr (big blind) folded before Flop
Seat 6: tapouttazz9 collected ($0.05)


PokerStars Hand #155627599999:  Hold'em No Limit ($0.01/$0.02 USD) - 2016/07/11 16:41:16 ET
Table 'Alcyone' 6-max Seat #4 is the button
Seat 1: Scoop15 ($3.23 in chips)
Seat 2: pinnocio ($1.51 in chips)
Seat 4: PINGASSO201 ($2.62 in chips)
Seat 5: TraveIerr ($5.47 in chips)
Seat 6: tapouttazz9 ($1.93 in chips)
TraveIerr: posts small blind $0.01
tapouttazz9: posts big blind $0.02
*** HOLE CARDS ***
Dealt to tapouttazz9 [5c Kd]
Scoop15: calls $0.02
pinnocio: folds
PINGASSO201: folds
TraveIerr: raises $0.06 to $0.08
tapouttazz9: folds
Scoop15: calls $0.06
*** FLOP *** [Qd Ad Td]
TraveIerr: checks
Scoop15: checks
*** TURN *** [Qd Ad Td] [Qs]
TraveIerr: checks
Scoop15: checks
*** RIVER *** [Qd Ad Td Qs] [As]
TraveIerr: bets $0.14
Scoop15: folds
Uncalled bet ($0.14) returned to TraveIerr
TraveIerr collected $0.17 from pot
TraveIerr: doesn't show hand
*** SUMMARY ***
Total pot $0.18 | Rake $0.01
Board [Qd Ad Td Qs As]
Seat 1: Scoop15 folded on the River
Seat 2: pinnocio folded before Flop (didn't bet)
Seat 4: PINGASSO201 (button) folded before Flop (didn't bet)
Seat 5: TraveIerr (small blind) collected ($0.17)
Seat 6: tapouttazz9 (big blind) folded before Flop


PokerStars Hand #155628089098:  Hold'em No Limit ($0.01/$0.02 USD) - 2016/07/11 16:41:49 ET
Table 'Alcyone' 6-max Seat #5 is the button
Seat 1: Scoop15 ($3.15 in chips)
Seat 2: pinnocio ($1.51 in chips)
Seat 4: PINGASSO201 ($2.62 in chips)
Seat 5: TraveIerr ($5.56 in chips)
Seat 6: tapouttazz9 ($1.91 in chips)
tapouttazz9: posts small blind $0.01
Scoop15: posts big blind $0.02
*** HOLE CARDS ***
Dealt to tapouttazz9 [4h Td]
pinnocio: calls $0.02
PINGASSO201: folds
TraveIerr: folds
tapouttazz9: folds
Scoop15: checks
*** FLOP *** [9s 7c 2s]
Scoop15: checks
pinnocio: checks
*** TURN *** [9s 7c 2s] [4s]
Scoop15: checks
pinnocio: bets $0.02
Scoop15: folds
Uncalled bet ($0.02) returned to pinnocio
pinnocio collected $0.05 from pot
pinnocio: doesn't show hand
*** SUMMARY ***
Total pot $0.05 | Rake $0
Board [9s 7c 2s 4s]
Seat 1: Scoop15 (big blind) folded on the Turn
Seat 2: pinnocio collected ($0.05)
Seat 4: PINGASSO201 folded before Flop (didn't bet)
Seat 5: TraveIerr (button) folded before Flop (didn't bet)
Seat 6: tapouttazz9 (small blind) folded before Flop


PokerStars Hand #155628089312:  Hold'em No Limit ($0.01/$0.02 USD) - 2016/07/11 16:42:25 ET
Table 'Alcyone' 6-max Seat #6 is the button
Seat 1: Scoop15 ($3.13 in chips)
Seat 2: pinnocio ($1.54 in chips)
Seat 4: PINGASSO201 ($2.62 in chips)
Seat 5: TraveIerr ($5.56 in chips)
Seat 6: tapouttazz9 ($1.90 in chips)
Scoop15: posts small blind $0.01
pinnocio: posts big blind $0.02
*** HOLE CARDS ***
Dealt to tapouttazz9 [3c Ts]
PINGASSO201: folds
TraveIerr: folds
tapouttazz9: folds
Scoop15: calls $0.01
pinnocio: checks
*** FLOP *** [Qh 6h Ac]
Scoop15: bets $0.02
pinnocio: folds
Uncalled bet ($0.02) returned to Scoop15
Scoop15 collected $0.04 from pot
Scoop15: doesn't show hand
*** SUMMARY ***
Total pot $0.04 | Rake $0
Board [Qh 6h Ac]
Seat 1: Scoop15 (small blind) collected ($0.04)
Seat 2: pinnocio (big blind) folded on the Flop
Seat 4: PINGASSO201 folded before Flop (didn't bet)
Seat 5: TraveIerr folded before Flop (didn't bet)
Seat 6: tapouttazz9 (button) folded before Flop (didn't bet)


PokerStars Hand #155628089434:  Hold'em No Limit ($0.01/$0.02 USD) - 2016/07/11 16:42:48 ET
Table 'Alcyone' 6-max Seat #1 is the button
Seat 1: Scoop15 ($3.15 in chips)
Seat 2: pinnocio ($1.52 in chips)
Seat 3: JZappa ($1.87 in chips)
Seat 4: PINGASSO201 ($2.62 in chips)
Seat 5: TraveIerr ($5.56 in chips)
Seat 6: tapouttazz9 ($1.90 in chips)
pinnocio: posts small blind $0.01
JZappa: posts big blind $0.02
*** HOLE CARDS ***
Dealt to tapouttazz9 [8d 5d]
PINGASSO201: folds
TraveIerr has timed out
TraveIerr: folds
tapouttazz9: folds
Scoop15: folds
pinnocio: calls $0.01
JZappa: checks
*** FLOP *** [2h Qh 7h]
pinnocio: checks
JZappa: checks
*** TURN *** [2h Qh 7h] [2d]
pinnocio: bets $0.02
JZappa: calls $0.02
*** RIVER *** [2h Qh 7h 2d] [Jc]
pinnocio: bets $0.08
JZappa: calls $0.08
*** SHOW DOWN ***
pinnocio: shows [4h 8h] (a flush, Queen high)
JZappa: mucks hand
pinnocio collected $0.23 from pot
*** SUMMARY ***
Total pot $0.24 | Rake $0.01
Board [2h Qh 7h 2d Jc]
Seat 1: Scoop15 (button) folded before Flop (didn't bet)
Seat 2: pinnocio (small blind) showed [4h 8h] and won ($0.23) with a flush, Queen high
Seat 3: JZappa (big blind) mucked [Qs 6d]
Seat 4: PINGASSO201 folded before Flop (didn't bet)
Seat 5: TraveIerr folded before Flop (didn't bet)
Seat 6: tapouttazz9 folded before Flop (didn't bet)


PokerStars Hand #155628089677:  Hold'em No Limit ($0.01/$0.02 USD) - 2016/07/11 16:43:33 ET
Table 'Alcyone' 6-max Seat #2 is the button
Seat 1: Scoop15 ($3.15 in chips)
Seat 2: pinnocio ($1.63 in chips)
Seat 3: JZappa ($1.75 in chips)
Seat 4: PINGASSO201 ($2.62 in chips)
Seat 5: TraveIerr ($5.56 in chips)
Seat 6: tapouttazz9 ($1.90 in chips)
JZappa: posts small blind $0.01
PINGASSO201: posts big blind $0.02
*** HOLE CARDS ***
Dealt to tapouttazz9 [3c 4d]
TraveIerr: folds
tapouttazz9: folds
Scoop15: folds
pinnocio: folds
JZappa: calls $0.01
PINGASSO201: checks
*** FLOP *** [2c 7s Qc]
JZappa: checks
PINGASSO201: checks
*** TURN *** [2c 7s Qc] [Kh]
JZappa: checks
PINGASSO201: checks
*** RIVER *** [2c 7s Qc Kh] [3s]
JZappa: checks
PINGASSO201: checks
*** SHOW DOWN ***
JZappa: shows [9s 6h] (high card King)
PINGASSO201: shows [Ad 5s] (high card Ace)
PINGASSO201 collected $0.04 from pot
*** SUMMARY ***
Total pot $0.04 | Rake $0
Board [2c 7s Qc Kh 3s]
Seat 1: Scoop15 folded before Flop (didn't bet)
Seat 2: pinnocio (button) folded before Flop (didn't bet)
Seat 3: JZappa (small blind) showed [9s 6h] and lost with high card King
Seat 4: PINGASSO201 (big blind) showed [Ad 5s] and won ($0.04) with high card Ace
Seat 5: TraveIerr folded before Flop (didn't bet)
Seat 6: tapouttazz9 folded before Flop (didn't bet)


PokerStars Hand #155628089815:  Hold'em No Limit ($0.01/$0.02 USD) - 2016/07/11 16:43:58 ET
Table 'Alcyone' 6-max Seat #3 is the button
Seat 1: Scoop15 ($3.15 in chips)
Seat 2: pinnocio ($1.63 in chips)
Seat 3: JZappa ($1.73 in chips)
Seat 4: PINGASSO201 ($2.64 in chips)
Seat 5: TraveIerr ($5.56 in chips)
Seat 6: tapouttazz9 ($1.90 in chips)
PINGASSO201: posts small blind $0.01
TraveIerr: posts big blind $0.02
*** HOLE CARDS ***
Dealt to tapouttazz9 [Qs 3s]
tapouttazz9: folds
Scoop15: calls $0.02
pinnocio: calls $0.02
JZappa: calls $0.02
PINGASSO201: calls $0.01
TraveIerr: checks
*** FLOP *** [7s 9c Kc]
PINGASSO201: checks
TraveIerr: checks
Scoop15: bets $0.04
pinnocio: folds
JZappa: folds
PINGASSO201: folds
TraveIerr: calls $0.04
*** TURN *** [7s 9c Kc] [Jd]
TraveIerr: checks
Scoop15: bets $0.06
TraveIerr: calls $0.06
*** RIVER *** [7s 9c Kc Jd] [Th]
TraveIerr: checks
Scoop15: bets $0.18
TraveIerr: folds
Uncalled bet ($0.18) returned to Scoop15
Scoop15 collected $0.29 from pot
Scoop15: doesn't show hand
*** SUMMARY ***
Total pot $0.30 | Rake $0.01
Board [7s 9c Kc Jd Th]
Seat 1: Scoop15 collected ($0.29)
Seat 2: pinnocio folded on the Flop
Seat 3: JZappa (button) folded on the Flop
Seat 4: PINGASSO201 (small blind) folded on the Flop
Seat 5: TraveIerr (big blind) folded on the River
Seat 6: tapouttazz9 folded before Flop (didn't bet)


PokerStars Hand #155628222959:  Hold'em No Limit ($0.01/$0.02 USD) - 2016/07/11 16:44:57 ET
Table 'Alcyone' 6-max Seat #4 is the button
Seat 1: Scoop15 ($3.32 in chips)
Seat 2: pinnocio ($1.61 in chips)
Seat 3: JZappa ($1.71 in chips)
Seat 4: PINGASSO201 ($2.62 in chips)
Seat 5: TraveIerr ($5.44 in chips)
Seat 6: tapouttazz9 ($1.90 in chips)
TraveIerr: posts small blind $0.01
tapouttazz9: posts big blind $0.02
*** HOLE CARDS ***
Dealt to tapouttazz9 [5d Ah]
Scoop15: raises $0.02 to $0.04
pinnocio: folds
JZappa: folds
PINGASSO201: calls $0.04
TraveIerr: folds
tapouttazz9: folds
*** FLOP *** [Th 4h 9d]
Scoop15: bets $0.04
PINGASSO201: calls $0.04
*** TURN *** [Th 4h 9d] [9h]
Scoop15: checks
PINGASSO201: checks
*** RIVER *** [Th 4h 9d 9h] [9c]
Scoop15: checks
PINGASSO201: checks
*** SHOW DOWN ***
Scoop15: shows [7s 8s] (three of a kind, Nines)
PINGASSO201: shows [Ad Qd] (three of a kind, Nines - Ace kicker)
PINGASSO201 collected $0.18 from pot
*** SUMMARY ***
Total pot $0.19 | Rake $0.01
Board [Th 4h 9d 9h 9c]
Seat 1: Scoop15 showed [7s 8s] and lost with three of a kind, Nines
Seat 2: pinnocio folded before Flop (didn't bet)
Seat 3: JZappa folded before Flop (didn't bet)
Seat 4: PINGASSO201 (button) showed [Ad Qd] and won ($0.18) with three of a kind, Nines
Seat 5: TraveIerr (small blind) folded before Flop
Seat 6: tapouttazz9 (big blind) folded before Flop


PokerStars Hand #155628223107:  Hold'em No Limit ($0.01/$0.02 USD) - 2016/07/11 16:45:26 ET
Table 'Alcyone' 6-max Seat #5 is the button
Seat 1: Scoop15 ($3.24 in chips)
Seat 2: pinnocio ($1.61 in chips)
Seat 3: JZappa ($1.71 in chips)
Seat 4: PINGASSO201 ($2.72 in chips)
Seat 5: TraveIerr ($5.43 in chips)
Seat 6: tapouttazz9 ($1.88 in chips)
tapouttazz9: posts small blind $0.01
Scoop15: posts big blind $0.02
*** HOLE CARDS ***
Dealt to tapouttazz9 [4d 6c]
pinnocio: calls $0.02
JZappa: folds
PINGASSO201: folds
TraveIerr: folds
tapouttazz9: folds
Scoop15: checks
*** FLOP *** [2d 8d 5c]
Scoop15: checks
pinnocio: checks
*** TURN *** [2d 8d 5c] [3d]
Scoop15: bets $0.04
pinnocio: folds
Uncalled bet ($0.04) returned to Scoop15
Scoop15 collected $0.05 from pot
Scoop15: doesn't show hand
*** SUMMARY ***
Total pot $0.05 | Rake $0
Board [2d 8d 5c 3d]
Seat 1: Scoop15 (big blind) collected ($0.05)
Seat 2: pinnocio folded on the Turn
Seat 3: JZappa folded before Flop (didn't bet)
Seat 4: PINGASSO201 folded before Flop (didn't bet)
Seat 5: TraveIerr (button) folded before Flop (didn't bet)
Seat 6: tapouttazz9 (small blind) folded before Flop


PokerStars Hand #155628223272:  Hold'em No Limit ($0.01/$0.02 USD) - 2016/07/11 16:45:58 ET
Table 'Alcyone' 6-max Seat #6 is the button
Seat 1: Scoop15 ($3.27 in chips)
Seat 2: pinnocio ($1.59 in chips)
Seat 3: JZappa ($1.71 in chips)
Seat 4: PINGASSO201 ($2.72 in chips)
Seat 5: TraveIerr ($5.43 in chips)
Seat 6: tapouttazz9 ($1.87 in chips)
Scoop15: posts small blind $0.01
pinnocio: posts big blind $0.02
*** HOLE CARDS ***
Dealt to tapouttazz9 [8s 2c]
JZappa: raises $0.04 to $0.06
PINGASSO201: folds
TraveIerr: folds
tapouttazz9: folds
Scoop15: calls $0.05
pinnocio: folds
*** FLOP *** [2s 5h 7h]
Scoop15: checks
JZappa: checks
*** TURN *** [2s 5h 7h] [Ad]
Scoop15: checks
JZappa: bets $0.13
Scoop15: folds
Uncalled bet ($0.13) returned to JZappa
JZappa collected $0.13 from pot
JZappa: doesn't show hand
*** SUMMARY ***
Total pot $0.14 | Rake $0.01
Board [2s 5h 7h Ad]
Seat 1: Scoop15 (small blind) folded on the Turn
Seat 2: pinnocio (big blind) folded before Flop
Seat 3: JZappa collected ($0.13)
Seat 4: PINGASSO201 folded before Flop (didn't bet)
Seat 5: TraveIerr folded before Flop (didn't bet)
Seat 6: tapouttazz9 (button) folded before Flop (didn't bet)


PokerStars Hand #155628223414:  Hold'em No Limit ($0.01/$0.02 USD) - 2016/07/11 16:46:23 ET
Table 'Alcyone' 6-max Seat #1 is the button
Seat 1: Scoop15 ($3.21 in chips)
Seat 2: pinnocio ($1.57 in chips)
Seat 3: JZappa ($1.78 in chips)
Seat 4: PINGASSO201 ($2.72 in chips)
Seat 5: TraveIerr ($5.43 in chips)
Seat 6: tapouttazz9 ($1.87 in chips)
pinnocio: posts small blind $0.01
JZappa: posts big blind $0.02
*** HOLE CARDS ***
Dealt to tapouttazz9 [3c 3d]
PINGASSO201: folds
TraveIerr: folds
tapouttazz9: raises $0.02 to $0.04
Scoop15: folds
pinnocio: calls $0.03
JZappa: calls $0.02
*** FLOP *** [Jc 8h As]
pinnocio: checks
JZappa: checks
tapouttazz9: checks
*** TURN *** [Jc 8h As] [8d]
pinnocio: checks
JZappa: bets $0.11
tapouttazz9: folds
pinnocio: folds
Uncalled bet ($0.11) returned to JZappa
JZappa collected $0.11 from pot
JZappa: doesn't show hand
*** SUMMARY ***
Total pot $0.12 | Rake $0.01
Board [Jc 8h As 8d]
Seat 1: Scoop15 (button) folded before Flop (didn't bet)
Seat 2: pinnocio (small blind) folded on the Turn
Seat 3: JZappa (big blind) collected ($0.11)
Seat 4: PINGASSO201 folded before Flop (didn't bet)
Seat 5: TraveIerr folded before Flop (didn't bet)
Seat 6: tapouttazz9 folded on the Turn


PokerStars Hand #155628223609:  Hold'em No Limit ($0.01/$0.02 USD) - 2016/07/11 16:47:00 ET
Table 'Alcyone' 6-max Seat #2 is the button
Seat 2: pinnocio ($1.53 in chips)
Seat 3: JZappa ($1.85 in chips)
Seat 4: PINGASSO201 ($2.72 in chips)
Seat 5: TraveIerr ($5.43 in chips)
Seat 6: tapouttazz9 ($1.83 in chips)
JZappa: posts small blind $0.01
PINGASSO201: posts big blind $0.02
*** HOLE CARDS ***
Dealt to tapouttazz9 [5c Jd]
TraveIerr: raises $0.04 to $0.06
tapouttazz9: folds
pinnocio: folds
JZappa: calls $0.05
PINGASSO201: folds
*** FLOP *** [7d Js Qc]
JZappa: checks
TraveIerr: checks
*** TURN *** [7d Js Qc] [6d]
JZappa: bets $0.06
TraveIerr: calls $0.06
*** RIVER *** [7d Js Qc 6d] [Kd]
JZappa: bets $0.25
TraveIerr: folds
Uncalled bet ($0.25) returned to JZappa
JZappa collected $0.25 from pot
JZappa: doesn't show hand
*** SUMMARY ***
Total pot $0.26 | Rake $0.01
Board [7d Js Qc 6d Kd]
Seat 2: pinnocio (button) folded before Flop (didn't bet)
Seat 3: JZappa (small blind) collected ($0.25)
Seat 4: PINGASSO201 (big blind) folded before Flop
Seat 5: TraveIerr folded on the River
Seat 6: tapouttazz9 folded before Flop (didn't bet)


PokerStars Hand #155628223871:  Hold'em No Limit ($0.01/$0.02 USD) - 2016/07/11 16:47:52 ET
Table 'Alcyone' 6-max Seat #3 is the button
Seat 1: Scoop15 ($3.21 in chips)
Seat 2: pinnocio ($1.53 in chips)
Seat 3: JZappa ($1.98 in chips)
Seat 4: PINGASSO201 ($2.70 in chips)
Seat 5: TraveIerr ($5.31 in chips)
Seat 6: tapouttazz9 ($1.83 in chips)
PINGASSO201: posts small blind $0.01
TraveIerr: posts big blind $0.02
*** HOLE CARDS ***
Dealt to tapouttazz9 [Qh 8c]
tapouttazz9: folds
Scoop15: folds
pinnocio: folds
JZappa: raises $0.04 to $0.06
PINGASSO201: folds
TraveIerr: calls $0.04
*** FLOP *** [6h 9h 6s]
TraveIerr: checks
JZappa: checks
*** TURN *** [6h 9h 6s] [Ac]
TraveIerr: checks
JZappa: bets $0.12
TraveIerr: calls $0.12
*** RIVER *** [6h 9h 6s Ac] [Qs]
TraveIerr: checks
JZappa: checks
*** SHOW DOWN ***
TraveIerr: shows [9c 8h] (two pair, Nines and Sixes)
JZappa: shows [Td Ad] (two pair, Aces and Sixes)
JZappa collected $0.35 from pot
*** SUMMARY ***
Total pot $0.37 | Rake $0.02
Board [6h 9h 6s Ac Qs]
Seat 1: Scoop15 folded before Flop (didn't bet)
Seat 2: pinnocio folded before Flop (didn't bet)
Seat 3: JZappa (button) showed [Td Ad] and won ($0.35) with two pair, Aces and Sixes
Seat 4: PINGASSO201 (small blind) folded before Flop
Seat 5: TraveIerr (big blind) showed [9c 8h] and lost with two pair, Nines and Sixes
Seat 6: tapouttazz9 folded before Flop (didn't bet)


PokerStars Hand #157036238387:  Hold'em No Limit ($0.05/$0.10 USD) - 2016/08/16 19:10:52 ET
Table 'Alcyone' 6-max Seat #5 is the button
Seat 2: tapouttazz9 ($10 in chips)
Seat 3: joeystubs1 ($3.28 in chips)
Seat 4: real_memorex ($19.80 in chips)
Seat 5: kingxanmastr ($7.57 in chips)
Seat 6: doubelEagle5 ($2.39 in chips)
doubelEagle5: posts small blind $0.05
tapouttazz9: posts big blind $0.10
*** HOLE CARDS ***
Dealt to tapouttazz9 [6d 7h]
joeystubs1: raises $0.20 to $0.30
real_memorex: folds
kingxanmastr: folds
doubelEagle5: folds
tapouttazz9: calls $0.20
*** FLOP *** [5s 2s Td]
tapouttazz9: bets $0.31
joeystubs1: raises $0.31 to $0.62
tapouttazz9: folds
Uncalled bet ($0.31) returned to joeystubs1
joeystubs1 collected $1.21 from pot
joeystubs1: doesn't show hand
*** SUMMARY ***
Total pot $1.27 | Rake $0.06
Board [5s 2s Td]
Seat 2: tapouttazz9 (big blind) folded on the Flop
Seat 3: joeystubs1 collected ($1.21)
Seat 4: real_memorex folded before Flop (didn't bet)
Seat 5: kingxanmastr (button) folded before Flop (didn't bet)
Seat 6: doubelEagle5 (small blind) folded before Flop


PokerStars Hand #157036238562:  Hold'em No Limit ($0.05/$0.10 USD) - 2016/08/16 19:11:26 ET
Table 'Alcyone' 6-max Seat #6 is the button
Seat 2: tapouttazz9 ($9.39 in chips)
Seat 3: joeystubs1 ($3.88 in chips)
Seat 4: real_memorex ($19.80 in chips)
Seat 5: kingxanmastr ($7.57 in chips)
Seat 6: doubelEagle5 ($2.34 in chips)
tapouttazz9: posts small blind $0.05
joeystubs1: posts big blind $0.10
*** HOLE CARDS ***
Dealt to tapouttazz9 [3c 9d]
real_memorex: raises $0.20 to $0.30
kingxanmastr: calls $0.30
doubelEagle5: calls $0.30
tapouttazz9: folds
joeystubs1: folds
*** FLOP *** [2d Qc 7c]
real_memorex: checks
kingxanmastr: checks
doubelEagle5: bets $1
real_memorex: folds
kingxanmastr: folds
Uncalled bet ($1) returned to doubelEagle5
doubelEagle5 collected $1 from pot
doubelEagle5: doesn't show hand
*** SUMMARY ***
Total pot $1.05 | Rake $0.05
Board [2d Qc 7c]
Seat 2: tapouttazz9 (small blind) folded before Flop
Seat 3: joeystubs1 (big blind) folded before Flop
Seat 4: real_memorex folded on the Flop
Seat 5: kingxanmastr folded on the Flop
Seat 6: doubelEagle5 (button) collected ($1)


PokerStars Hand #157036238738:  Hold'em No Limit ($0.05/$0.10 USD) - 2016/08/16 19:11:58 ET
Table 'Alcyone' 6-max Seat #2 is the button
Seat 2: tapouttazz9 ($10 in chips)
Seat 3: joeystubs1 ($3.78 in chips)
Seat 4: real_memorex ($19.50 in chips)
Seat 5: kingxanmastr ($7.27 in chips)
Seat 6: doubelEagle5 ($3.04 in chips)
joeystubs1: posts small blind $0.05
real_memorex: posts big blind $0.10
*** HOLE CARDS ***
Dealt to tapouttazz9 [8c Tc]
kingxanmastr: calls $0.10
doubelEagle5: folds
tapouttazz9: folds
joeystubs1: folds
real_memorex: raises $0.20 to $0.30
kingxanmastr: calls $0.20
*** FLOP *** [9c 2s 7c]
real_memorex: bets $0.70
kingxanmastr: folds
Uncalled bet ($0.70) returned to real_memorex
real_memorex collected $0.62 from pot
real_memorex: doesn't show hand
*** SUMMARY ***
Total pot $0.65 | Rake $0.03
Board [9c 2s 7c]
Seat 2: tapouttazz9 (button) folded before Flop (didn't bet)
Seat 3: joeystubs1 (small blind) folded before Flop
Seat 4: real_memorex (big blind) collected ($0.62)
Seat 5: kingxanmastr folded on the Flop
Seat 6: doubelEagle5 folded before Flop (didn't bet)


PokerStars Hand #157036238856:  Hold'em No Limit ($0.05/$0.10 USD) - 2016/08/16 19:12:21 ET
Table 'Alcyone' 6-max Seat #3 is the button
Seat 2: tapouttazz9 ($10 in chips)
Seat 3: joeystubs1 ($3.73 in chips)
Seat 4: real_memorex ($19.82 in chips)
Seat 5: kingxanmastr ($6.97 in chips)
Seat 6: doubelEagle5 ($3.04 in chips)
real_memorex: posts small blind $0.05
kingxanmastr: posts big blind $0.10
*** HOLE CARDS ***
Dealt to tapouttazz9 [9c 5s]
doubelEagle5: folds
tapouttazz9: folds
joeystubs1: folds
real_memorex: calls $0.05
kingxanmastr: checks
*** FLOP *** [5c 8h 4s]
real_memorex: checks
kingxanmastr: checks
*** TURN *** [5c 8h 4s] [Ad]
real_memorex: bets $0.14
kingxanmastr: folds
Uncalled bet ($0.14) returned to real_memorex
real_memorex collected $0.19 from pot
real_memorex: doesn't show hand
*** SUMMARY ***
Total pot $0.20 | Rake $0.01
Board [5c 8h 4s Ad]
Seat 2: tapouttazz9 folded before Flop (didn't bet)
Seat 3: joeystubs1 (button) folded before Flop (didn't bet)
Seat 4: real_memorex (small blind) collected ($0.19)
Seat 5: kingxanmastr (big blind) folded on the Turn
Seat 6: doubelEagle5 folded before Flop (didn't bet)


PokerStars Hand #157036238969:  Hold'em No Limit ($0.05/$0.10 USD) - 2016/08/16 19:12:45 ET
Table 'Alcyone' 6-max Seat #4 is the button
Seat 2: tapouttazz9 ($10 in chips)
Seat 3: joeystubs1 ($3.73 in chips)
Seat 4: real_memorex ($19.91 in chips)
Seat 5: kingxanmastr ($6.87 in chips)
Seat 6: doubelEagle5 ($3.04 in chips)
kingxanmastr: posts small blind $0.05
doubelEagle5: posts big blind $0.10
*** HOLE CARDS ***
Dealt to tapouttazz9 [3c 2d]
tapouttazz9: folds
joeystubs1: calls $0.10
real_memorex: calls $0.10
kingxanmastr: calls $0.05
doubelEagle5: checks
*** FLOP *** [4d 9s Js]
kingxanmastr: checks
doubelEagle5: checks
joeystubs1: checks
real_memorex: bets $0.38
kingxanmastr: folds
doubelEagle5: folds
joeystubs1: folds
Uncalled bet ($0.38) returned to real_memorex
real_memorex collected $0.38 from pot
real_memorex: doesn't show hand
*** SUMMARY ***
Total pot $0.40 | Rake $0.02
Board [4d 9s Js]
Seat 2: tapouttazz9 folded before Flop (didn't bet)
Seat 3: joeystubs1 folded on the Flop
Seat 4: real_memorex (button) collected ($0.38)
Seat 5: kingxanmastr (small blind) folded on the Flop
Seat 6: doubelEagle5 (big blind) folded on the Flop


PokerStars Hand #122804888538:  Hold'em No Limit ($0.05/$0.10 USD) - 2016/03/17 17:34:42 ET
Table 'Vala' 6-max Seat #1 is the button
Seat 1: IPLAY4LINDSY ($6.85 in chips)
Seat 2: MoneysaysFU ($34.98 in chips)
Seat 4: tapouttazz9 ($10 in chips)
Seat 5: dwygal ($10.47 in chips)
Seat 6: magmike322 ($8.82 in chips)
MoneysaysFU: posts small blind $0.05
tapouttazz9: posts big blind $0.10
*** HOLE CARDS ***
Dealt to tapouttazz9 [6c 3h]
dwygal: calls $0.10
magmike322: folds
IPLAY4LINDSY: folds
MoneysaysFU: raises $0.30 to $0.40
tapouttazz9: folds
dwygal: calls $0.30
*** FLOP *** [Js Ah 8c]
MoneysaysFU: bets $0.86
dwygal: calls $0.86
*** TURN *** [Js Ah 8c] [8d]
MoneysaysFU: bets $1.24
dwygal: calls $1.24
*** RIVER *** [Js Ah 8c 8d] [9c]
MoneysaysFU: checks
dwygal: bets $5
MoneysaysFU: calls $5
*** SHOW DOWN ***
dwygal: shows [5h Qd] (a pair of Eights)
MoneysaysFU: shows [Th As] (two pair, Aces and Eights)
MoneysaysFU collected $14.34 from pot
*** SUMMARY ***
Total pot $15.10 | Rake $0.76
Board [Js Ah 8c 8d 9c]
Seat 1: IPLAY4LINDSY (button) folded before Flop (didn't bet)
Seat 2: MoneysaysFU (small blind) showed [Th As] and won ($14.34) with two pair, Aces and Eights
Seat 4: tapouttazz9 (big blind) folded before Flop
Seat 5: dwygal showed [5h Qd] and lost with a pair of Eights
Seat 6: magmike322 folded before Flop (didn't bet)


PokerStars Hand #122804888592:  Hold'em No Limit ($0.05/$0.10 USD) - 2016/03/17 17:35:20 ET
Table 'Vala' 6-max Seat #2 is the button
Seat 1: IPLAY4LINDSY ($6.85 in chips)
Seat 2: MoneysaysFU ($41.82 in chips)
Seat 4: tapouttazz9 ($9.90 in chips)
Seat 5: dwygal ($2.97 in chips)
Seat 6: magmike322 ($8.82 in chips)
tapouttazz9: posts small blind $0.05
dwygal: posts big blind $0.10
*** HOLE CARDS ***
Dealt to tapouttazz9 [Kh 7c]
magmike322: calls $0.10
IPLAY4LINDSY: folds
MoneysaysFU: calls $0.10
tapouttazz9: folds
dwygal: checks
*** FLOP *** [Js 5h 5d]
dwygal: checks
magmike322: checks
MoneysaysFU: checks
*** TURN *** [Js 5h 5d] [Td]
dwygal: checks
magmike322: checks
MoneysaysFU: checks
*** RIVER *** [Js 5h 5d Td] [Jc]
dwygal: checks
magmike322: bets $0.20
MoneysaysFU: folds
dwygal: folds
Uncalled bet ($0.20) returned to magmike322
magmike322 collected $0.33 from pot
magmike322: doesn't show hand
*** SUMMARY ***
Total pot $0.35 | Rake $0.02
Board [Js 5h 5d Td Jc]
Seat 1: IPLAY4LINDSY folded before Flop (didn't bet)
Seat 2: MoneysaysFU (button) folded on the River
Seat 4: tapouttazz9 (small blind) folded before Flop
Seat 5: dwygal (big blind) folded on the River
Seat 6: magmike322 collected ($0.33)


PokerStars Hand #122804888692:  Hold'em No Limit ($0.05/$0.10 USD) - 2016/03/17 17:36:20 ET
Table 'Vala' 6-max Seat #4 is the button
Seat 1: IPLAY4LINDSY ($6.85 in chips)
Seat 2: MoneysaysFU ($41.72 in chips)
Seat 4: tapouttazz9 ($9.85 in chips)
Seat 5: dwygal ($2.87 in chips)
Seat 6: magmike322 ($9.05 in chips)
dwygal: posts small blind $0.05
magmike322: posts big blind $0.10
trumpcaddy: sits out
*** HOLE CARDS ***
Dealt to tapouttazz9 [Qd 3s]
IPLAY4LINDSY: calls $0.10
MoneysaysFU: calls $0.10
tapouttazz9: folds
dwygal: calls $0.05
magmike322: checks
*** FLOP *** [Th 8s 6c]
dwygal: checks
magmike322: checks
IPLAY4LINDSY: bets $0.10
MoneysaysFU: calls $0.10
dwygal: calls $0.10
magmike322: calls $0.10
*** TURN *** [Th 8s 6c] [8c]
dwygal: bets $0.20
magmike322: folds
IPLAY4LINDSY: calls $0.20
MoneysaysFU: calls $0.20
*** RIVER *** [Th 8s 6c 8c] [8h]
dwygal: bets $2
IPLAY4LINDSY: folds
MoneysaysFU: folds
Uncalled bet ($2) returned to dwygal
dwygal collected $1.33 from pot
dwygal: doesn't show hand
*** SUMMARY ***
Total pot $1.40 | Rake $0.07
Board [Th 8s 6c 8c 8h]
Seat 1: IPLAY4LINDSY folded on the River
Seat 2: MoneysaysFU folded on the River
Seat 4: tapouttazz9 (button) folded before Flop (didn't bet)
Seat 5: dwygal (small blind) collected ($1.33)
Seat 6: magmike322 (big blind) folded on the Turn


PokerStars Hand #122804888855:  Hold'em No Limit ($0.05/$0.10 USD) - 2016/03/17 17:37:49 ET
Table 'Vala' 6-max Seat #5 is the button
Seat 1: IPLAY4LINDSY ($6.45 in chips)
Seat 2: MoneysaysFU ($41.32 in chips)
Seat 4: tapouttazz9 ($9.85 in chips)
Seat 5: dwygal ($3.80 in chips)
Seat 6: magmike322 ($8.85 in chips)
magmike322: posts small blind $0.05
IPLAY4LINDSY: posts big blind $0.10
trumpcaddy: sits out
*** HOLE CARDS ***
Dealt to tapouttazz9 [As 4h]
MoneysaysFU: folds
tapouttazz9: raises $0.20 to $0.30
dwygal: calls $0.30
magmike322: folds
IPLAY4LINDSY: calls $0.20
*** FLOP *** [9h 6d Ac]
IPLAY4LINDSY: checks
tapouttazz9: bets $0.45
dwygal: calls $0.45
IPLAY4LINDSY: folds
*** TURN *** [9h 6d Ac] [8h]
tapouttazz9: bets $0.88
dwygal: folds
Uncalled bet ($0.88) returned to tapouttazz9
tapouttazz9 collected $1.76 from pot
tapouttazz9: doesn't show hand
*** SUMMARY ***
Total pot $1.85 | Rake $0.09
Board [9h 6d Ac 8h]
Seat 1: IPLAY4LINDSY (big blind) folded on the Flop
Seat 2: MoneysaysFU folded before Flop (didn't bet)
Seat 4: tapouttazz9 collected ($1.76)
Seat 5: dwygal (button) folded on the Turn
Seat 6: magmike322 (small blind) folded before Flop


PokerStars Hand #122804888946:  Hold'em No Limit ($0.05/$0.10 USD) - 2016/03/17 17:38:29 ET
Table 'Vala' 6-max Seat #6 is the button
Seat 1: IPLAY4LINDSY ($6.15 in chips)
Seat 2: MoneysaysFU ($41.32 in chips)
Seat 4: tapouttazz9 ($10.86 in chips)
Seat 5: dwygal ($3.05 in chips)
Seat 6: magmike322 ($8.80 in chips)
IPLAY4LINDSY: posts small blind $0.05
MoneysaysFU: posts big blind $0.10
trumpcaddy: sits out
*** HOLE CARDS ***
Dealt to tapouttazz9 [3d 2c]
tapouttazz9: folds
dwygal: calls $0.10
magmike322: calls $0.10
IPLAY4LINDSY: calls $0.05
MoneysaysFU: checks
*** FLOP *** [4c Th Kc]
IPLAY4LINDSY: checks
MoneysaysFU: checks
dwygal: checks
magmike322: checks
*** TURN *** [4c Th Kc] [2s]
IPLAY4LINDSY: checks
MoneysaysFU: checks
dwygal: checks
magmike322: checks
*** RIVER *** [4c Th Kc 2s] [3c]
IPLAY4LINDSY: checks
MoneysaysFU: bets $0.38
dwygal: folds
magmike322: folds
IPLAY4LINDSY: folds
Uncalled bet ($0.38) returned to MoneysaysFU
MoneysaysFU collected $0.38 from pot
MoneysaysFU: doesn't show hand
*** SUMMARY ***
Total pot $0.40 | Rake $0.02
Board [4c Th Kc 2s 3c]
Seat 1: IPLAY4LINDSY (small blind) folded on the River
Seat 2: MoneysaysFU (big blind) collected ($0.38)
Seat 4: tapouttazz9 folded before Flop (didn't bet)
Seat 5: dwygal folded on the River
Seat 6: magmike322 (button) folded on the River


PokerStars Hand #122804889053:  Hold'em No Limit ($0.05/$0.10 USD) - 2016/03/17 17:39:29 ET
Table 'Vala' 6-max Seat #1 is the button
Seat 1: IPLAY4LINDSY ($6.05 in chips)
Seat 2: MoneysaysFU ($41.60 in chips)
Seat 3: trumpcaddy ($9.09 in chips)
Seat 4: tapouttazz9 ($10.86 in chips)
Seat 5: dwygal ($2.95 in chips)
Seat 6: magmike322 ($8.70 in chips)
MoneysaysFU: posts small blind $0.05
trumpcaddy: posts big blind $0.10
*** HOLE CARDS ***
Dealt to tapouttazz9 [8h Qs]
tapouttazz9: folds
dwygal: calls $0.10
magmike322: folds
IPLAY4LINDSY: folds
MoneysaysFU: calls $0.05
trumpcaddy: checks
*** FLOP *** [9d Td Jh]
MoneysaysFU: checks
trumpcaddy: checks
dwygal: bets $0.20
MoneysaysFU: folds
trumpcaddy: calls $0.20
*** TURN *** [9d Td Jh] [Kc]
trumpcaddy: checks
dwygal: bets $0.30
trumpcaddy: folds
Uncalled bet ($0.30) returned to dwygal
dwygal collected $0.66 from pot
dwygal: doesn't show hand
*** SUMMARY ***
Total pot $0.70 | Rake $0.04
Board [9d Td Jh Kc]
Seat 1: IPLAY4LINDSY (button) folded before Flop (didn't bet)
Seat 2: MoneysaysFU (small blind) folded on the Flop
Seat 3: trumpcaddy (big blind) folded on the Turn
Seat 4: tapouttazz9 folded before Flop (didn't bet)
Seat 5: dwygal collected ($0.66)
Seat 6: magmike322 folded before Flop (didn't bet)


PokerStars Hand #122804889141:  Hold'em No Limit ($0.05/$0.10 USD) - 2016/03/17 17:40:14 ET
Table 'Vala' 6-max Seat #2 is the button
Seat 1: IPLAY4LINDSY ($6.05 in chips)
Seat 2: MoneysaysFU ($41.50 in chips)
Seat 3: trumpcaddy ($8.79 in chips)
Seat 4: tapouttazz9 ($10.86 in chips)
Seat 5: dwygal ($3.31 in chips)
Seat 6: magmike322 ($8.70 in chips)
trumpcaddy: posts small blind $0.05
tapouttazz9: posts big blind $0.10
*** HOLE CARDS ***
Dealt to tapouttazz9 [5d 9c]
dwygal: calls $0.10
magmike322: folds
IPLAY4LINDSY: folds
MoneysaysFU: raises $0.35 to $0.45
trumpcaddy: folds
tapouttazz9: folds
dwygal: folds
Uncalled bet ($0.35) returned to MoneysaysFU
MoneysaysFU collected $0.35 from pot
*** SUMMARY ***
Total pot $0.35 | Rake $0
Seat 1: IPLAY4LINDSY folded before Flop (didn't bet)
Seat 2: MoneysaysFU (button) collected ($0.35)
Seat 3: trumpcaddy (small blind) folded before Flop
Seat 4: tapouttazz9 (big blind) folded before Flop
Seat 5: dwygal folded before Flop
Seat 6: magmike322 folded before Flop (didn't bet)


PokerStars Hand #122804889179:  Hold'em No Limit ($0.05/$0.10 USD) - 2016/03/17 17:40:34 ET
Table 'Vala' 6-max Seat #3 is the button
Seat 1: IPLAY4LINDSY ($6.05 in chips)
Seat 2: MoneysaysFU ($41.75 in chips)
Seat 3: trumpcaddy ($8.74 in chips)
Seat 4: tapouttazz9 ($10.76 in chips)
Seat 5: dwygal ($3.21 in chips)
Seat 6: magmike322 ($8.70 in chips)
tapouttazz9: posts small blind $0.05
dwygal: posts big blind $0.10
*** HOLE CARDS ***
Dealt to tapouttazz9 [3c 8c]
magmike322: calls $0.10
IPLAY4LINDSY: folds
MoneysaysFU: folds
trumpcaddy: folds
tapouttazz9: folds
dwygal: checks
*** FLOP *** [Jd 9c Th]
dwygal: checks
magmike322: bets $0.10
dwygal: calls $0.10
*** TURN *** [Jd 9c Th] [2s]
dwygal: checks
magmike322: bets $0.20
dwygal: calls $0.20
*** RIVER *** [Jd 9c Th 2s] [3d]
dwygal: checks
magmike322: bets $0.40
dwygal: folds
Uncalled bet ($0.40) returned to magmike322
magmike322 collected $0.81 from pot
magmike322: doesn't show hand
*** SUMMARY ***
Total pot $0.85 | Rake $0.04
Board [Jd 9c Th 2s 3d]
Seat 1: IPLAY4LINDSY folded before Flop (didn't bet)
Seat 2: MoneysaysFU folded before Flop (didn't bet)
Seat 3: trumpcaddy (button) folded before Flop (didn't bet)
Seat 4: tapouttazz9 (small blind) folded before Flop
Seat 5: dwygal (big blind) folded on the River
Seat 6: magmike322 collected ($0.81)


PokerStars Hand #122804889271:  Hold'em No Limit ($0.05/$0.10 USD) - 2016/03/17 17:41:17 ET
Table 'Vala' 6-max Seat #4 is the button
Seat 1: IPLAY4LINDSY ($6.05 in chips)
Seat 2: MoneysaysFU ($41.75 in chips)
Seat 3: trumpcaddy ($8.74 in chips)
Seat 4: tapouttazz9 ($10.71 in chips)
Seat 5: dwygal ($2.81 in chips)
Seat 6: magmike322 ($9.11 in chips)
dwygal: posts small blind $0.05
magmike322: posts big blind $0.10
*** HOLE CARDS ***
Dealt to tapouttazz9 [8c Jd]
IPLAY4LINDSY: folds
MoneysaysFU: raises $0.25 to $0.35
trumpcaddy: folds
tapouttazz9: folds
dwygal: raises $0.25 to $0.60
magmike322: folds
MoneysaysFU: calls $0.25
*** FLOP *** [Qd 8d 3c]
dwygal: bets $1
MoneysaysFU: folds
Uncalled bet ($1) returned to dwygal
dwygal collected $1.24 from pot
dwygal: doesn't show hand
*** SUMMARY ***
Total pot $1.30 | Rake $0.06
Board [Qd 8d 3c]
Seat 1: IPLAY4LINDSY folded before Flop (didn't bet)
Seat 2: MoneysaysFU folded on the Flop
Seat 3: trumpcaddy folded before Flop (didn't bet)
Seat 4: tapouttazz9 (button) folded before Flop (didn't bet)
Seat 5: dwygal (small blind) collected ($1.24)
Seat 6: magmike322 (big blind) folded before Flop


PokerStars Hand #122804889344:  Hold'em No Limit ($0.05/$0.10 USD) - 2016/03/17 17:41:50 ET
Table 'Vala' 6-max Seat #5 is the button
Seat 1: IPLAY4LINDSY ($6.05 in chips)
Seat 2: MoneysaysFU ($41.15 in chips)
Seat 3: trumpcaddy ($8.74 in chips)
Seat 4: tapouttazz9 ($10.71 in chips)
Seat 5: dwygal ($3.45 in chips)
Seat 6: magmike322 ($9.01 in chips)
magmike322: posts small blind $0.05
IPLAY4LINDSY: posts big blind $0.10
*** HOLE CARDS ***
Dealt to tapouttazz9 [9s 8d]
MoneysaysFU: folds
trumpcaddy: raises $0.25 to $0.35
tapouttazz9: folds
dwygal: calls $0.35
magmike322: folds
IPLAY4LINDSY: calls $0.25
*** FLOP *** [2h As Qs]
IPLAY4LINDSY: checks
trumpcaddy: bets $1.04
dwygal: folds
IPLAY4LINDSY: folds
Uncalled bet ($1.04) returned to trumpcaddy
trumpcaddy collected $1.04 from pot
trumpcaddy: doesn't show hand
*** SUMMARY ***
Total pot $1.10 | Rake $0.06
Board [2h As Qs]
Seat 1: IPLAY4LINDSY (big blind) folded on the Flop
Seat 2: MoneysaysFU folded before Flop (didn't bet)
Seat 3: trumpcaddy collected ($1.04)
Seat 4: tapouttazz9 folded before Flop (didn't bet)
Seat 5: dwygal (button) folded on the Flop
Seat 6: magmike322 (small blind) folded before Flop


PokerStars Hand #122804889413:  Hold'em No Limit ($0.05/$0.10 USD) - 2016/03/17 17:42:25 ET
Table 'Vala' 6-max Seat #6 is the button
Seat 1: IPLAY4LINDSY ($5.70 in chips)
Seat 2: MoneysaysFU ($41.15 in chips)
Seat 3: trumpcaddy ($9.43 in chips)
Seat 4: tapouttazz9 ($10.71 in chips)
Seat 5: dwygal ($3.10 in chips)
Seat 6: magmike322 ($8.96 in chips)
IPLAY4LINDSY: posts small blind $0.05
MoneysaysFU: posts big blind $0.10
*** HOLE CARDS ***
Dealt to tapouttazz9 [6h 6c]
trumpcaddy: raises $0.30 to $0.40
tapouttazz9: calls $0.40
dwygal: folds
magmike322: folds
IPLAY4LINDSY: calls $0.35
MoneysaysFU: calls $0.30
*** FLOP *** [Qh Jd 3c]
IPLAY4LINDSY: checks
MoneysaysFU: checks
trumpcaddy: bets $1.52
tapouttazz9: folds
IPLAY4LINDSY: folds
MoneysaysFU: folds
Uncalled bet ($1.52) returned to trumpcaddy
trumpcaddy collected $1.52 from pot
trumpcaddy: doesn't show hand
*** SUMMARY ***
Total pot $1.60 | Rake $0.08
Board [Qh Jd 3c]
Seat 1: IPLAY4LINDSY (small blind) folded on the Flop
Seat 2: MoneysaysFU (big blind) folded on the Flop
Seat 3: trumpcaddy collected ($1.52)
Seat 4: tapouttazz9 folded on the Flop
Seat 5: dwygal folded before Flop (didn't bet)
Seat 6: magmike322 (button) folded before Flop (didn't bet)


PokerStars Hand #158087089442:  Hold'em No Limit ($0.05/$0.10 USD) - 2016/09/11 10:43:12 ET
Table 'Vala' 6-max Seat #2 is the button
Seat 2: dougwid ($10 in chips)
Seat 3: tapouttazz9 ($10 in chips)
dougwid: posts small blind $0.05
tapouttazz9: posts big blind $0.10
*** HOLE CARDS ***
Dealt to tapouttazz9 [6d Jh]
dougwid: calls $0.05
tapouttazz9: checks
*** FLOP *** [6h 9c 5c]
tapouttazz9: bets $0.20
dougwid: calls $0.20
*** TURN *** [6h 9c 5c] [8d]
tapouttazz9: checks
dougwid: checks
*** RIVER *** [6h 9c 5c 8d] [6c]
tapouttazz9: bets $0.57
dougwid: folds
Uncalled bet ($0.57) returned to tapouttazz9
tapouttazz9 collected $0.57 from pot
*** SUMMARY ***
Total pot $0.60 | Rake $0.03
Board [6h 9c 5c 8d 6c]
Seat 2: dougwid (button) (small blind) folded on the River
Seat 3: tapouttazz9 (big blind) collected ($0.57)


PokerStars Hand #158087089508:  Hold'em No Limit ($0.05/$0.10 USD) - 2016/09/11 10:43:38 ET
Table 'Vala' 6-max Seat #3 is the button
Seat 2: dougwid ($10 in chips)
Seat 3: tapouttazz9 ($10.27 in chips)
tapouttazz9: posts small blind $0.05
dougwid: posts big blind $0.10
*** HOLE CARDS ***
Dealt to tapouttazz9 [2d Qh]
tapouttazz9: calls $0.05
dougwid: checks
*** FLOP *** [5c 9c Qs]
dougwid: checks
tapouttazz9: checks
*** TURN *** [5c 9c Qs] [As]
dougwid: checks
tapouttazz9: checks
*** RIVER *** [5c 9c Qs As] [2c]
theboss3232 joins the table at seat #4
dougwid: checks
tapouttazz9: bets $0.20
dougwid: calls $0.20
*** SHOW DOWN ***
tapouttazz9: shows [2d Qh] (two pair, Queens and Deuces)
dougwid: mucks hand
tapouttazz9 collected $0.57 from pot
*** SUMMARY ***
Total pot $0.60 | Rake $0.03
Board [5c 9c Qs As 2c]
Seat 2: dougwid (big blind) mucked [Jc 2s]
Seat 3: tapouttazz9 (button) (small blind) showed [2d Qh] and won ($0.57) with two pair, Queens and Deuces


PokerStars Hand #158087089586:  Hold'em No Limit ($0.05/$0.10 USD) - 2016/09/11 10:44:08 ET
Table 'Vala' 6-max Seat #2 is the button
Seat 2: dougwid ($10 in chips)
Seat 3: tapouttazz9 ($10.54 in chips)
dougwid: posts small blind $0.05
tapouttazz9: posts big blind $0.10
*** HOLE CARDS ***
Dealt to tapouttazz9 [2c 5c]
dougwid: calls $0.05
tapouttazz9: checks
*** FLOP *** [9s Tc 3d]
Psychoticpro joins the table at seat #5
tapouttazz9: checks
dougwid: checks
*** TURN *** [9s Tc 3d] [Js]
tapouttazz9: checks
dougwid: checks
*** RIVER *** [9s Tc 3d Js] [9d]
tapouttazz9: checks
dougwid: bets $0.19
tapouttazz9: folds
Uncalled bet ($0.19) returned to dougwid
dougwid collected $0.19 from pot
dougwid: doesn't show hand
*** SUMMARY ***
Total pot $0.20 | Rake $0.01
Board [9s Tc 3d Js 9d]
Seat 2: dougwid (button) (small blind) collected ($0.19)
Seat 3: tapouttazz9 (big blind) folded on the River


PokerStars Hand #158087089661:  Hold'em No Limit ($0.05/$0.10 USD) - 2016/09/11 10:44:41 ET
Table 'Vala' 6-max Seat #2 is the button
Seat 2: dougwid ($10.09 in chips)
Seat 3: tapouttazz9 ($10.44 in chips)
Seat 4: theboss3232 ($8 in chips)
tapouttazz9: posts small blind $0.05
theboss3232: posts big blind $0.10
Psychoticpro: sits out
*** HOLE CARDS ***
Dealt to tapouttazz9 [Kc Td]
noooy joins the table at seat #6
dougwid: folds
tapouttazz9: raises $0.10 to $0.20
theboss3232: calls $0.10
*** FLOP *** [9h Ts Qs]
tapouttazz9: checks
theboss3232: checks
*** TURN *** [9h Ts Qs] [7s]
tapouttazz9: bets $0.30
theboss3232: folds
Uncalled bet ($0.30) returned to tapouttazz9
tapouttazz9 collected $0.38 from pot
*** SUMMARY ***
Total pot $0.40 | Rake $0.02
Board [9h Ts Qs 7s]
Seat 2: dougwid (button) folded before Flop (didn't bet)
Seat 3: tapouttazz9 (small blind) collected ($0.38)
Seat 4: theboss3232 (big blind) folded on the Turn


PokerStars Hand #158087089746:  Hold'em No Limit ($0.05/$0.10 USD) - 2016/09/11 10:45:15 ET
Table 'Vala' 6-max Seat #3 is the button
Seat 2: dougwid ($10.09 in chips)
Seat 3: tapouttazz9 ($10.62 in chips)
Seat 4: theboss3232 ($7.80 in chips)
Seat 5: Psychoticpro ($8 in chips)
theboss3232: posts small blind $0.05
Psychoticpro: posts big blind $0.10
noooy: sits out
*** HOLE CARDS ***
Dealt to tapouttazz9 [7c 4s]
alphabae00 joins the table at seat #1
dougwid: folds
tapouttazz9: folds
theboss3232: calls $0.05
Psychoticpro: checks
*** FLOP *** [6d 5d 7h]
theboss3232: checks
Psychoticpro: checks
*** TURN *** [6d 5d 7h] [Ac]
theboss3232: checks
Psychoticpro: checks
*** RIVER *** [6d 5d 7h Ac] [Jh]
theboss3232: checks
Psychoticpro: bets $0.10
theboss3232: folds
Uncalled bet ($0.10) returned to Psychoticpro
Psychoticpro collected $0.19 from pot
Psychoticpro: doesn't show hand
*** SUMMARY ***
Total pot $0.20 | Rake $0.01
Board [6d 5d 7h Ac Jh]
Seat 2: dougwid folded before Flop (didn't bet)
Seat 3: tapouttazz9 (button) folded before Flop (didn't bet)
Seat 4: theboss3232 (small blind) folded on the River
Seat 5: Psychoticpro (big blind) collected ($0.19)


PokerStars Hand #158087089841:  Hold'em No Limit ($0.05/$0.10 USD) - 2016/09/11 10:45:49 ET
Table 'Vala' 6-max Seat #4 is the button
Seat 2: dougwid ($10.09 in chips)
Seat 3: tapouttazz9 ($10.62 in chips)
Seat 4: theboss3232 ($7.70 in chips)
Seat 5: Psychoticpro ($8.09 in chips)
Seat 6: noooy ($8 in chips)
Psychoticpro: posts small blind $0.05
noooy: posts big blind $0.10
alphabae00: sits out
*** HOLE CARDS ***
Dealt to tapouttazz9 [6d Qs]
dougwid: raises $0.25 to $0.35
tapouttazz9: folds
theboss3232: folds
Psychoticpro: folds
noooy: folds
Uncalled bet ($0.25) returned to dougwid
dougwid collected $0.25 from pot
dougwid: doesn't show hand
*** SUMMARY ***
Total pot $0.25 | Rake $0
Seat 2: dougwid collected ($0.25)
Seat 3: tapouttazz9 folded before Flop (didn't bet)
Seat 4: theboss3232 (button) folded before Flop (didn't bet)
Seat 5: Psychoticpro (small blind) folded before Flop
Seat 6: noooy (big blind) folded before Flop


PokerStars Hand #158087089879:  Hold'em No Limit ($0.05/$0.10 USD) - 2016/09/11 10:46:02 ET
Table 'Vala' 6-max Seat #5 is the button
Seat 1: alphabae00 ($8 in chips)
Seat 2: dougwid ($10.24 in chips)
Seat 3: tapouttazz9 ($10.62 in chips)
Seat 4: theboss3232 ($7.70 in chips)
Seat 5: Psychoticpro ($8.04 in chips)
Seat 6: noooy ($7.90 in chips)
noooy: posts small blind $0.05
alphabae00: posts big blind $0.10
*** HOLE CARDS ***
Dealt to tapouttazz9 [5s Ac]
dougwid: folds
tapouttazz9: folds
theboss3232: raises $0.10 to $0.20
Psychoticpro: folds
noooy: folds
alphabae00: calls $0.10
*** FLOP *** [5d 2c 3c]
alphabae00: checks
theboss3232: bets $0.20
alphabae00: raises $0.20 to $0.40
theboss3232: calls $0.20
*** TURN *** [5d 2c 3c] [Kc]
alphabae00: bets $0.30
theboss3232: calls $0.30
*** RIVER *** [5d 2c 3c Kc] [6h]
alphabae00: bets $0.70
theboss3232: calls $0.70
*** SHOW DOWN ***
alphabae00: shows [8c Tc] (a flush, King high)
theboss3232: mucks hand
alphabae00 collected $3.09 from pot
*** SUMMARY ***
Total pot $3.25 | Rake $0.16
Board [5d 2c 3c Kc 6h]
Seat 1: alphabae00 (big blind) showed [8c Tc] and won ($3.09) with a flush, King high
Seat 2: dougwid folded before Flop (didn't bet)
Seat 3: tapouttazz9 folded before Flop (didn't bet)
Seat 4: theboss3232 mucked [9d Kd]
Seat 5: Psychoticpro (button) folded before Flop (didn't bet)
Seat 6: noooy (small blind) folded before Flop


PokerStars Hand #158087331107:  Hold'em No Limit ($0.05/$0.10 USD) - 2016/09/11 10:46:51 ET
Table 'Vala' 6-max Seat #6 is the button
Seat 1: alphabae00 ($9.49 in chips)
Seat 2: dougwid ($10.24 in chips)
Seat 3: tapouttazz9 ($10.62 in chips)
Seat 4: theboss3232 ($6.10 in chips)
Seat 5: Psychoticpro ($8.04 in chips)
Seat 6: noooy ($7.85 in chips)
alphabae00: posts small blind $0.05
dougwid: posts big blind $0.10
*** HOLE CARDS ***
Dealt to tapouttazz9 [Jc Ah]
tapouttazz9: raises $0.20 to $0.30
theboss3232: calls $0.30
Psychoticpro: folds
noooy: calls $0.30
alphabae00: folds
dougwid: calls $0.20
*** FLOP *** [3h Kh Ts]
dougwid: checks
tapouttazz9: checks
theboss3232: bets $0.40
noooy: folds
dougwid: calls $0.40
tapouttazz9: calls $0.40
*** TURN *** [3h Kh Ts] [Jh]
dougwid: checks
tapouttazz9: checks
theboss3232: bets $1.20
dougwid: folds
tapouttazz9: calls $1.20
*** RIVER *** [3h Kh Ts Jh] [3c]
tapouttazz9: checks
theboss3232: checks
*** SHOW DOWN ***
tapouttazz9: shows [Jc Ah] (two pair, Jacks and Threes)
theboss3232: shows [4h 5h] (a flush, King high)
theboss3232 collected $4.61 from pot
*** SUMMARY ***
Total pot $4.85 | Rake $0.24
Board [3h Kh Ts Jh 3c]
Seat 1: alphabae00 (small blind) folded before Flop
Seat 2: dougwid (big blind) folded on the Turn
Seat 3: tapouttazz9 showed [Jc Ah] and lost with two pair, Jacks and Threes
Seat 4: theboss3232 showed [4h 5h] and won ($4.61) with a flush, King high
Seat 5: Psychoticpro folded before Flop (didn't bet)
Seat 6: noooy (button) folded on the Flop


PokerStars Hand #158087331256:  Hold'em No Limit ($0.05/$0.10 USD) - 2016/09/11 10:47:45 ET
Table 'Vala' 6-max Seat #1 is the button
Seat 1: alphabae00 ($9.44 in chips)
Seat 2: dougwid ($10 in chips)
Seat 3: tapouttazz9 ($8.72 in chips)
Seat 4: theboss3232 ($8.81 in chips)
Seat 5: Psychoticpro ($8.04 in chips)
Seat 6: noooy ($7.55 in chips)
dougwid: posts small blind $0.05
tapouttazz9: posts big blind $0.10
*** HOLE CARDS ***
Dealt to tapouttazz9 [Kd Th]
theboss3232: folds
Psychoticpro: raises $0.10 to $0.20
noooy: calls $0.20
alphabae00: folds
dougwid: calls $0.15
tapouttazz9: calls $0.10
*** FLOP *** [3h 7c Jd]
dougwid: bets $0.76
tapouttazz9: folds
Psychoticpro: calls $0.76
noooy: calls $0.76
*** TURN *** [3h 7c Jd] [9h]
dougwid: checks
Psychoticpro: checks
noooy: bets $1.46
dougwid: calls $1.46
Psychoticpro: folds
*** RIVER *** [3h 7c Jd 9h] [Tc]
theboss3232 leaves the table
dougwid: checks
noooy: checks
*** SHOW DOWN ***
dougwid: shows [Ad Js] (a pair of Jacks)
noooy: mucks hand
dougwid collected $5.70 from pot
*** SUMMARY ***
Total pot $6 | Rake $0.30
Board [3h 7c Jd 9h Tc]
Seat 1: alphabae00 (button) folded before Flop (didn't bet)
Seat 2: dougwid (small blind) showed [Ad Js] and won ($5.70) with a pair of Jacks
Seat 3: tapouttazz9 (big blind) folded on the Flop
Seat 4: theboss3232 folded before Flop (didn't bet)
Seat 5: Psychoticpro folded on the Turn
Seat 6: noooy mucked [Qc Jc]


PokerStars Hand #158087331428:  Hold'em No Limit ($0.05/$0.10 USD) - 2016/09/11 10:48:46 ET
Table 'Vala' 6-max Seat #2 is the button
Seat 1: alphabae00 ($9.44 in chips)
Seat 2: dougwid ($13.28 in chips)
Seat 3: tapouttazz9 ($8.52 in chips)
Seat 5: Psychoticpro ($7.08 in chips)
Seat 6: noooy ($5.13 in chips)
tapouttazz9: posts small blind $0.05
Psychoticpro: posts big blind $0.10
*** HOLE CARDS ***
Dealt to tapouttazz9 [3s 8c]
noooy: calls $0.10
alphabae00: folds
dougwid: calls $0.10
tapouttazz9: folds
Psychoticpro: checks
*** FLOP *** [6s 9s 4c]
Psychoticpro: checks
noooy: bets $0.33
dougwid: folds
Psychoticpro: folds
Uncalled bet ($0.33) returned to noooy
noooy collected $0.33 from pot
noooy: doesn't show hand
*** SUMMARY ***
Total pot $0.35 | Rake $0.02
Board [6s 9s 4c]
Seat 1: alphabae00 folded before Flop (didn't bet)
Seat 2: dougwid (button) folded on the Flop
Seat 3: tapouttazz9 (small blind) folded before Flop
Seat 5: Psychoticpro (big blind) folded on the Flop
Seat 6: noooy collected ($0.33)


PokerStars Hand #158087331512:  Hold'em No Limit ($0.05/$0.10 USD) - 2016/09/11 10:49:19 ET
Table 'Vala' 6-max Seat #3 is the button
Seat 1: alphabae00 ($9.44 in chips)
Seat 2: dougwid ($13.18 in chips)
Seat 3: tapouttazz9 ($8.47 in chips)
Seat 5: Psychoticpro ($6.98 in chips)
Seat 6: noooy ($5.36 in chips)
Psychoticpro: posts small blind $0.05
noooy: posts big blind $0.10
*** HOLE CARDS ***
Dealt to tapouttazz9 [Tc 3s]
alphabae00: raises $0.25 to $0.35
dougwid: folds
tapouttazz9: folds
Psychoticpro: folds
noooy: folds
Uncalled bet ($0.25) returned to alphabae00
alphabae00 collected $0.25 from pot
alphabae00: doesn't show hand
*** SUMMARY ***
Total pot $0.25 | Rake $0
Seat 1: alphabae00 collected ($0.25)
Seat 2: dougwid folded before Flop (didn't bet)
Seat 3: tapouttazz9 (button) folded before Flop (didn't bet)
Seat 5: Psychoticpro (small blind) folded before Flop
Seat 6: noooy (big blind) folded before Flop


PokerStars Hand #158087331560:  Hold'em No Limit ($0.05/$0.10 USD) - 2016/09/11 10:49:34 ET
Table 'Vala' 6-max Seat #5 is the button
Seat 1: alphabae00 ($9.59 in chips)
Seat 2: dougwid ($13.18 in chips)
Seat 3: tapouttazz9 ($8.47 in chips)
Seat 5: Psychoticpro ($6.93 in chips)
Seat 6: noooy ($5.26 in chips)
noooy: posts small blind $0.05
alphabae00: posts big blind $0.10
*** HOLE CARDS ***
Dealt to tapouttazz9 [2h 3s]
dougwid: folds
tapouttazz9: folds
Psychoticpro: calls $0.10
noooy: calls $0.05
XanthanGum joins the table at seat #4
alphabae00: checks
*** FLOP *** [Jh Tc 9c]
noooy: checks
alphabae00: checks
Psychoticpro: checks
*** TURN *** [Jh Tc 9c] [Kd]
noooy: checks
alphabae00: bets $0.10
Psychoticpro: calls $0.10
noooy: folds
*** RIVER *** [Jh Tc 9c Kd] [5h]
alphabae00: checks
Psychoticpro: checks
*** SHOW DOWN ***
alphabae00: shows [9d 2d] (a pair of Nines)
Psychoticpro: mucks hand
alphabae00 collected $0.48 from pot
*** SUMMARY ***
Total pot $0.50 | Rake $0.02
Board [Jh Tc 9c Kd 5h]
Seat 1: alphabae00 (big blind) showed [9d 2d] and won ($0.48) with a pair of Nines
Seat 2: dougwid folded before Flop (didn't bet)
Seat 3: tapouttazz9 folded before Flop (didn't bet)
Seat 5: Psychoticpro (button) mucked [Ac 3h]
Seat 6: noooy (small blind) folded on the Turn


PokerStars Hand #158087331623:  Hold'em No Limit ($0.05/$0.10 USD) - 2016/09/11 10:49:58 ET
Table 'Vala' 6-max Seat #6 is the button
Seat 1: alphabae00 ($9.87 in chips)
Seat 2: dougwid ($13.18 in chips)
Seat 3: tapouttazz9 ($8.47 in chips)
Seat 5: Psychoticpro ($6.73 in chips)
Seat 6: noooy ($5.16 in chips)
alphabae00: posts small blind $0.05
dougwid: posts big blind $0.10
XanthanGum: sits out
*** HOLE CARDS ***
Dealt to tapouttazz9 [4s 9d]
tapouttazz9: folds
Psychoticpro: folds
noooy: folds
alphabae00: calls $0.05
dougwid: checks
*** FLOP *** [6d Qc Th]
alphabae00: checks
dougwid: bets $0.19
alphabae00: folds
Uncalled bet ($0.19) returned to dougwid
dougwid collected $0.19 from pot
dougwid: doesn't show hand
*** SUMMARY ***
Total pot $0.20 | Rake $0.01
Board [6d Qc Th]
Seat 1: alphabae00 (small blind) folded on the Flop
Seat 2: dougwid (big blind) collected ($0.19)
Seat 3: tapouttazz9 folded before Flop (didn't bet)
Seat 5: Psychoticpro folded before Flop (didn't bet)
Seat 6: noooy (button) folded before Flop (didn't bet)


PokerStars Hand #158087331703:  Hold'em No Limit ($0.05/$0.10 USD) - 2016/09/11 10:50:20 ET
Table 'Vala' 6-max Seat #1 is the button
Seat 1: alphabae00 ($9.77 in chips)
Seat 2: dougwid ($13.27 in chips)
Seat 3: tapouttazz9 ($8.47 in chips)
Seat 5: Psychoticpro ($6.73 in chips)
Seat 6: noooy ($5.16 in chips)
dougwid: posts small blind $0.05
tapouttazz9: posts big blind $0.10
XanthanGum: sits out
*** HOLE CARDS ***
Dealt to tapouttazz9 [5c 7d]
Psychoticpro: folds
noooy: calls $0.10
alphabae00: folds
dougwid: folds
tapouttazz9: checks
*** FLOP *** [4c Td 2c]
tapouttazz9: checks
noooy: checks
*** TURN *** [4c Td 2c] [9s]
tapouttazz9: checks
noooy: bets $0.24
tapouttazz9: folds
Uncalled bet ($0.24) returned to noooy
noooy collected $0.24 from pot
noooy: doesn't show hand
*** SUMMARY ***
Total pot $0.25 | Rake $0.01
Board [4c Td 2c 9s]
Seat 1: alphabae00 (button) folded before Flop (didn't bet)
Seat 2: dougwid (small blind) folded before Flop
Seat 3: tapouttazz9 (big blind) folded on the Turn
Seat 5: Psychoticpro folded before Flop (didn't bet)
Seat 6: noooy collected ($0.24)


PokerStars Hand #158087331783:  Hold'em No Limit ($0.05/$0.10 USD) - 2016/09/11 10:50:49 ET
Table 'Vala' 6-max Seat #2 is the button
Seat 1: alphabae00 ($9.77 in chips)
Seat 2: dougwid ($13.22 in chips)
Seat 3: tapouttazz9 ($8.37 in chips)
Seat 4: XanthanGum ($8 in chips)
Seat 5: Psychoticpro ($6.73 in chips)
Seat 6: noooy ($5.30 in chips)
tapouttazz9: posts small blind $0.05
XanthanGum: posts big blind $0.10
*** HOLE CARDS ***
Dealt to tapouttazz9 [8c Td]
Psychoticpro: calls $0.10
noooy: folds
alphabae00: folds
dougwid: folds
tapouttazz9: folds
XanthanGum: checks
*** FLOP *** [Kd 3h Jh]
XanthanGum: checks
Psychoticpro: checks
*** TURN *** [Kd 3h Jh] [6c]
XanthanGum: checks
Psychoticpro: bets $0.10
XanthanGum: folds
Uncalled bet ($0.10) returned to Psychoticpro
Psychoticpro collected $0.24 from pot
Psychoticpro: doesn't show hand
*** SUMMARY ***
Total pot $0.25 | Rake $0.01
Board [Kd 3h Jh 6c]
Seat 1: alphabae00 folded before Flop (didn't bet)
Seat 2: dougwid (button) folded before Flop (didn't bet)
Seat 3: tapouttazz9 (small blind) folded before Flop
Seat 4: XanthanGum (big blind) folded on the Turn
Seat 5: Psychoticpro collected ($0.24)
Seat 6: noooy folded before Flop (didn't bet)


PokerStars Hand #158087331831:  Hold'em No Limit ($0.05/$0.10 USD) - 2016/09/11 10:51:09 ET
Table 'Vala' 6-max Seat #3 is the button
Seat 1: alphabae00 ($9.77 in chips)
Seat 2: dougwid ($13.22 in chips)
Seat 3: tapouttazz9 ($8.32 in chips)
Seat 4: XanthanGum ($7.90 in chips)
Seat 5: Psychoticpro ($6.87 in chips)
Seat 6: noooy ($5.30 in chips)
XanthanGum: posts small blind $0.05
Psychoticpro: posts big blind $0.10
*** HOLE CARDS ***
Dealt to tapouttazz9 [8h Ah]
noooy: folds
alphabae00: folds
dougwid: folds
tapouttazz9: raises $0.20 to $0.30
XanthanGum: calls $0.25
Psychoticpro: folds
*** FLOP *** [7d Th Kh]
XanthanGum: checks
tapouttazz9: checks
*** TURN *** [7d Th Kh] [Jc]
XanthanGum: checks
tapouttazz9: checks
*** RIVER *** [7d Th Kh Jc] [3h]
XanthanGum: bets $0.33
tapouttazz9: raises $1.32 to $1.65
XanthanGum: calls $1.32
*** SHOW DOWN ***
tapouttazz9: shows [8h Ah] (a flush, Ace high)
XanthanGum: mucks hand
tapouttazz9 collected $3.80 from pot
*** SUMMARY ***
Total pot $4 | Rake $0.20
Board [7d Th Kh Jc 3h]
Seat 1: alphabae00 folded before Flop (didn't bet)
Seat 2: dougwid folded before Flop (didn't bet)
Seat 3: tapouttazz9 (button) showed [8h Ah] and won ($3.80) with a flush, Ace high
Seat 4: XanthanGum (small blind) mucked [9h 8s]
Seat 5: Psychoticpro (big blind) folded before Flop
Seat 6: noooy folded before Flop (didn't bet)


PokerStars Hand #158087331958:  Hold'em No Limit ($0.05/$0.10 USD) - 2016/09/11 10:51:51 ET
Table 'Vala' 6-max Seat #4 is the button
Seat 1: alphabae00 ($9.77 in chips)
Seat 2: dougwid ($13.22 in chips)
Seat 3: tapouttazz9 ($10.17 in chips)
Seat 4: XanthanGum ($5.95 in chips)
Seat 5: Psychoticpro ($6.77 in chips)
Seat 6: noooy ($5.30 in chips)
Psychoticpro: posts small blind $0.05
noooy: posts big blind $0.10
*** HOLE CARDS ***
Dealt to tapouttazz9 [8c 8h]
alphabae00: folds
dougwid: folds
tapouttazz9: raises $0.10 to $0.20
XanthanGum: folds
Psychoticpro: calls $0.15
noooy: calls $0.10
*** FLOP *** [Ks Th Qc]
Psychoticpro: checks
noooy: checks
tapouttazz9: checks
*** TURN *** [Ks Th Qc] [Kc]
Psychoticpro: bets $0.10
noooy: folds
tapouttazz9: folds
Uncalled bet ($0.10) returned to Psychoticpro
Psychoticpro collected $0.57 from pot
Psychoticpro: doesn't show hand
*** SUMMARY ***
Total pot $0.60 | Rake $0.03
Board [Ks Th Qc Kc]
Seat 1: alphabae00 folded before Flop (didn't bet)
Seat 2: dougwid folded before Flop (didn't bet)
Seat 3: tapouttazz9 folded on the Turn
Seat 4: XanthanGum (button) folded before Flop (didn't bet)
Seat 5: Psychoticpro (small blind) collected ($0.57)
Seat 6: noooy (big blind) folded on the Turn


PokerStars Hand #158087332060:  Hold'em No Limit ($0.05/$0.10 USD) - 2016/09/11 10:52:27 ET
Table 'Vala' 6-max Seat #5 is the button
Seat 1: alphabae00 ($9.77 in chips)
Seat 2: dougwid ($13.22 in chips)
Seat 3: tapouttazz9 ($9.97 in chips)
Seat 4: XanthanGum ($5.95 in chips)
Seat 5: Psychoticpro ($7.14 in chips)
Seat 6: noooy ($5.10 in chips)
noooy: posts small blind $0.05
alphabae00: posts big blind $0.10
*** HOLE CARDS ***
Dealt to tapouttazz9 [As 5c]
dougwid: folds
tapouttazz9: folds
XanthanGum: calls $0.10
Psychoticpro: calls $0.10
noooy: raises $0.10 to $0.20
alphabae00: calls $0.10
XanthanGum: raises $5.75 to $5.95 and is all-in
Psychoticpro: folds
noooy: folds
alphabae00: folds
Uncalled bet ($5.75) returned to XanthanGum
XanthanGum collected $0.70 from pot
XanthanGum: doesn't show hand
*** SUMMARY ***
Total pot $0.70 | Rake $0
Seat 1: alphabae00 (big blind) folded before Flop
Seat 2: dougwid folded before Flop (didn't bet)
Seat 3: tapouttazz9 folded before Flop (didn't bet)
Seat 4: XanthanGum collected ($0.70)
Seat 5: Psychoticpro (button) folded before Flop
Seat 6: noooy (small blind) folded before Flop


PokerStars Hand #158087332141:  Hold'em No Limit ($0.05/$0.10 USD) - 2016/09/11 10:52:56 ET
Table 'Vala' 6-max Seat #6 is the button
Seat 1: alphabae00 ($9.57 in chips)
Seat 2: dougwid ($13.22 in chips)
Seat 3: tapouttazz9 ($9.97 in chips)
Seat 4: XanthanGum ($6.45 in chips)
Seat 5: Psychoticpro ($7.04 in chips)
Seat 6: noooy ($4.90 in chips)
alphabae00: posts small blind $0.05
dougwid: posts big blind $0.10
*** HOLE CARDS ***
Dealt to tapouttazz9 [Ad 5s]
tapouttazz9: folds
XanthanGum: folds
Psychoticpro: calls $0.10
noooy: calls $0.10
alphabae00: calls $0.05
dougwid: checks
*** FLOP *** [Js Kc Qh]
alphabae00: checks
dougwid: checks
Psychoticpro: checks
noooy: bets $0.19
alphabae00: folds
dougwid: folds
Psychoticpro: folds
Uncalled bet ($0.19) returned to noooy
noooy collected $0.38 from pot
noooy: doesn't show hand
*** SUMMARY ***
Total pot $0.40 | Rake $0.02
Board [Js Kc Qh]
Seat 1: alphabae00 (small blind) folded on the Flop
Seat 2: dougwid (big blind) folded on the Flop
Seat 3: tapouttazz9 folded before Flop (didn't bet)
Seat 4: XanthanGum folded before Flop (didn't bet)
Seat 5: Psychoticpro folded on the Flop
Seat 6: noooy (button) collected ($0.38)


PokerStars Hand #158087332251:  Hold'em No Limit ($0.05/$0.10 USD) - 2016/09/11 10:53:34 ET
Table 'Vala' 6-max Seat #1 is the button
Seat 1: alphabae00 ($9.47 in chips)
Seat 2: dougwid ($13.12 in chips)
Seat 3: tapouttazz9 ($9.97 in chips)
Seat 4: XanthanGum ($6.45 in chips)
Seat 5: Psychoticpro ($6.94 in chips)
Seat 6: noooy ($5.18 in chips)
dougwid: posts small blind $0.05
tapouttazz9: posts big blind $0.10
*** HOLE CARDS ***
Dealt to tapouttazz9 [Jc 4h]
XanthanGum: folds
Psychoticpro: folds
noooy: calls $0.10
alphabae00: folds
dougwid: raises $0.30 to $0.40
tapouttazz9: folds
noooy: folds
Uncalled bet ($0.30) returned to dougwid
dougwid collected $0.30 from pot
dougwid: doesn't show hand
*** SUMMARY ***
Total pot $0.30 | Rake $0
Seat 1: alphabae00 (button) folded before Flop (didn't bet)
Seat 2: dougwid (small blind) collected ($0.30)
Seat 3: tapouttazz9 (big blind) folded before Flop
Seat 4: XanthanGum folded before Flop (didn't bet)
Seat 5: Psychoticpro folded before Flop (didn't bet)
Seat 6: noooy folded before Flop


PokerStars Hand #158087332288:  Hold'em No Limit ($0.05/$0.10 USD) - 2016/09/11 10:53:48 ET
Table 'Vala' 6-max Seat #2 is the button
Seat 1: alphabae00 ($9.47 in chips)
Seat 2: dougwid ($13.32 in chips)
Seat 3: tapouttazz9 ($9.87 in chips)
Seat 4: XanthanGum ($6.45 in chips)
Seat 5: Psychoticpro ($6.94 in chips)
Seat 6: noooy ($5.08 in chips)
tapouttazz9: posts small blind $0.05
XanthanGum: posts big blind $0.10
*** HOLE CARDS ***
Dealt to tapouttazz9 [Jc Ts]
Psychoticpro: folds
noooy: calls $0.10
alphabae00: folds
dougwid: folds
tapouttazz9: calls $0.05
XanthanGum: checks
*** FLOP *** [Th 2c 6d]
tapouttazz9: bets $0.30
XanthanGum: folds
noooy: folds
Uncalled bet ($0.30) returned to tapouttazz9
tapouttazz9 collected $0.28 from pot
*** SUMMARY ***
Total pot $0.30 | Rake $0.02
Board [Th 2c 6d]
Seat 1: alphabae00 folded before Flop (didn't bet)
Seat 2: dougwid (button) folded before Flop (didn't bet)
Seat 3: tapouttazz9 (small blind) collected ($0.28)
Seat 4: XanthanGum (big blind) folded on the Flop
Seat 5: Psychoticpro folded before Flop (didn't bet)
Seat 6: noooy folded on the Flop


PokerStars Hand #158087332502:  Hold'em No Limit ($0.05/$0.10 USD) - 2016/09/11 10:55:10 ET
Table 'Vala' 6-max Seat #3 is the button
Seat 1: alphabae00 ($9.47 in chips)
Seat 2: dougwid ($13.32 in chips)
Seat 3: tapouttazz9 ($10.05 in chips)
Seat 4: XanthanGum ($6.35 in chips)
Seat 5: Psychoticpro ($6.94 in chips)
Seat 6: noooy ($4.98 in chips)
XanthanGum: posts small blind $0.05
Psychoticpro: posts big blind $0.10
*** HOLE CARDS ***
Dealt to tapouttazz9 [5d 6d]
noooy: folds
alphabae00: raises $0.20 to $0.30
dougwid: calls $0.30
tapouttazz9: folds
XanthanGum: folds
Psychoticpro: calls $0.20
*** FLOP *** [4d Qs 6c]
Psychoticpro: checks
alphabae00: bets $0.60
dougwid: folds
Psychoticpro: calls $0.60
*** TURN *** [4d Qs 6c] [9s]
Psychoticpro: checks
alphabae00: checks
*** RIVER *** [4d Qs 6c 9s] [4c]
Psychoticpro: checks
alphabae00: checks
*** SHOW DOWN ***
Psychoticpro: shows [Kc Ad] (a pair of Fours)
alphabae00: mucks hand
Psychoticpro collected $2.04 from pot
*** SUMMARY ***
Total pot $2.15 | Rake $0.11
Board [4d Qs 6c 9s 4c]
Seat 1: alphabae00 mucked [Ah 7h]
Seat 2: dougwid folded on the Flop
Seat 3: tapouttazz9 (button) folded before Flop (didn't bet)
Seat 4: XanthanGum (small blind) folded before Flop
Seat 5: Psychoticpro (big blind) showed [Kc Ad] and won ($2.04) with a pair of Fours
Seat 6: noooy folded before Flop (didn't bet)


PokerStars Hand #158087332655:  Hold'em No Limit ($0.05/$0.10 USD) - 2016/09/11 10:56:02 ET
Table 'Vala' 6-max Seat #4 is the button
Seat 1: alphabae00 ($8.57 in chips)
Seat 2: dougwid ($13.02 in chips)
Seat 3: tapouttazz9 ($10.05 in chips)
Seat 4: XanthanGum ($6.30 in chips)
Seat 5: Psychoticpro ($8.08 in chips)
Seat 6: noooy ($4.98 in chips)
Psychoticpro: posts small blind $0.05
noooy: posts big blind $0.10
*** HOLE CARDS ***
Dealt to tapouttazz9 [2h 4h]
alphabae00: folds
dougwid: folds
tapouttazz9: folds
XanthanGum: folds
Psychoticpro: calls $0.05
noooy: checks
*** FLOP *** [7c As 5d]
Psychoticpro: checks
noooy: bets $0.19
Psychoticpro: folds
Uncalled bet ($0.19) returned to noooy
noooy collected $0.19 from pot
noooy: doesn't show hand
*** SUMMARY ***
Total pot $0.20 | Rake $0.01
Board [7c As 5d]
Seat 1: alphabae00 folded before Flop (didn't bet)
Seat 2: dougwid folded before Flop (didn't bet)
Seat 3: tapouttazz9 folded before Flop (didn't bet)
Seat 4: XanthanGum (button) folded before Flop (didn't bet)
Seat 5: Psychoticpro (small blind) folded on the Flop
Seat 6: noooy (big blind) collected ($0.19)


PokerStars Hand #158087332714:  Hold'em No Limit ($0.05/$0.10 USD) - 2016/09/11 10:56:20 ET
Table 'Vala' 6-max Seat #5 is the button
Seat 1: alphabae00 ($8.57 in chips)
Seat 2: dougwid ($13.02 in chips)
Seat 3: tapouttazz9 ($10.05 in chips)
Seat 4: XanthanGum ($6.30 in chips)
Seat 5: Psychoticpro ($7.98 in chips)
Seat 6: noooy ($5.07 in chips)
noooy: posts small blind $0.05
alphabae00: posts big blind $0.10
*** HOLE CARDS ***
Dealt to tapouttazz9 [5s Th]
dougwid: folds
tapouttazz9: folds
XanthanGum: folds
Psychoticpro: calls $0.10
noooy: folds
alphabae00: checks
*** FLOP *** [6d 4h Td]
alphabae00: checks
Psychoticpro: checks
*** TURN *** [6d 4h Td] [3h]
alphabae00: bets $0.20
Psychoticpro: calls $0.20
*** RIVER *** [6d 4h Td 3h] [4c]
alphabae00: bets $0.50
Psychoticpro: folds
Uncalled bet ($0.50) returned to alphabae00
alphabae00 collected $0.62 from pot
alphabae00: doesn't show hand
*** SUMMARY ***
Total pot $0.65 | Rake $0.03
Board [6d 4h Td 3h 4c]
Seat 1: alphabae00 (big blind) collected ($0.62)
Seat 2: dougwid folded before Flop (didn't bet)
Seat 3: tapouttazz9 folded before Flop (didn't bet)
Seat 4: XanthanGum folded before Flop (didn't bet)
Seat 5: Psychoticpro (button) folded on the River
Seat 6: noooy (small blind) folded before Flop


PokerStars Hand #158087332788:  Hold'em No Limit ($0.05/$0.10 USD) - 2016/09/11 10:56:45 ET
Table 'Vala' 6-max Seat #6 is the button
Seat 1: alphabae00 ($8.89 in chips)
Seat 2: dougwid ($13.02 in chips)
Seat 3: tapouttazz9 ($10.05 in chips)
Seat 4: XanthanGum ($6.30 in chips)
Seat 5: Psychoticpro ($7.68 in chips)
Seat 6: noooy ($5.02 in chips)
alphabae00: posts small blind $0.05
dougwid: posts big blind $0.10
*** HOLE CARDS ***
Dealt to tapouttazz9 [Qh 5s]
tapouttazz9: folds
XanthanGum: folds
Psychoticpro: folds
noooy: calls $0.10
alphabae00: calls $0.05
dougwid: checks
*** FLOP *** [6s Ts Ac]
alphabae00: checks
dougwid: checks
noooy: checks
*** TURN *** [6s Ts Ac] [4d]
alphabae00: checks
dougwid: checks
noooy: bets $0.28
alphabae00: folds
dougwid: folds
Uncalled bet ($0.28) returned to noooy
noooy collected $0.28 from pot
noooy: doesn't show hand
*** SUMMARY ***
Total pot $0.30 | Rake $0.02
Board [6s Ts Ac 4d]
Seat 1: alphabae00 (small blind) folded on the Turn
Seat 2: dougwid (big blind) folded on the Turn
Seat 3: tapouttazz9 folded before Flop (didn't bet)
Seat 4: XanthanGum folded before Flop (didn't bet)
Seat 5: Psychoticpro folded before Flop (didn't bet)
Seat 6: noooy (button) collected ($0.28)


PokerStars Hand #158087332916:  Hold'em No Limit ($0.05/$0.10 USD) - 2016/09/11 10:57:24 ET
Table 'Vala' 6-max Seat #1 is the button
Seat 1: alphabae00 ($8.79 in chips)
Seat 2: dougwid ($12.92 in chips)
Seat 3: tapouttazz9 ($10.05 in chips)
Seat 4: XanthanGum ($6.30 in chips)
Seat 5: Psychoticpro ($7.68 in chips)
Seat 6: noooy ($5.20 in chips)
dougwid: posts small blind $0.05
tapouttazz9: posts big blind $0.10
*** HOLE CARDS ***
Dealt to tapouttazz9 [7s 7c]
XanthanGum: folds
Psychoticpro: calls $0.10
noooy: folds
alphabae00: folds
dougwid: folds
tapouttazz9: checks
*** FLOP *** [5s 3c Kc]
tapouttazz9: checks
Psychoticpro: checks
*** TURN *** [5s 3c Kc] [Td]
tapouttazz9: checks
Psychoticpro: checks
*** RIVER *** [5s 3c Kc Td] [Jh]
tapouttazz9: checks
Psychoticpro: checks
*** SHOW DOWN ***
tapouttazz9: shows [7s 7c] (a pair of Sevens)
Psychoticpro: mucks hand
tapouttazz9 collected $0.24 from pot
*** SUMMARY ***
Total pot $0.25 | Rake $0.01
Board [5s 3c Kc Td Jh]
Seat 1: alphabae00 (button) folded before Flop (didn't bet)
Seat 2: dougwid (small blind) folded before Flop
Seat 3: tapouttazz9 (big blind) showed [7s 7c] and won ($0.24) with a pair of Sevens
Seat 4: XanthanGum folded before Flop (didn't bet)
Seat 5: Psychoticpro mucked [7h 8s]
Seat 6: noooy folded before Flop (didn't bet)


PokerStars Hand #158087332984:  Hold'em No Limit ($0.05/$0.10 USD) - 2016/09/11 10:57:47 ET
Table 'Vala' 6-max Seat #2 is the button
Seat 1: alphabae00 ($8.79 in chips)
Seat 2: dougwid ($12.87 in chips)
Seat 3: tapouttazz9 ($10.19 in chips)
Seat 4: XanthanGum ($6.30 in chips)
Seat 5: Psychoticpro ($7.58 in chips)
Seat 6: noooy ($5.20 in chips)
tapouttazz9: posts small blind $0.05
XanthanGum: posts big blind $0.10
*** HOLE CARDS ***
Dealt to tapouttazz9 [Ks Kh]
Psychoticpro: calls $0.10
noooy: folds
alphabae00: raises $0.35 to $0.45
dougwid: folds
tapouttazz9: raises $0.35 to $0.80
XanthanGum: folds
Psychoticpro: folds
alphabae00: calls $0.35
*** FLOP *** [Qh Qc Ad]
tapouttazz9: checks
alphabae00: bets $0.80
tapouttazz9: calls $0.80
*** TURN *** [Qh Qc Ad] [Jd]
tapouttazz9: checks
alphabae00: checks
*** RIVER *** [Qh Qc Ad Jd] [Tc]
tapouttazz9: bets $8.59 and is all-in
alphabae00: folds
Uncalled bet ($8.59) returned to tapouttazz9
tapouttazz9 collected $3.23 from pot
*** SUMMARY ***
Total pot $3.40 | Rake $0.17
Board [Qh Qc Ad Jd Tc]
Seat 1: alphabae00 folded on the River
Seat 2: dougwid (button) folded before Flop (didn't bet)
Seat 3: tapouttazz9 (small blind) collected ($3.23)
Seat 4: XanthanGum (big blind) folded before Flop
Seat 5: Psychoticpro folded before Flop
Seat 6: noooy folded before Flop (didn't bet)


PokerStars Hand #122879869683:  Hold'em No Limit ($0.05/$0.10 USD) - 2016/03/18 22:29:33 ET
Table 'Gemini' 6-max Seat #3 is the button
Seat 1: chachamaru ($9.94 in chips)
Seat 2: retrd08 ($1.07 in chips)
Seat 3: chipsdonator ($16.36 in chips)
Seat 4: Any2CardsRIU ($10.05 in chips)
Seat 5: tapouttazz9 ($10 in chips)
Any2CardsRIU: posts small blind $0.05
tapouttazz9: posts big blind $0.10
eastwickrich: sits out
*** HOLE CARDS ***
Dealt to tapouttazz9 [7s 7d]
chachamaru: folds
retrd08: raises $0.97 to $1.07 and is all-in
chipsdonator: folds
Any2CardsRIU: folds
tapouttazz9: calls $0.97
*** FLOP *** [Td 6c 2s]
*** TURN *** [Td 6c 2s] [Ac]
*** RIVER *** [Td 6c 2s Ac] [Js]
*** SHOW DOWN ***
tapouttazz9: shows [7s 7d] (a pair of Sevens)
retrd08: shows [8h 8s] (a pair of Eights)
retrd08 collected $2.08 from pot
*** SUMMARY ***
Total pot $2.19 | Rake $0.11
Board [Td 6c 2s Ac Js]
Seat 1: chachamaru folded before Flop (didn't bet)
Seat 2: retrd08 showed [8h 8s] and won ($2.08) with a pair of Eights
Seat 3: chipsdonator (button) folded before Flop (didn't bet)
Seat 4: Any2CardsRIU (small blind) folded before Flop
Seat 5: tapouttazz9 (big blind) showed [7s 7d] and lost with a pair of Sevens


PokerStars Hand #122879869742:  Hold'em No Limit ($0.05/$0.10 USD) - 2016/03/18 22:29:55 ET
Table 'Gemini' 6-max Seat #4 is the button
Seat 1: chachamaru ($9.94 in chips)
Seat 2: retrd08 ($2.08 in chips)
Seat 3: chipsdonator ($16.36 in chips)
Seat 4: Any2CardsRIU ($10 in chips)
Seat 5: tapouttazz9 ($8.93 in chips)
Seat 6: eastwickrich ($8 in chips)
tapouttazz9: posts small blind $0.05
eastwickrich: posts big blind $0.10
*** HOLE CARDS ***
Dealt to tapouttazz9 [8c Ah]
chachamaru: folds
retrd08: folds
chipsdonator: folds
Any2CardsRIU: folds
tapouttazz9: folds
Uncalled bet ($0.05) returned to eastwickrich
eastwickrich collected $0.10 from pot
eastwickrich: doesn't show hand
*** SUMMARY ***
Total pot $0.10 | Rake $0
Seat 1: chachamaru folded before Flop (didn't bet)
Seat 2: retrd08 folded before Flop (didn't bet)
Seat 3: chipsdonator folded before Flop (didn't bet)
Seat 4: Any2CardsRIU (button) folded before Flop (didn't bet)
Seat 5: tapouttazz9 (small blind) folded before Flop
Seat 6: eastwickrich (big blind) collected ($0.10)


PokerStars Hand #122879869779:  Hold'em No Limit ($0.05/$0.10 USD) - 2016/03/18 22:30:09 ET
Table 'Gemini' 6-max Seat #5 is the button
Seat 1: chachamaru ($9.94 in chips)
Seat 2: retrd08 ($2.08 in chips)
Seat 3: chipsdonator ($16.36 in chips)
Seat 4: Any2CardsRIU ($10 in chips)
Seat 5: tapouttazz9 ($8.88 in chips)
Seat 6: eastwickrich ($8.05 in chips)
eastwickrich: posts small blind $0.05
chachamaru: posts big blind $0.10
*** HOLE CARDS ***
Dealt to tapouttazz9 [2h 8s]
retrd08: folds
chipsdonator: folds
Any2CardsRIU: folds
tapouttazz9: folds
eastwickrich: raises $0.10 to $0.20
chachamaru: calls $0.10
*** FLOP *** [Qc 5h 6s]
eastwickrich: bets $0.40
chachamaru: folds
Uncalled bet ($0.40) returned to eastwickrich
eastwickrich collected $0.38 from pot
eastwickrich: doesn't show hand
*** SUMMARY ***
Total pot $0.40 | Rake $0.02
Board [Qc 5h 6s]
Seat 1: chachamaru (big blind) folded on the Flop
Seat 2: retrd08 folded before Flop (didn't bet)
Seat 3: chipsdonator folded before Flop (didn't bet)
Seat 4: Any2CardsRIU folded before Flop (didn't bet)
Seat 5: tapouttazz9 (button) folded before Flop (didn't bet)
Seat 6: eastwickrich (small blind) collected ($0.38)


PokerStars Hand #122879869850:  Hold'em No Limit ($0.05/$0.10 USD) - 2016/03/18 22:30:36 ET
Table 'Gemini' 6-max Seat #6 is the button
Seat 1: chachamaru ($9.74 in chips)
Seat 2: retrd08 ($2.08 in chips)
Seat 3: chipsdonator ($16.36 in chips)
Seat 4: Any2CardsRIU ($10 in chips)
Seat 5: tapouttazz9 ($8.88 in chips)
Seat 6: eastwickrich ($8.23 in chips)
chachamaru: posts small blind $0.05
retrd08: posts big blind $0.10
*** HOLE CARDS ***
Dealt to tapouttazz9 [Qd Ac]
chipsdonator: folds
Any2CardsRIU: folds
tapouttazz9: raises $0.10 to $0.20
eastwickrich: folds
chachamaru: calls $0.15
retrd08: calls $0.10
*** FLOP *** [5s As 9s]
chachamaru: checks
eastwickrich leaves the table
retrd08: bets $0.10
tapouttazz9: raises $0.77 to $0.87
chachamaru: folds
retrd08: calls $0.77
*** TURN *** [5s As 9s] [7c]
retrd08: bets $1.01 and is all-in
tapouttazz9: calls $1.01
*** RIVER *** [5s As 9s 7c] [Td]
*** SHOW DOWN ***
retrd08: shows [8d 6h] (a straight, Six to Ten)
tapouttazz9: shows [Qd Ac] (a pair of Aces)
retrd08 collected $4.14 from pot
*** SUMMARY ***
Total pot $4.36 | Rake $0.22
Board [5s As 9s 7c Td]
Seat 1: chachamaru (small blind) folded on the Flop
Seat 2: retrd08 (big blind) showed [8d 6h] and won ($4.14) with a straight, Six to Ten
Seat 3: chipsdonator folded before Flop (didn't bet)
Seat 4: Any2CardsRIU folded before Flop (didn't bet)
Seat 5: tapouttazz9 showed [Qd Ac] and lost with a pair of Aces
Seat 6: eastwickrich (button) folded before Flop (didn't bet)


PokerStars Hand #122879869961:  Hold'em No Limit ($0.05/$0.10 USD) - 2016/03/18 22:31:09 ET
Table 'Gemini' 6-max Seat #1 is the button
Seat 1: chachamaru ($9.54 in chips)
Seat 2: retrd08 ($4.14 in chips)
Seat 3: chipsdonator ($16.36 in chips)
Seat 4: Any2CardsRIU ($10 in chips)
Seat 5: tapouttazz9 ($6.80 in chips)
retrd08: posts small blind $0.05
chipsdonator: posts big blind $0.10
*** HOLE CARDS ***
Dealt to tapouttazz9 [5h 7h]
Any2CardsRIU: folds
tapouttazz9: folds
chachamaru: calls $0.10
retrd08: calls $0.05
chipsdonator: checks
*** FLOP *** [Ts 7c 6h]
retrd08: bets $0.10
chipsdonator: folds
chachamaru: raises $0.50 to $0.60
retrd08: calls $0.50
*** TURN *** [Ts 7c 6h] [3c]
retrd08: checks
chachamaru: checks
*** RIVER *** [Ts 7c 6h 3c] [9s]
retrd08: bets $1.42
chachamaru: folds
Uncalled bet ($1.42) returned to retrd08
retrd08 collected $1.42 from pot
retrd08: doesn't show hand
*** SUMMARY ***
Total pot $1.50 | Rake $0.08
Board [Ts 7c 6h 3c 9s]
Seat 1: chachamaru (button) folded on the River
Seat 2: retrd08 (small blind) collected ($1.42)
Seat 3: chipsdonator (big blind) folded on the Flop
Seat 4: Any2CardsRIU folded before Flop (didn't bet)
Seat 5: tapouttazz9 folded before Flop (didn't bet)


PokerStars Hand #122879870102:  Hold'em No Limit ($0.05/$0.10 USD) - 2016/03/18 22:31:52 ET
Table 'Gemini' 6-max Seat #2 is the button
Seat 1: chachamaru ($8.84 in chips)
Seat 2: retrd08 ($4.86 in chips)
Seat 3: chipsdonator ($16.26 in chips)
Seat 4: Any2CardsRIU ($10 in chips)
Seat 5: tapouttazz9 ($10 in chips)
chipsdonator: posts small blind $0.05
Any2CardsRIU: posts big blind $0.10
*** HOLE CARDS ***
Dealt to tapouttazz9 [3s 3d]
tapouttazz9: folds
PettyRaise joins the table at seat #6
chachamaru: folds
retrd08: calls $0.10
chipsdonator: folds
Any2CardsRIU: raises $0.25 to $0.35
retrd08: calls $0.25
*** FLOP *** [6d 7c Kh]
Any2CardsRIU: checks
retrd08: checks
*** TURN *** [6d 7c Kh] [4d]
Any2CardsRIU: bets $0.30
retrd08: raises $0.30 to $0.60
Any2CardsRIU: calls $0.30
*** RIVER *** [6d 7c Kh 4d] [Ah]
Any2CardsRIU: bets $1
retrd08: raises $1 to $2
Any2CardsRIU: raises $7.05 to $9.05 and is all-in
retrd08: calls $1.91 and is all-in
Uncalled bet ($5.14) returned to Any2CardsRIU
*** SHOW DOWN ***
Any2CardsRIU: shows [Kc Ks] (three of a kind, Kings)
retrd08: shows [7s Ac] (two pair, Aces and Sevens)
Any2CardsRIU collected $9.28 from pot
*** SUMMARY ***
Total pot $9.77 | Rake $0.49
Board [6d 7c Kh 4d Ah]
Seat 1: chachamaru folded before Flop (didn't bet)
Seat 2: retrd08 (button) showed [7s Ac] and lost with two pair, Aces and Sevens
Seat 3: chipsdonator (small blind) folded before Flop
Seat 4: Any2CardsRIU (big blind) showed [Kc Ks] and won ($9.28) with three of a kind, Kings
Seat 5: tapouttazz9 folded before Flop (didn't bet)


PokerStars Hand #122879870290:  Hold'em No Limit ($0.05/$0.10 USD) - 2016/03/18 22:32:52 ET
Table 'Gemini' 6-max Seat #3 is the button
Seat 1: chachamaru ($8.84 in chips)
Seat 3: chipsdonator ($16.21 in chips)
Seat 4: Any2CardsRIU ($14.42 in chips)
Seat 5: tapouttazz9 ($10 in chips)
Any2CardsRIU: posts small blind $0.05
tapouttazz9: posts big blind $0.10
PettyRaise: sits out
*** HOLE CARDS ***
Dealt to tapouttazz9 [Qs Td]
chachamaru: folds
chipsdonator: raises $0.20 to $0.30
Any2CardsRIU: folds
tapouttazz9: calls $0.20
*** FLOP *** [7s 4d Ts]
tapouttazz9: bets $0.62
chipsdonator: folds
Uncalled bet ($0.62) returned to tapouttazz9
tapouttazz9 collected $0.62 from pot
tapouttazz9: doesn't show hand
*** SUMMARY ***
Total pot $0.65 | Rake $0.03
Board [7s 4d Ts]
Seat 1: chachamaru folded before Flop (didn't bet)
Seat 3: chipsdonator (button) folded on the Flop
Seat 4: Any2CardsRIU (small blind) folded before Flop
Seat 5: tapouttazz9 (big blind) collected ($0.62)


PokerStars Hand #122879870415:  Hold'em No Limit ($0.05/$0.10 USD) - 2016/03/18 22:33:28 ET
Table 'Gemini' 6-max Seat #4 is the button
Seat 1: chachamaru ($8.84 in chips)
Seat 2: retrd08 ($10 in chips)
Seat 3: chipsdonator ($15.91 in chips)
Seat 4: Any2CardsRIU ($14.37 in chips)
Seat 5: tapouttazz9 ($10.32 in chips)
Seat 6: PettyRaise ($10 in chips)
tapouttazz9: posts small blind $0.05
PettyRaise: posts big blind $0.10
*** HOLE CARDS ***
Dealt to tapouttazz9 [Jc Kh]
chachamaru: calls $0.10
retrd08: raises $0.10 to $0.20
chipsdonator: folds
Any2CardsRIU: folds
tapouttazz9: calls $0.15
PettyRaise: calls $0.10
chachamaru: calls $0.10
*** FLOP *** [8d 4s Kc]
tapouttazz9: bets $0.38
PettyRaise: folds
chachamaru: folds
retrd08: raises $0.38 to $0.76
tapouttazz9: calls $0.38
*** TURN *** [8d 4s Kc] [7c]
tapouttazz9: bets $1.10
retrd08: raises $7.94 to $9.04 and is all-in
tapouttazz9: calls $7.94
*** RIVER *** [8d 4s Kc 7c] [Jh]
*** SHOW DOWN ***
tapouttazz9: shows [Jc Kh] (two pair, Kings and Jacks)
retrd08: shows [Ad Ah] (a pair of Aces)
tapouttazz9 collected $19.38 from pot
*** SUMMARY ***
Total pot $20.40 | Rake $1.02
Board [8d 4s Kc 7c Jh]
Seat 1: chachamaru folded on the Flop
Seat 2: retrd08 showed [Ad Ah] and lost with a pair of Aces
Seat 3: chipsdonator folded before Flop (didn't bet)
Seat 4: Any2CardsRIU (button) folded before Flop (didn't bet)
Seat 5: tapouttazz9 (small blind) showed [Jc Kh] and won ($19.38) with two pair, Kings and Jacks
Seat 6: PettyRaise (big blind) folded on the Flop


PokerStars Hand #122879870563:  Hold'em No Limit ($0.05/$0.10 USD) - 2016/03/18 22:34:11 ET
Table 'Gemini' 6-max Seat #5 is the button
Seat 1: chachamaru ($8.64 in chips)
Seat 3: chipsdonator ($15.91 in chips)
Seat 4: Any2CardsRIU ($14.37 in chips)
Seat 5: tapouttazz9 ($19.70 in chips)
Seat 6: PettyRaise ($9.80 in chips)
PettyRaise: posts small blind $0.05
chachamaru: posts big blind $0.10
*** HOLE CARDS ***
Dealt to tapouttazz9 [5c 4d]
chipsdonator: folds
retrd08 leaves the table
Any2CardsRIU: raises $0.20 to $0.30
tapouttazz9: folds
PettyRaise: folds
chachamaru: folds
Uncalled bet ($0.20) returned to Any2CardsRIU
Any2CardsRIU collected $0.25 from pot
Any2CardsRIU: doesn't show hand
*** SUMMARY ***
Total pot $0.25 | Rake $0
Seat 1: chachamaru (big blind) folded before Flop
Seat 3: chipsdonator folded before Flop (didn't bet)
Seat 4: Any2CardsRIU collected ($0.25)
Seat 5: tapouttazz9 (button) folded before Flop (didn't bet)
Seat 6: PettyRaise (small blind) folded before Flop


PokerStars Hand #122879870622:  Hold'em No Limit ($0.05/$0.10 USD) - 2016/03/18 22:34:24 ET
Table 'Gemini' 6-max Seat #6 is the button
Seat 1: chachamaru ($8.54 in chips)
Seat 3: chipsdonator ($15.91 in chips)
Seat 4: Any2CardsRIU ($14.52 in chips)
Seat 5: tapouttazz9 ($19.70 in chips)
Seat 6: PettyRaise ($9.75 in chips)
chachamaru: posts small blind $0.05
chipsdonator: posts big blind $0.10
*** HOLE CARDS ***
Dealt to tapouttazz9 [Jh Qs]
Any2CardsRIU: folds
tapouttazz9: folds
PettyRaise: raises $0.20 to $0.30
chachamaru: folds
chipsdonator: folds
Uncalled bet ($0.20) returned to PettyRaise
PettyRaise collected $0.25 from pot
PettyRaise: doesn't show hand
*** SUMMARY ***
Total pot $0.25 | Rake $0
Seat 1: chachamaru (small blind) folded before Flop
Seat 3: chipsdonator (big blind) folded before Flop
Seat 4: Any2CardsRIU folded before Flop (didn't bet)
Seat 5: tapouttazz9 folded before Flop (didn't bet)
Seat 6: PettyRaise (button) collected ($0.25)


PokerStars Hand #122879870669:  Hold'em No Limit ($0.05/$0.10 USD) - 2016/03/18 22:34:39 ET
Table 'Gemini' 6-max Seat #1 is the button
Seat 1: chachamaru ($8.49 in chips)
Seat 3: chipsdonator ($15.81 in chips)
Seat 4: Any2CardsRIU ($14.52 in chips)
Seat 5: tapouttazz9 ($19.70 in chips)
Seat 6: PettyRaise ($9.90 in chips)
chipsdonator: posts small blind $0.05
Any2CardsRIU: posts big blind $0.10
*** HOLE CARDS ***
Dealt to tapouttazz9 [9s Td]
tapouttazz9: folds
PettyRaise: raises $0.20 to $0.30
chachamaru: folds
chipsdonator: folds
Any2CardsRIU: calls $0.20
*** FLOP *** [8s Ah Jh]
Any2CardsRIU: checks
PettyRaise: bets $0.40
Any2CardsRIU: calls $0.40
*** TURN *** [8s Ah Jh] [7h]
Any2CardsRIU: checks
PettyRaise: bets $0.70
Any2CardsRIU: calls $0.70
*** RIVER *** [8s Ah Jh 7h] [6d]
Any2CardsRIU: checks
PettyRaise: checks
*** SHOW DOWN ***
Any2CardsRIU: shows [As Qc] (a pair of Aces)
PettyRaise: mucks hand
Any2CardsRIU collected $2.71 from pot
*** SUMMARY ***
Total pot $2.85 | Rake $0.14
Board [8s Ah Jh 7h 6d]
Seat 1: chachamaru (button) folded before Flop (didn't bet)
Seat 3: chipsdonator (small blind) folded before Flop
Seat 4: Any2CardsRIU (big blind) showed [As Qc] and won ($2.71) with a pair of Aces
Seat 5: tapouttazz9 folded before Flop (didn't bet)
Seat 6: PettyRaise mucked [Kd Kh]


PokerStars Hand #122879870829:  Hold'em No Limit ($0.05/$0.10 USD) - 2016/03/18 22:35:25 ET
Table 'Gemini' 6-max Seat #3 is the button
Seat 1: chachamaru ($8.49 in chips)
Seat 3: chipsdonator ($15.76 in chips)
Seat 4: Any2CardsRIU ($15.83 in chips)
Seat 5: tapouttazz9 ($19.70 in chips)
Seat 6: PettyRaise ($10 in chips)
Any2CardsRIU: posts small blind $0.05
tapouttazz9: posts big blind $0.10
*** HOLE CARDS ***
Dealt to tapouttazz9 [Td 5s]
PettyRaise: folds
chachamaru: folds
chipsdonator: folds
Any2CardsRIU: calls $0.05
tapouttazz9: checks
*** FLOP *** [5c Ts Ac]
Any2CardsRIU: bets $0.10
tapouttazz9: raises $0.10 to $0.20
Any2CardsRIU: calls $0.10
*** TURN *** [5c Ts Ac] [Kh]
Any2CardsRIU: bets $0.25
tapouttazz9: calls $0.25
*** RIVER *** [5c Ts Ac Kh] [9h]
Any2CardsRIU: checks
tapouttazz9: bets $0.52
Any2CardsRIU: folds
Uncalled bet ($0.52) returned to tapouttazz9
tapouttazz9 collected $1.04 from pot
tapouttazz9: doesn't show hand
*** SUMMARY ***
Total pot $1.10 | Rake $0.06
Board [5c Ts Ac Kh 9h]
Seat 1: chachamaru folded before Flop (didn't bet)
Seat 3: chipsdonator (button) folded before Flop (didn't bet)
Seat 4: Any2CardsRIU (small blind) folded on the River
Seat 5: tapouttazz9 (big blind) collected ($1.04)
Seat 6: PettyRaise folded before Flop (didn't bet)


PokerStars Hand #122879871009:  Hold'em No Limit ($0.05/$0.10 USD) - 2016/03/18 22:36:21 ET
Table 'Gemini' 6-max Seat #4 is the button
Seat 1: chachamaru ($8.49 in chips)
Seat 3: chipsdonator ($15.76 in chips)
Seat 4: Any2CardsRIU ($15.28 in chips)
Seat 5: tapouttazz9 ($20.19 in chips)
Seat 6: PettyRaise ($10 in chips)
tapouttazz9: posts small blind $0.05
PettyRaise: posts big blind $0.10
*** HOLE CARDS ***
Dealt to tapouttazz9 [2c Tc]
Teamboca05 joins the table at seat #2
chachamaru: folds
chipsdonator: raises $0.25 to $0.35
Any2CardsRIU: folds
tapouttazz9: folds
PettyRaise: raises $0.60 to $0.95
chipsdonator: calls $0.60
*** FLOP *** [6s Qd 8d]
PettyRaise: checks
chipsdonator: bets $1.85
PettyRaise: folds
Uncalled bet ($1.85) returned to chipsdonator
chipsdonator collected $1.85 from pot
chipsdonator: doesn't show hand
*** SUMMARY ***
Total pot $1.95 | Rake $0.10
Board [6s Qd 8d]
Seat 1: chachamaru folded before Flop (didn't bet)
Seat 3: chipsdonator collected ($1.85)
Seat 4: Any2CardsRIU (button) folded before Flop (didn't bet)
Seat 5: tapouttazz9 (small blind) folded before Flop
Seat 6: PettyRaise (big blind) folded on the Flop


PokerStars Hand #122879871104:  Hold'em No Limit ($0.05/$0.10 USD) - 2016/03/18 22:36:52 ET
Table 'Gemini' 6-max Seat #5 is the button
Seat 1: chachamaru ($8.49 in chips)
Seat 3: chipsdonator ($16.66 in chips)
Seat 4: Any2CardsRIU ($15.28 in chips)
Seat 5: tapouttazz9 ($20.14 in chips)
Seat 6: PettyRaise ($9.05 in chips)
PettyRaise: posts small blind $0.05
chachamaru: posts big blind $0.10
Teamboca05: sits out
*** HOLE CARDS ***
Dealt to tapouttazz9 [Qh Ac]
chipsdonator: folds
Any2CardsRIU: folds
tapouttazz9: raises $0.10 to $0.20
PettyRaise: folds
chachamaru: calls $0.10
*** FLOP *** [7d 5s Kh]
chachamaru: checks
tapouttazz9: checks
*** TURN *** [7d 5s Kh] [5d]
chachamaru: checks
tapouttazz9: bets $0.21
chachamaru: calls $0.21
*** RIVER *** [7d 5s Kh 5d] [6d]
chachamaru: checks
tapouttazz9: bets $0.41
chachamaru: calls $0.41
*** SHOW DOWN ***
tapouttazz9: shows [Qh Ac] (a pair of Fives)
chachamaru: mucks hand
tapouttazz9 collected $1.61 from pot
*** SUMMARY ***
Total pot $1.69 | Rake $0.08
Board [7d 5s Kh 5d 6d]
Seat 1: chachamaru (big blind) mucked [8s As]
Seat 3: chipsdonator folded before Flop (didn't bet)
Seat 4: Any2CardsRIU folded before Flop (didn't bet)
Seat 5: tapouttazz9 (button) showed [Qh Ac] and won ($1.61) with a pair of Fives
Seat 6: PettyRaise (small blind) folded before Flop


PokerStars Hand #122879871229:  Hold'em No Limit ($0.05/$0.10 USD) - 2016/03/18 22:37:37 ET
Table 'Gemini' 6-max Seat #6 is the button
Seat 1: chachamaru ($7.67 in chips)
Seat 2: Teamboca05 ($10 in chips)
Seat 3: chipsdonator ($16.66 in chips)
Seat 4: Any2CardsRIU ($15.28 in chips)
Seat 5: tapouttazz9 ($20.93 in chips)
Seat 6: PettyRaise ($9 in chips)
chachamaru: posts small blind $0.05
Teamboca05: posts big blind $0.10
*** HOLE CARDS ***
Dealt to tapouttazz9 [3s 9s]
chipsdonator: folds
Any2CardsRIU: folds
tapouttazz9: folds
PettyRaise: raises $0.15 to $0.25
chachamaru: raises $0.60 to $0.85
Teamboca05: folds
PettyRaise: folds
Uncalled bet ($0.60) returned to chachamaru
chachamaru collected $0.60 from pot
chachamaru: doesn't show hand
*** SUMMARY ***
Total pot $0.60 | Rake $0
Seat 1: chachamaru (small blind) collected ($0.60)
Seat 2: Teamboca05 (big blind) folded before Flop
Seat 3: chipsdonator folded before Flop (didn't bet)
Seat 4: Any2CardsRIU folded before Flop (didn't bet)
Seat 5: tapouttazz9 folded before Flop (didn't bet)
Seat 6: PettyRaise (button) folded before Flop


PokerStars Hand #122879871297:  Hold'em No Limit ($0.05/$0.10 USD) - 2016/03/18 22:37:58 ET
Table 'Gemini' 6-max Seat #1 is the button
Seat 1: chachamaru ($8.02 in chips)
Seat 2: Teamboca05 ($10 in chips)
Seat 3: chipsdonator ($16.66 in chips)
Seat 4: Any2CardsRIU ($15.28 in chips)
Seat 5: tapouttazz9 ($20.93 in chips)
Seat 6: PettyRaise ($10 in chips)
Teamboca05: posts small blind $0.05
chipsdonator: posts big blind $0.10
*** HOLE CARDS ***
Dealt to tapouttazz9 [Ad 5s]
Any2CardsRIU: folds
tapouttazz9: folds
PettyRaise: raises $0.15 to $0.25
chachamaru: folds
Teamboca05: raises $0.75 to $1
chipsdonator: folds
PettyRaise: folds
Uncalled bet ($0.75) returned to Teamboca05
Teamboca05 collected $0.60 from pot
Teamboca05: doesn't show hand
*** SUMMARY ***
Total pot $0.60 | Rake $0
Seat 1: chachamaru (button) folded before Flop (didn't bet)
Seat 2: Teamboca05 (small blind) collected ($0.60)
Seat 3: chipsdonator (big blind) folded before Flop
Seat 4: Any2CardsRIU folded before Flop (didn't bet)
Seat 5: tapouttazz9 folded before Flop (didn't bet)
Seat 6: PettyRaise folded before Flop


PokerStars Hand #122879871354:  Hold'em No Limit ($0.05/$0.10 USD) - 2016/03/18 22:38:18 ET
Table 'Gemini' 6-max Seat #2 is the button
Seat 1: chachamaru ($8.02 in chips)
Seat 2: Teamboca05 ($10.35 in chips)
Seat 3: chipsdonator ($16.56 in chips)
Seat 4: Any2CardsRIU ($15.28 in chips)
Seat 5: tapouttazz9 ($20.93 in chips)
Seat 6: PettyRaise ($9.75 in chips)
chipsdonator: posts small blind $0.05
Any2CardsRIU: posts big blind $0.10
*** HOLE CARDS ***
Dealt to tapouttazz9 [Ac Jc]
tapouttazz9: raises $0.10 to $0.20
PettyRaise: folds
chachamaru: folds
Teamboca05: folds
chipsdonator: folds
Any2CardsRIU: folds
Uncalled bet ($0.10) returned to tapouttazz9
tapouttazz9 collected $0.25 from pot
tapouttazz9: doesn't show hand
*** SUMMARY ***
Total pot $0.25 | Rake $0
Seat 1: chachamaru folded before Flop (didn't bet)
Seat 2: Teamboca05 (button) folded before Flop (didn't bet)
Seat 3: chipsdonator (small blind) folded before Flop
Seat 4: Any2CardsRIU (big blind) folded before Flop
Seat 5: tapouttazz9 collected ($0.25)
Seat 6: PettyRaise folded before Flop (didn't bet)


PokerStars Hand #122879871388:  Hold'em No Limit ($0.05/$0.10 USD) - 2016/03/18 22:38:29 ET
Table 'Gemini' 6-max Seat #3 is the button
Seat 1: chachamaru ($8.02 in chips)
Seat 2: Teamboca05 ($10.35 in chips)
Seat 3: chipsdonator ($16.51 in chips)
Seat 4: Any2CardsRIU ($15.18 in chips)
Seat 5: tapouttazz9 ($21.08 in chips)
Seat 6: PettyRaise ($9.75 in chips)
Any2CardsRIU: posts small blind $0.05
tapouttazz9: posts big blind $0.10
*** HOLE CARDS ***
Dealt to tapouttazz9 [Qh 7s]
PettyRaise: folds
chachamaru: raises $0.25 to $0.35
Teamboca05: folds
chipsdonator: folds
Any2CardsRIU: folds
tapouttazz9: folds
Uncalled bet ($0.25) returned to chachamaru
chachamaru collected $0.25 from pot
chachamaru: doesn't show hand
*** SUMMARY ***
Total pot $0.25 | Rake $0
Seat 1: chachamaru collected ($0.25)
Seat 2: Teamboca05 folded before Flop (didn't bet)
Seat 3: chipsdonator (button) folded before Flop (didn't bet)
Seat 4: Any2CardsRIU (small blind) folded before Flop
Seat 5: tapouttazz9 (big blind) folded before Flop
Seat 6: PettyRaise folded before Flop (didn't bet)


PokerStars Hand #122879871428:  Hold'em No Limit ($0.05/$0.10 USD) - 2016/03/18 22:38:42 ET
Table 'Gemini' 6-max Seat #4 is the button
Seat 1: chachamaru ($8.17 in chips)
Seat 2: Teamboca05 ($10.35 in chips)
Seat 3: chipsdonator ($16.51 in chips)
Seat 4: Any2CardsRIU ($15.13 in chips)
Seat 5: tapouttazz9 ($20.98 in chips)
Seat 6: PettyRaise ($9.75 in chips)
tapouttazz9: posts small blind $0.05
PettyRaise: posts big blind $0.10
*** HOLE CARDS ***
Dealt to tapouttazz9 [3h 8c]
chachamaru: folds
Teamboca05: folds
chipsdonator: folds
Any2CardsRIU: raises $0.20 to $0.30
tapouttazz9: folds
PettyRaise: folds
Uncalled bet ($0.20) returned to Any2CardsRIU
Any2CardsRIU collected $0.25 from pot
Any2CardsRIU: doesn't show hand
*** SUMMARY ***
Total pot $0.25 | Rake $0
Seat 1: chachamaru folded before Flop (didn't bet)
Seat 2: Teamboca05 folded before Flop (didn't bet)
Seat 3: chipsdonator folded before Flop (didn't bet)
Seat 4: Any2CardsRIU (button) collected ($0.25)
Seat 5: tapouttazz9 (small blind) folded before Flop
Seat 6: PettyRaise (big blind) folded before Flop


PokerStars Hand #122879871503:  Hold'em No Limit ($0.05/$0.10 USD) - 2016/03/18 22:39:05 ET
Table 'Gemini' 6-max Seat #5 is the button
Seat 1: chachamaru ($8.17 in chips)
Seat 2: Teamboca05 ($10.35 in chips)
Seat 3: chipsdonator ($16.51 in chips)
Seat 4: Any2CardsRIU ($15.28 in chips)
Seat 5: tapouttazz9 ($20.93 in chips)
Seat 6: PettyRaise ($9.65 in chips)
PettyRaise: posts small blind $0.05
chachamaru: posts big blind $0.10
*** HOLE CARDS ***
Dealt to tapouttazz9 [3s 5h]
Teamboca05: folds
chipsdonator: folds
Any2CardsRIU: raises $0.20 to $0.30
tapouttazz9: folds
PettyRaise: folds
chachamaru: calls $0.20
*** FLOP *** [7c 3c 9c]
chachamaru: checks
Any2CardsRIU: checks
*** TURN *** [7c 3c 9c] [Jc]
chachamaru: checks
Any2CardsRIU: bets $0.25
chachamaru: folds
Uncalled bet ($0.25) returned to Any2CardsRIU
Any2CardsRIU collected $0.62 from pot
Any2CardsRIU: doesn't show hand
*** SUMMARY ***
Total pot $0.65 | Rake $0.03
Board [7c 3c 9c Jc]
Seat 1: chachamaru (big blind) folded on the Turn
Seat 2: Teamboca05 folded before Flop (didn't bet)
Seat 3: chipsdonator folded before Flop (didn't bet)
Seat 4: Any2CardsRIU collected ($0.62)
Seat 5: tapouttazz9 (button) folded before Flop (didn't bet)
Seat 6: PettyRaise (small blind) folded before Flop


PokerStars Hand #122879871602:  Hold'em No Limit ($0.05/$0.10 USD) - 2016/03/18 22:39:37 ET
Table 'Gemini' 6-max Seat #6 is the button
Seat 1: chachamaru ($7.87 in chips)
Seat 2: Teamboca05 ($10.35 in chips)
Seat 3: chipsdonator ($16.51 in chips)
Seat 4: Any2CardsRIU ($15.60 in chips)
Seat 5: tapouttazz9 ($20.93 in chips)
Seat 6: PettyRaise ($9.60 in chips)
chachamaru: posts small blind $0.05
Teamboca05: posts big blind $0.10
*** HOLE CARDS ***
Dealt to tapouttazz9 [Kd 8s]
chipsdonator: folds
Any2CardsRIU: folds
tapouttazz9: folds
PettyRaise: folds
chachamaru: folds
Uncalled bet ($0.05) returned to Teamboca05
Teamboca05 collected $0.10 from pot
Teamboca05: doesn't show hand
*** SUMMARY ***
Total pot $0.10 | Rake $0
Seat 1: chachamaru (small blind) folded before Flop
Seat 2: Teamboca05 (big blind) collected ($0.10)
Seat 3: chipsdonator folded before Flop (didn't bet)
Seat 4: Any2CardsRIU folded before Flop (didn't bet)
Seat 5: tapouttazz9 folded before Flop (didn't bet)
Seat 6: PettyRaise (button) folded before Flop (didn't bet)


PokerStars Hand #122879871629:  Hold'em No Limit ($0.05/$0.10 USD) - 2016/03/18 22:39:47 ET
Table 'Gemini' 6-max Seat #1 is the button
Seat 1: chachamaru ($7.82 in chips)
Seat 2: Teamboca05 ($10.40 in chips)
Seat 3: chipsdonator ($16.51 in chips)
Seat 4: Any2CardsRIU ($15.60 in chips)
Seat 5: tapouttazz9 ($20.93 in chips)
Seat 6: PettyRaise ($9.60 in chips)
Teamboca05: posts small blind $0.05
chipsdonator: posts big blind $0.10
*** HOLE CARDS ***
Dealt to tapouttazz9 [7c Jd]
Any2CardsRIU: folds
tapouttazz9: folds
PettyRaise: raises $0.20 to $0.30
chachamaru: calls $0.30
Teamboca05: folds
chipsdonator: folds
*** FLOP *** [Qc 6s 5s]
PettyRaise: checks
chachamaru: checks
*** TURN *** [Qc 6s 5s] [Ac]
PettyRaise: bets $0.40
chachamaru: folds
Uncalled bet ($0.40) returned to PettyRaise
PettyRaise collected $0.71 from pot
PettyRaise: doesn't show hand
*** SUMMARY ***
Total pot $0.75 | Rake $0.04
Board [Qc 6s 5s Ac]
Seat 1: chachamaru (button) folded on the Turn
Seat 2: Teamboca05 (small blind) folded before Flop
Seat 3: chipsdonator (big blind) folded before Flop
Seat 4: Any2CardsRIU folded before Flop (didn't bet)
Seat 5: tapouttazz9 folded before Flop (didn't bet)
Seat 6: PettyRaise collected ($0.71)


PokerStars Hand #122879871782:  Hold'em No Limit ($0.05/$0.10 USD) - 2016/03/18 22:40:33 ET
Table 'Gemini' 6-max Seat #2 is the button
Seat 1: chachamaru ($7.52 in chips)
Seat 2: Teamboca05 ($10.35 in chips)
Seat 3: chipsdonator ($16.41 in chips)
Seat 4: Any2CardsRIU ($15.60 in chips)
Seat 5: tapouttazz9 ($20.93 in chips)
Seat 6: PettyRaise ($10.01 in chips)
chipsdonator: posts small blind $0.05
Any2CardsRIU: posts big blind $0.10
*** HOLE CARDS ***
Dealt to tapouttazz9 [2d 5s]
tapouttazz9: folds
PettyRaise: folds
chachamaru: raises $0.25 to $0.35
Teamboca05: folds
chipsdonator: folds
Any2CardsRIU: folds
Uncalled bet ($0.25) returned to chachamaru
chachamaru collected $0.25 from pot
chachamaru: doesn't show hand
*** SUMMARY ***
Total pot $0.25 | Rake $0
Seat 1: chachamaru collected ($0.25)
Seat 2: Teamboca05 (button) folded before Flop (didn't bet)
Seat 3: chipsdonator (small blind) folded before Flop
Seat 4: Any2CardsRIU (big blind) folded before Flop
Seat 5: tapouttazz9 folded before Flop (didn't bet)
Seat 6: PettyRaise folded before Flop (didn't bet)


PokerStars Hand #122879871804:  Hold'em No Limit ($0.05/$0.10 USD) - 2016/03/18 22:40:53 ET
Table 'Gemini' 6-max Seat #3 is the button
Seat 1: chachamaru ($7.67 in chips)
Seat 2: Teamboca05 ($10.35 in chips)
Seat 3: chipsdonator ($16.36 in chips)
Seat 4: Any2CardsRIU ($15.50 in chips)
Seat 5: tapouttazz9 ($20.93 in chips)
Seat 6: PettyRaise ($10.01 in chips)
Any2CardsRIU: posts small blind $0.05
tapouttazz9: posts big blind $0.10
*** HOLE CARDS ***
Dealt to tapouttazz9 [Ad Jh]
PettyRaise: folds
chachamaru: raises $0.25 to $0.35
Teamboca05: folds
chipsdonator: folds
Any2CardsRIU: folds
tapouttazz9: calls $0.25
*** FLOP *** [Ts 9c Jd]
tapouttazz9: bets $0.35
chachamaru: calls $0.35
*** TURN *** [Ts 9c Jd] [Qc]
tapouttazz9: bets $0.69
chachamaru: calls $0.69
*** RIVER *** [Ts 9c Jd Qc] [Js]
tapouttazz9: checks
chachamaru: checks
*** SHOW DOWN ***
tapouttazz9: shows [Ad Jh] (three of a kind, Jacks)
chachamaru: mucks hand
tapouttazz9 collected $2.69 from pot
*** SUMMARY ***
Total pot $2.83 | Rake $0.14
Board [Ts 9c Jd Qc Js]
Seat 1: chachamaru mucked [Qh 9h]
Seat 2: Teamboca05 folded before Flop (didn't bet)
Seat 3: chipsdonator (button) folded before Flop (didn't bet)
Seat 4: Any2CardsRIU (small blind) folded before Flop
Seat 5: tapouttazz9 (big blind) showed [Ad Jh] and won ($2.69) with three of a kind, Jacks
Seat 6: PettyRaise folded before Flop (didn't bet)


PokerStars Hand #122879872016:  Hold'em No Limit ($0.05/$0.10 USD) - 2016/03/18 22:41:52 ET
Table 'Gemini' 6-max Seat #4 is the button
Seat 1: chachamaru ($6.28 in chips)
Seat 2: Teamboca05 ($10.35 in chips)
Seat 3: chipsdonator ($16.36 in chips)
Seat 4: Any2CardsRIU ($15.45 in chips)
Seat 5: tapouttazz9 ($22.23 in chips)
Seat 6: PettyRaise ($10.01 in chips)
tapouttazz9: posts small blind $0.05
PettyRaise: posts big blind $0.10
*** HOLE CARDS ***
Dealt to tapouttazz9 [8h Kh]
chachamaru: raises $0.25 to $0.35
Teamboca05: folds
chipsdonator: folds
Any2CardsRIU: folds
tapouttazz9: folds
PettyRaise: folds
Uncalled bet ($0.25) returned to chachamaru
chachamaru collected $0.25 from pot
chachamaru: doesn't show hand
*** SUMMARY ***
Total pot $0.25 | Rake $0
Seat 1: chachamaru collected ($0.25)
Seat 2: Teamboca05 folded before Flop (didn't bet)
Seat 3: chipsdonator folded before Flop (didn't bet)
Seat 4: Any2CardsRIU (button) folded before Flop (didn't bet)
Seat 5: tapouttazz9 (small blind) folded before Flop
Seat 6: PettyRaise (big blind) folded before Flop


PokerStars Hand #122879872122:  Hold'em No Limit ($0.05/$0.10 USD) - 2016/03/18 22:42:24 ET
Table 'Gemini' 6-max Seat #5 is the button
Seat 1: chachamaru ($6.43 in chips)
Seat 2: Teamboca05 ($10.35 in chips)
Seat 3: chipsdonator ($16.36 in chips)
Seat 4: Any2CardsRIU ($15.45 in chips)
Seat 5: tapouttazz9 ($22.18 in chips)
Seat 6: PettyRaise ($9.91 in chips)
PettyRaise: posts small blind $0.05
chachamaru: posts big blind $0.10
*** HOLE CARDS ***
Dealt to tapouttazz9 [7s 5s]
Teamboca05: raises $0.20 to $0.30
chipsdonator: calls $0.30
Any2CardsRIU: folds
tapouttazz9: folds
PettyRaise: folds
chachamaru: folds
*** FLOP *** [Ah Js Kd]
Teamboca05: checks
chipsdonator: bets $0.71
Teamboca05: folds
Uncalled bet ($0.71) returned to chipsdonator
chipsdonator collected $0.71 from pot
chipsdonator: doesn't show hand
*** SUMMARY ***
Total pot $0.75 | Rake $0.04
Board [Ah Js Kd]
Seat 1: chachamaru (big blind) folded before Flop
Seat 2: Teamboca05 folded on the Flop
Seat 3: chipsdonator collected ($0.71)
Seat 4: Any2CardsRIU folded before Flop (didn't bet)
Seat 5: tapouttazz9 (button) folded before Flop (didn't bet)
Seat 6: PettyRaise (small blind) folded before Flop


PokerStars Hand #122879872212:  Hold'em No Limit ($0.05/$0.10 USD) - 2016/03/18 22:42:52 ET
Table 'Gemini' 6-max Seat #6 is the button
Seat 1: chachamaru ($6.33 in chips)
Seat 2: Teamboca05 ($10.05 in chips)
Seat 3: chipsdonator ($16.77 in chips)
Seat 4: Any2CardsRIU ($15.45 in chips)
Seat 5: tapouttazz9 ($22.18 in chips)
Seat 6: PettyRaise ($9.86 in chips)
chachamaru: posts small blind $0.05
Teamboca05: posts big blind $0.10
*** HOLE CARDS ***
Dealt to tapouttazz9 [Jh 4h]
chipsdonator: raises $0.20 to $0.30
Any2CardsRIU: folds
tapouttazz9: folds
PettyRaise: folds
chachamaru: folds
Teamboca05: folds
Uncalled bet ($0.20) returned to chipsdonator
chipsdonator collected $0.25 from pot
chipsdonator: doesn't show hand
*** SUMMARY ***
Total pot $0.25 | Rake $0
Seat 1: chachamaru (small blind) folded before Flop
Seat 2: Teamboca05 (big blind) folded before Flop
Seat 3: chipsdonator collected ($0.25)
Seat 4: Any2CardsRIU folded before Flop (didn't bet)
Seat 5: tapouttazz9 folded before Flop (didn't bet)
Seat 6: PettyRaise (button) folded before Flop (didn't bet)


PokerStars Hand #122879872268:  Hold'em No Limit ($0.05/$0.10 USD) - 2016/03/18 22:43:12 ET
Table 'Gemini' 6-max Seat #1 is the button
Seat 1: chachamaru ($6.28 in chips)
Seat 2: Teamboca05 ($10 in chips)
Seat 3: chipsdonator ($16.92 in chips)
Seat 4: Any2CardsRIU ($15.45 in chips)
Seat 5: tapouttazz9 ($22.18 in chips)
Seat 6: PettyRaise ($9.86 in chips)
Teamboca05: posts small blind $0.05
chipsdonator: posts big blind $0.10
*** HOLE CARDS ***
Dealt to tapouttazz9 [4s Ah]
Any2CardsRIU: folds
tapouttazz9: folds
PettyRaise: folds
chachamaru: folds
Teamboca05: folds
Uncalled bet ($0.05) returned to chipsdonator
chipsdonator collected $0.10 from pot
chipsdonator: doesn't show hand
*** SUMMARY ***
Total pot $0.10 | Rake $0
Seat 1: chachamaru (button) folded before Flop (didn't bet)
Seat 2: Teamboca05 (small blind) folded before Flop
Seat 3: chipsdonator (big blind) collected ($0.10)
Seat 4: Any2CardsRIU folded before Flop (didn't bet)
Seat 5: tapouttazz9 folded before Flop (didn't bet)
Seat 6: PettyRaise folded before Flop (didn't bet)


PokerStars Hand #122879872338:  Hold'em No Limit ($0.05/$0.10 USD) - 2016/03/18 22:43:34 ET
Table 'Gemini' 6-max Seat #2 is the button
Seat 1: chachamaru ($6.28 in chips)
Seat 2: Teamboca05 ($10 in chips)
Seat 3: chipsdonator ($16.97 in chips)
Seat 4: Any2CardsRIU ($15.45 in chips)
Seat 5: tapouttazz9 ($22.18 in chips)
Seat 6: PettyRaise ($9.86 in chips)
chipsdonator: posts small blind $0.05
Any2CardsRIU: posts big blind $0.10
*** HOLE CARDS ***
Dealt to tapouttazz9 [As 4h]
tapouttazz9: folds
PettyRaise: folds
chachamaru: folds
Teamboca05: folds
chipsdonator: folds
Uncalled bet ($0.05) returned to Any2CardsRIU
Any2CardsRIU collected $0.10 from pot
Any2CardsRIU: doesn't show hand
*** SUMMARY ***
Total pot $0.10 | Rake $0
Seat 1: chachamaru folded before Flop (didn't bet)
Seat 2: Teamboca05 (button) folded before Flop (didn't bet)
Seat 3: chipsdonator (small blind) folded before Flop
Seat 4: Any2CardsRIU (big blind) collected ($0.10)
Seat 5: tapouttazz9 folded before Flop (didn't bet)
Seat 6: PettyRaise folded before Flop (didn't bet)


PokerStars Hand #122879872379:  Hold'em No Limit ($0.05/$0.10 USD) - 2016/03/18 22:43:48 ET
Table 'Gemini' 6-max Seat #3 is the button
Seat 1: chachamaru ($6.28 in chips)
Seat 2: Teamboca05 ($10 in chips)
Seat 3: chipsdonator ($16.92 in chips)
Seat 4: Any2CardsRIU ($15.50 in chips)
Seat 5: tapouttazz9 ($22.18 in chips)
Seat 6: PettyRaise ($9.86 in chips)
Any2CardsRIU: posts small blind $0.05
tapouttazz9: posts big blind $0.10
*** HOLE CARDS ***
Dealt to tapouttazz9 [Td As]
PettyRaise: folds
chachamaru: calls $0.10
Teamboca05: raises $0.30 to $0.40
chipsdonator: folds
Any2CardsRIU: folds
tapouttazz9: calls $0.30
chachamaru: folds
*** FLOP *** [6d 2c Ac]
tapouttazz9: checks
Teamboca05: checks
*** TURN *** [6d 2c Ac] [3h]
tapouttazz9: bets $0.45
Teamboca05: calls $0.45
*** RIVER *** [6d 2c Ac 3h] [4c]
tapouttazz9: checks
Teamboca05: checks
*** SHOW DOWN ***
tapouttazz9: shows [Td As] (a pair of Aces)
Teamboca05: shows [Ah Qc] (a pair of Aces - Queen kicker)
Teamboca05 collected $1.76 from pot
*** SUMMARY ***
Total pot $1.85 | Rake $0.09
Board [6d 2c Ac 3h 4c]
Seat 1: chachamaru folded before Flop
Seat 2: Teamboca05 showed [Ah Qc] and won ($1.76) with a pair of Aces
Seat 3: chipsdonator (button) folded before Flop (didn't bet)
Seat 4: Any2CardsRIU (small blind) folded before Flop
Seat 5: tapouttazz9 (big blind) showed [Td As] and lost with a pair of Aces
Seat 6: PettyRaise folded before Flop (didn't bet)


PokerStars Hand #122879872519:  Hold'em No Limit ($0.05/$0.10 USD) - 2016/03/18 22:44:33 ET
Table 'Gemini' 6-max Seat #4 is the button
Seat 1: chachamaru ($6.18 in chips)
Seat 2: Teamboca05 ($10.91 in chips)
Seat 3: chipsdonator ($16.92 in chips)
Seat 4: Any2CardsRIU ($15.45 in chips)
Seat 5: tapouttazz9 ($21.33 in chips)
Seat 6: PettyRaise ($9.86 in chips)
tapouttazz9: posts small blind $0.05
PettyRaise: posts big blind $0.10
*** HOLE CARDS ***
Dealt to tapouttazz9 [3h 3d]
chachamaru: raises $0.25 to $0.35
Teamboca05: calls $0.35
chipsdonator: folds
Any2CardsRIU: raises $0.90 to $1.25
tapouttazz9: folds
PettyRaise: folds
chachamaru: raises $4.93 to $6.18 and is all-in
Teamboca05: folds
Any2CardsRIU: calls $4.93
*** FLOP *** [5h 2d Jc]
*** TURN *** [5h 2d Jc] [2h]
*** RIVER *** [5h 2d Jc 2h] [6h]
*** SHOW DOWN ***
chachamaru: shows [Ac As] (two pair, Aces and Deuces)
Any2CardsRIU: shows [Ah Kh] (a flush, Ace high)
Any2CardsRIU collected $12.22 from pot
*** SUMMARY ***
Total pot $12.86 | Rake $0.64
Board [5h 2d Jc 2h 6h]
Seat 1: chachamaru showed [Ac As] and lost with two pair, Aces and Deuces
Seat 2: Teamboca05 folded before Flop
Seat 3: chipsdonator folded before Flop (didn't bet)
Seat 4: Any2CardsRIU (button) showed [Ah Kh] and won ($12.22) with a flush, Ace high
Seat 5: tapouttazz9 (small blind) folded before Flop
Seat 6: PettyRaise (big blind) folded before Flop


PokerStars Hand #122879872624:  Hold'em No Limit ($0.05/$0.10 USD) - 2016/03/18 22:45:07 ET
Table 'Gemini' 6-max Seat #5 is the button
Seat 2: Teamboca05 ($10.56 in chips)
Seat 3: chipsdonator ($16.92 in chips)
Seat 4: Any2CardsRIU ($21.49 in chips)
Seat 5: tapouttazz9 ($21.28 in chips)
Seat 6: PettyRaise ($9.76 in chips)
PettyRaise: posts small blind $0.05
Teamboca05: posts big blind $0.10
*** HOLE CARDS ***
Dealt to tapouttazz9 [Qs 5s]
chipsdonator: folds
Any2CardsRIU: folds
tapouttazz9: folds
chachamaru said, "nice suckout"
PettyRaise: folds
Uncalled bet ($0.05) returned to Teamboca05
Teamboca05 collected $0.10 from pot
Teamboca05: doesn't show hand
*** SUMMARY ***
Total pot $0.10 | Rake $0
Seat 2: Teamboca05 (big blind) collected ($0.10)
Seat 3: chipsdonator folded before Flop (didn't bet)
Seat 4: Any2CardsRIU folded before Flop (didn't bet)
Seat 5: tapouttazz9 (button) folded before Flop (didn't bet)
Seat 6: PettyRaise (small blind) folded before Flop


PokerStars Hand #122879872670:  Hold'em No Limit ($0.05/$0.10 USD) - 2016/03/18 22:45:25 ET
Table 'Gemini' 6-max Seat #6 is the button
Seat 2: Teamboca05 ($10.61 in chips)
Seat 3: chipsdonator ($16.92 in chips)
Seat 4: Any2CardsRIU ($21.49 in chips)
Seat 5: tapouttazz9 ($21.28 in chips)
Seat 6: PettyRaise ($9.71 in chips)
Teamboca05: posts small blind $0.05
chipsdonator: posts big blind $0.10
*** HOLE CARDS ***
Dealt to tapouttazz9 [2s Qh]
Any2CardsRIU said, "not my fault"
Any2CardsRIU: folds
tapouttazz9: folds
PettyRaise: raises $0.20 to $0.30
Teamboca05: calls $0.25
chipsdonator: folds
*** FLOP *** [Qc 2h Qd]
Teamboca05: checks
chachamaru said, "luck box"
PettyRaise: bets $0.37
Teamboca05: calls $0.37
*** TURN *** [Qc 2h Qd] [7h]
Teamboca05 said, "lol"
Teamboca05: checks
chachamaru leaves the table
PettyRaise: checks
*** RIVER *** [Qc 2h Qd 7h] [9d]
SyN7001 joins the table at seat #1
Any2CardsRIU said, "yea poker is part luck each hand"
Teamboca05: bets $1
Any2CardsRIU said, "get over it or dont play"
PettyRaise: folds
Uncalled bet ($1) returned to Teamboca05
Any2CardsRIU said, "u should be happy i called"
Teamboca05 collected $1.37 from pot
Teamboca05: doesn't show hand
*** SUMMARY ***
Total pot $1.44 | Rake $0.07
Board [Qc 2h Qd 7h 9d]
Seat 2: Teamboca05 (small blind) collected ($1.37)
Seat 3: chipsdonator (big blind) folded before Flop
Seat 4: Any2CardsRIU folded before Flop (didn't bet)
Seat 5: tapouttazz9 folded before Flop (didn't bet)
Seat 6: PettyRaise (button) folded on the River


PokerStars Hand #122879872813:  Hold'em No Limit ($0.05/$0.10 USD) - 2016/03/18 22:46:11 ET
Table 'Gemini' 6-max Seat #2 is the button
Seat 2: Teamboca05 ($11.31 in chips)
Seat 3: chipsdonator ($16.82 in chips)
Seat 4: Any2CardsRIU ($21.49 in chips)
Seat 5: tapouttazz9 ($21.28 in chips)
Seat 6: PettyRaise ($9.04 in chips)
chipsdonator: posts small blind $0.05
Any2CardsRIU: posts big blind $0.10
SyN7001: sits out
*** HOLE CARDS ***
Dealt to tapouttazz9 [8h 7c]
tapouttazz9: folds
PettyRaise: folds
Teamboca05: folds
chipsdonator: folds
Uncalled bet ($0.05) returned to Any2CardsRIU
Any2CardsRIU collected $0.10 from pot
Any2CardsRIU: doesn't show hand
*** SUMMARY ***
Total pot $0.10 | Rake $0
Seat 2: Teamboca05 (button) folded before Flop (didn't bet)
Seat 3: chipsdonator (small blind) folded before Flop
Seat 4: Any2CardsRIU (big blind) collected ($0.10)
Seat 5: tapouttazz9 folded before Flop (didn't bet)
Seat 6: PettyRaise folded before Flop (didn't bet)


PokerStars Hand #122879872845:  Hold'em No Limit ($0.05/$0.10 USD) - 2016/03/18 22:46:22 ET
Table 'Gemini' 6-max Seat #3 is the button
Seat 2: Teamboca05 ($11.31 in chips)
Seat 3: chipsdonator ($16.77 in chips)
Seat 4: Any2CardsRIU ($21.54 in chips)
Seat 5: tapouttazz9 ($21.28 in chips)
Seat 6: PettyRaise ($9.04 in chips)
Any2CardsRIU: posts small blind $0.05
tapouttazz9: posts big blind $0.10
SyN7001: sits out
*** HOLE CARDS ***
Dealt to tapouttazz9 [9c 2h]
PettyRaise: raises $0.25 to $0.35
Teamboca05: folds
chipsdonator: folds
Any2CardsRIU: folds
tapouttazz9: folds
Uncalled bet ($0.25) returned to PettyRaise
PettyRaise collected $0.25 from pot
PettyRaise: doesn't show hand
*** SUMMARY ***
Total pot $0.25 | Rake $0
Seat 2: Teamboca05 folded before Flop (didn't bet)
Seat 3: chipsdonator (button) folded before Flop (didn't bet)
Seat 4: Any2CardsRIU (small blind) folded before Flop
Seat 5: tapouttazz9 (big blind) folded before Flop
Seat 6: PettyRaise collected ($0.25)


PokerStars Hand #122879872927:  Hold'em No Limit ($0.05/$0.10 USD) - 2016/03/18 22:46:45 ET
Table 'Gemini' 6-max Seat #4 is the button
Seat 2: Teamboca05 ($11.31 in chips)
Seat 3: chipsdonator ($16.77 in chips)
Seat 4: Any2CardsRIU ($21.49 in chips)
Seat 5: tapouttazz9 ($21.18 in chips)
Seat 6: PettyRaise ($9.19 in chips)
tapouttazz9: posts small blind $0.05
PettyRaise: posts big blind $0.10
SyN7001: sits out
*** HOLE CARDS ***
Dealt to tapouttazz9 [Ac 4s]
Teamboca05: folds
chipsdonator: folds
Any2CardsRIU: raises $0.20 to $0.30
tapouttazz9: folds
PettyRaise: folds
Uncalled bet ($0.20) returned to Any2CardsRIU
Any2CardsRIU collected $0.25 from pot
Any2CardsRIU: doesn't show hand
*** SUMMARY ***
Total pot $0.25 | Rake $0
Seat 2: Teamboca05 folded before Flop (didn't bet)
Seat 3: chipsdonator folded before Flop (didn't bet)
Seat 4: Any2CardsRIU (button) collected ($0.25)
Seat 5: tapouttazz9 (small blind) folded before Flop
Seat 6: PettyRaise (big blind) folded before Flop


PokerStars Hand #122879872986:  Hold'em No Limit ($0.05/$0.10 USD) - 2016/03/18 22:47:04 ET
Table 'Gemini' 6-max Seat #5 is the button
Seat 1: SyN7001 ($10 in chips)
Seat 2: Teamboca05 ($11.31 in chips)
Seat 3: chipsdonator ($16.77 in chips)
Seat 4: Any2CardsRIU ($21.64 in chips)
Seat 5: tapouttazz9 ($21.13 in chips)
Seat 6: PettyRaise ($9.09 in chips)
PettyRaise: posts small blind $0.05
SyN7001: posts big blind $0.10
*** HOLE CARDS ***
Dealt to tapouttazz9 [4h Th]
Teamboca05: folds
chipsdonator: folds
Any2CardsRIU: calls $0.10
tapouttazz9: folds
PettyRaise: folds
SyN7001: checks
*** FLOP *** [8s Ac Tc]
SyN7001: checks
Any2CardsRIU: checks
*** TURN *** [8s Ac Tc] [4s]
SyN7001: bets $0.20
Any2CardsRIU: folds
Uncalled bet ($0.20) returned to SyN7001
SyN7001 collected $0.24 from pot
SyN7001: doesn't show hand
*** SUMMARY ***
Total pot $0.25 | Rake $0.01
Board [8s Ac Tc 4s]
Seat 1: SyN7001 (big blind) collected ($0.24)
Seat 2: Teamboca05 folded before Flop (didn't bet)
Seat 3: chipsdonator folded before Flop (didn't bet)
Seat 4: Any2CardsRIU folded on the Turn
Seat 5: tapouttazz9 (button) folded before Flop (didn't bet)
Seat 6: PettyRaise (small blind) folded before Flop


PokerStars Hand #122879873050:  Hold'em No Limit ($0.05/$0.10 USD) - 2016/03/18 22:47:25 ET
Table 'Gemini' 6-max Seat #6 is the button
Seat 1: SyN7001 ($10.14 in chips)
Seat 2: Teamboca05 ($11.31 in chips)
Seat 3: chipsdonator ($16.77 in chips)
Seat 4: Any2CardsRIU ($21.54 in chips)
Seat 5: tapouttazz9 ($21.13 in chips)
Seat 6: PettyRaise ($9.04 in chips)
SyN7001: posts small blind $0.05
Teamboca05: posts big blind $0.10
*** HOLE CARDS ***
Dealt to tapouttazz9 [6d 7h]
chipsdonator: folds
Any2CardsRIU: folds
tapouttazz9: folds
PettyRaise: raises $0.20 to $0.30
SyN7001: raises $0.80 to $1.10
Teamboca05: folds
PettyRaise: folds
Uncalled bet ($0.80) returned to SyN7001
SyN7001 collected $0.70 from pot
SyN7001: doesn't show hand
*** SUMMARY ***
Total pot $0.70 | Rake $0
Seat 1: SyN7001 (small blind) collected ($0.70)
Seat 2: Teamboca05 (big blind) folded before Flop
Seat 3: chipsdonator folded before Flop (didn't bet)
Seat 4: Any2CardsRIU folded before Flop (didn't bet)
Seat 5: tapouttazz9 folded before Flop (didn't bet)
Seat 6: PettyRaise (button) folded before Flop


PokerStars Hand #122879873141:  Hold'em No Limit ($0.05/$0.10 USD) - 2016/03/18 22:47:52 ET
Table 'Gemini' 6-max Seat #1 is the button
Seat 1: SyN7001 ($10.54 in chips)
Seat 2: Teamboca05 ($11.21 in chips)
Seat 3: chipsdonator ($16.77 in chips)
Seat 4: Any2CardsRIU ($21.54 in chips)
Seat 5: tapouttazz9 ($21.13 in chips)
Seat 6: PettyRaise ($10 in chips)
Teamboca05: posts small blind $0.05
chipsdonator: posts big blind $0.10
*** HOLE CARDS ***
Dealt to tapouttazz9 [3s Jd]
Any2CardsRIU: folds
tapouttazz9: folds
PettyRaise: raises $0.20 to $0.30
SyN7001: folds
Teamboca05: folds
chipsdonator: folds
Uncalled bet ($0.20) returned to PettyRaise
PettyRaise collected $0.25 from pot
PettyRaise: doesn't show hand
*** SUMMARY ***
Total pot $0.25 | Rake $0
Seat 1: SyN7001 (button) folded before Flop (didn't bet)
Seat 2: Teamboca05 (small blind) folded before Flop
Seat 3: chipsdonator (big blind) folded before Flop
Seat 4: Any2CardsRIU folded before Flop (didn't bet)
Seat 5: tapouttazz9 folded before Flop (didn't bet)
Seat 6: PettyRaise collected ($0.25)


PokerStars Hand #122879873176:  Hold'em No Limit ($0.05/$0.10 USD) - 2016/03/18 22:48:06 ET
Table 'Gemini' 6-max Seat #2 is the button
Seat 1: SyN7001 ($10.54 in chips)
Seat 2: Teamboca05 ($11.16 in chips)
Seat 3: chipsdonator ($16.67 in chips)
Seat 4: Any2CardsRIU ($21.54 in chips)
Seat 5: tapouttazz9 ($21.13 in chips)
Seat 6: PettyRaise ($10.15 in chips)
chipsdonator: posts small blind $0.05
Any2CardsRIU: posts big blind $0.10
*** HOLE CARDS ***
Dealt to tapouttazz9 [8h Ah]
tapouttazz9: folds
PettyRaise: folds
SyN7001: folds
Teamboca05: folds
chipsdonator: calls $0.05
Any2CardsRIU: checks
*** FLOP *** [8c 9d 8d]
chipsdonator: checks
Any2CardsRIU: checks
*** TURN *** [8c 9d 8d] [Ts]
chipsdonator: bets $0.19
Any2CardsRIU: folds
Uncalled bet ($0.19) returned to chipsdonator
chipsdonator collected $0.19 from pot
chipsdonator: doesn't show hand
*** SUMMARY ***
Total pot $0.20 | Rake $0.01
Board [8c 9d 8d Ts]
Seat 1: SyN7001 folded before Flop (didn't bet)
Seat 2: Teamboca05 (button) folded before Flop (didn't bet)
Seat 3: chipsdonator (small blind) collected ($0.19)
Seat 4: Any2CardsRIU (big blind) folded on the Turn
Seat 5: tapouttazz9 folded before Flop (didn't bet)
Seat 6: PettyRaise folded before Flop (didn't bet)


PokerStars Hand #122879873264:  Hold'em No Limit ($0.05/$0.10 USD) - 2016/03/18 22:48:38 ET
Table 'Gemini' 6-max Seat #3 is the button
Seat 1: SyN7001 ($10.54 in chips)
Seat 2: Teamboca05 ($11.16 in chips)
Seat 3: chipsdonator ($16.76 in chips)
Seat 4: Any2CardsRIU ($21.44 in chips)
Seat 5: tapouttazz9 ($21.13 in chips)
Seat 6: PettyRaise ($10.15 in chips)
Any2CardsRIU: posts small blind $0.05
tapouttazz9: posts big blind $0.10
*** HOLE CARDS ***
Dealt to tapouttazz9 [8c Qh]
PettyRaise: folds
SyN7001: folds
Teamboca05: folds
chipsdonator: folds
Any2CardsRIU: raises $0.20 to $0.30
tapouttazz9: folds
Uncalled bet ($0.20) returned to Any2CardsRIU
Any2CardsRIU collected $0.20 from pot
Any2CardsRIU: doesn't show hand
*** SUMMARY ***
Total pot $0.20 | Rake $0
Seat 1: SyN7001 folded before Flop (didn't bet)
Seat 2: Teamboca05 folded before Flop (didn't bet)
Seat 3: chipsdonator (button) folded before Flop (didn't bet)
Seat 4: Any2CardsRIU (small blind) collected ($0.20)
Seat 5: tapouttazz9 (big blind) folded before Flop
Seat 6: PettyRaise folded before Flop (didn't bet)


PokerStars Hand #122879873316:  Hold'em No Limit ($0.05/$0.10 USD) - 2016/03/18 22:49:00 ET
Table 'Gemini' 6-max Seat #4 is the button
Seat 1: SyN7001 ($10.54 in chips)
Seat 2: Teamboca05 ($11.16 in chips)
Seat 3: chipsdonator ($16.76 in chips)
Seat 4: Any2CardsRIU ($21.54 in chips)
Seat 5: tapouttazz9 ($21.03 in chips)
Seat 6: PettyRaise ($10.15 in chips)
tapouttazz9: posts small blind $0.05
PettyRaise: posts big blind $0.10
*** HOLE CARDS ***
Dealt to tapouttazz9 [5c 3s]
SyN7001: folds
Teamboca05: folds
chipsdonator: folds
Any2CardsRIU: raises $0.20 to $0.30
tapouttazz9: folds
PettyRaise: folds
Uncalled bet ($0.20) returned to Any2CardsRIU
Any2CardsRIU collected $0.25 from pot
Any2CardsRIU: doesn't show hand
*** SUMMARY ***
Total pot $0.25 | Rake $0
Seat 1: SyN7001 folded before Flop (didn't bet)
Seat 2: Teamboca05 folded before Flop (didn't bet)
Seat 3: chipsdonator folded before Flop (didn't bet)
Seat 4: Any2CardsRIU (button) collected ($0.25)
Seat 5: tapouttazz9 (small blind) folded before Flop
Seat 6: PettyRaise (big blind) folded before Flop


PokerStars Hand #122879873382:  Hold'em No Limit ($0.05/$0.10 USD) - 2016/03/18 22:49:21 ET
Table 'Gemini' 6-max Seat #5 is the button
Seat 1: SyN7001 ($10.54 in chips)
Seat 2: Teamboca05 ($11.16 in chips)
Seat 3: chipsdonator ($16.76 in chips)
Seat 4: Any2CardsRIU ($21.69 in chips)
Seat 5: tapouttazz9 ($20.98 in chips)
Seat 6: PettyRaise ($10.05 in chips)
PettyRaise: posts small blind $0.05
SyN7001: posts big blind $0.10
*** HOLE CARDS ***
Dealt to tapouttazz9 [Kc 8h]
Teamboca05: folds
chipsdonator: folds
Any2CardsRIU: folds
tapouttazz9: raises $0.10 to $0.20
PettyRaise: calls $0.15
SyN7001: folds
*** FLOP *** [Qh Tc 9s]
PettyRaise: checks
tapouttazz9: checks
*** TURN *** [Qh Tc 9s] [Ts]
PettyRaise: bets $0.40
tapouttazz9: calls $0.40
*** RIVER *** [Qh Tc 9s Ts] [Ah]
PettyRaise: checks
tapouttazz9: bets $0.62
PettyRaise: calls $0.62
*** SHOW DOWN ***
tapouttazz9: shows [Kc 8h] (a pair of Tens)
PettyRaise: shows [Jh Qd] (two pair, Queens and Tens)
PettyRaise collected $2.41 from pot
*** SUMMARY ***
Total pot $2.54 | Rake $0.13
Board [Qh Tc 9s Ts Ah]
Seat 1: SyN7001 (big blind) folded before Flop
Seat 2: Teamboca05 folded before Flop (didn't bet)
Seat 3: chipsdonator folded before Flop (didn't bet)
Seat 4: Any2CardsRIU folded before Flop (didn't bet)
Seat 5: tapouttazz9 (button) showed [Kc 8h] and lost with a pair of Tens
Seat 6: PettyRaise (small blind) showed [Jh Qd] and won ($2.41) with two pair, Queens and Tens


PokerStars Hand #122879873478:  Hold'em No Limit ($0.05/$0.10 USD) - 2016/03/18 22:49:58 ET
Table 'Gemini' 6-max Seat #6 is the button
Seat 1: SyN7001 ($10.44 in chips)
Seat 2: Teamboca05 ($11.16 in chips)
Seat 3: chipsdonator ($16.76 in chips)
Seat 4: Any2CardsRIU ($21.69 in chips)
Seat 5: tapouttazz9 ($19.76 in chips)
Seat 6: PettyRaise ($11.24 in chips)
SyN7001: posts small blind $0.05
Teamboca05: posts big blind $0.10
*** HOLE CARDS ***
Dealt to tapouttazz9 [6s 4h]
chipsdonator: folds
Any2CardsRIU: folds
tapouttazz9: folds
PettyRaise: raises $0.20 to $0.30
SyN7001: raises $0.80 to $1.10
Teamboca05: folds
PettyRaise: folds
Uncalled bet ($0.80) returned to SyN7001
SyN7001 collected $0.70 from pot
SyN7001: doesn't show hand
*** SUMMARY ***
Total pot $0.70 | Rake $0
Seat 1: SyN7001 (small blind) collected ($0.70)
Seat 2: Teamboca05 (big blind) folded before Flop
Seat 3: chipsdonator folded before Flop (didn't bet)
Seat 4: Any2CardsRIU folded before Flop (didn't bet)
Seat 5: tapouttazz9 folded before Flop (didn't bet)
Seat 6: PettyRaise (button) folded before Flop


PokerStars Hand #122879873560:  Hold'em No Limit ($0.05/$0.10 USD) - 2016/03/18 22:50:36 ET
Table 'Gemini' 6-max Seat #1 is the button
Seat 1: SyN7001 ($10.84 in chips)
Seat 2: Teamboca05 ($11.06 in chips)
Seat 3: chipsdonator ($16.76 in chips)
Seat 4: Any2CardsRIU ($21.69 in chips)
Seat 5: tapouttazz9 ($19.76 in chips)
Seat 6: PettyRaise ($10.94 in chips)
Teamboca05: posts small blind $0.05
chipsdonator: posts big blind $0.10
*** HOLE CARDS ***
Dealt to tapouttazz9 [3d 3c]
Any2CardsRIU: folds
tapouttazz9: folds
PettyRaise: raises $0.20 to $0.30
SyN7001: folds
Teamboca05: folds
chipsdonator: folds
Uncalled bet ($0.20) returned to PettyRaise
PettyRaise collected $0.25 from pot
PettyRaise: doesn't show hand
*** SUMMARY ***
Total pot $0.25 | Rake $0
Seat 1: SyN7001 (button) folded before Flop (didn't bet)
Seat 2: Teamboca05 (small blind) folded before Flop
Seat 3: chipsdonator (big blind) folded before Flop
Seat 4: Any2CardsRIU folded before Flop (didn't bet)
Seat 5: tapouttazz9 folded before Flop (didn't bet)
Seat 6: PettyRaise collected ($0.25)


PokerStars Hand #122879873606:  Hold'em No Limit ($0.05/$0.10 USD) - 2016/03/18 22:50:51 ET
Table 'Gemini' 6-max Seat #2 is the button
Seat 1: SyN7001 ($10.84 in chips)
Seat 2: Teamboca05 ($11.01 in chips)
Seat 3: chipsdonator ($16.66 in chips)
Seat 4: Any2CardsRIU ($21.69 in chips)
Seat 5: tapouttazz9 ($19.76 in chips)
Seat 6: PettyRaise ($11.09 in chips)
chipsdonator: posts small blind $0.05
Any2CardsRIU: posts big blind $0.10
*** HOLE CARDS ***
Dealt to tapouttazz9 [6d 8s]
tapouttazz9: folds
PettyRaise: folds
SyN7001: folds
Teamboca05: folds
chipsdonator: folds
Uncalled bet ($0.05) returned to Any2CardsRIU
Any2CardsRIU collected $0.10 from pot
Any2CardsRIU: doesn't show hand
*** SUMMARY ***
Total pot $0.10 | Rake $0
Seat 1: SyN7001 folded before Flop (didn't bet)
Seat 2: Teamboca05 (button) folded before Flop (didn't bet)
Seat 3: chipsdonator (small blind) folded before Flop
Seat 4: Any2CardsRIU (big blind) collected ($0.10)
Seat 5: tapouttazz9 folded before Flop (didn't bet)
Seat 6: PettyRaise folded before Flop (didn't bet)


PokerStars Hand #122879873648:  Hold'em No Limit ($0.05/$0.10 USD) - 2016/03/18 22:51:03 ET
Table 'Gemini' 6-max Seat #3 is the button
Seat 1: SyN7001 ($10.84 in chips)
Seat 2: Teamboca05 ($11.01 in chips)
Seat 3: chipsdonator ($16.61 in chips)
Seat 4: Any2CardsRIU ($21.74 in chips)
Seat 5: tapouttazz9 ($19.76 in chips)
Seat 6: PettyRaise ($11.09 in chips)
Any2CardsRIU: posts small blind $0.05
tapouttazz9: posts big blind $0.10
*** HOLE CARDS ***
Dealt to tapouttazz9 [8d 3d]
PettyRaise: folds
SyN7001: folds
Teamboca05: folds
chipsdonator: folds
Any2CardsRIU: calls $0.05
tapouttazz9: checks
*** FLOP *** [Kc 6d 6h]
Any2CardsRIU: checks
tapouttazz9: checks
*** TURN *** [Kc 6d 6h] [5h]
Any2CardsRIU: bets $0.10
tapouttazz9: folds
Uncalled bet ($0.10) returned to Any2CardsRIU
Any2CardsRIU collected $0.19 from pot
Any2CardsRIU: doesn't show hand
*** SUMMARY ***
Total pot $0.20 | Rake $0.01
Board [Kc 6d 6h 5h]
Seat 1: SyN7001 folded before Flop (didn't bet)
Seat 2: Teamboca05 folded before Flop (didn't bet)
Seat 3: chipsdonator (button) folded before Flop (didn't bet)
Seat 4: Any2CardsRIU (small blind) collected ($0.19)
Seat 5: tapouttazz9 (big blind) folded on the Turn
Seat 6: PettyRaise folded before Flop (didn't bet)


PokerStars Hand #122879873738:  Hold'em No Limit ($0.05/$0.10 USD) - 2016/03/18 22:51:34 ET
Table 'Gemini' 6-max Seat #4 is the button
Seat 1: SyN7001 ($10.84 in chips)
Seat 2: Teamboca05 ($11.01 in chips)
Seat 3: chipsdonator ($16.61 in chips)
Seat 4: Any2CardsRIU ($21.83 in chips)
Seat 5: tapouttazz9 ($19.66 in chips)
Seat 6: PettyRaise ($11.09 in chips)
tapouttazz9: posts small blind $0.05
PettyRaise: posts big blind $0.10
*** HOLE CARDS ***
Dealt to tapouttazz9 [7d Jc]
SyN7001: folds
Teamboca05: folds
chipsdonator: folds
Any2CardsRIU: folds
tapouttazz9: folds
Uncalled bet ($0.05) returned to PettyRaise
PettyRaise collected $0.10 from pot
PettyRaise: doesn't show hand
*** SUMMARY ***
Total pot $0.10 | Rake $0
Seat 1: SyN7001 folded before Flop (didn't bet)
Seat 2: Teamboca05 folded before Flop (didn't bet)
Seat 3: chipsdonator folded before Flop (didn't bet)
Seat 4: Any2CardsRIU (button) folded before Flop (didn't bet)
Seat 5: tapouttazz9 (small blind) folded before Flop
Seat 6: PettyRaise (big blind) collected ($0.10)


PokerStars Hand #122879873777:  Hold'em No Limit ($0.05/$0.10 USD) - 2016/03/18 22:51:44 ET
Table 'Gemini' 6-max Seat #5 is the button
Seat 1: SyN7001 ($10.84 in chips)
Seat 2: Teamboca05 ($11.01 in chips)
Seat 3: chipsdonator ($16.61 in chips)
Seat 4: Any2CardsRIU ($21.83 in chips)
Seat 5: tapouttazz9 ($19.61 in chips)
Seat 6: PettyRaise ($11.14 in chips)
PettyRaise: posts small blind $0.05
SyN7001: posts big blind $0.10
*** HOLE CARDS ***
Dealt to tapouttazz9 [8h Kd]
Teamboca05: raises $0.20 to $0.30
chipsdonator: folds
Any2CardsRIU: folds
tapouttazz9: folds
PettyRaise: folds
SyN7001: folds
Uncalled bet ($0.20) returned to Teamboca05
Teamboca05 collected $0.25 from pot
Teamboca05: doesn't show hand
*** SUMMARY ***
Total pot $0.25 | Rake $0
Seat 1: SyN7001 (big blind) folded before Flop
Seat 2: Teamboca05 collected ($0.25)
Seat 3: chipsdonator folded before Flop (didn't bet)
Seat 4: Any2CardsRIU folded before Flop (didn't bet)
Seat 5: tapouttazz9 (button) folded before Flop (didn't bet)
Seat 6: PettyRaise (small blind) folded before Flop


PokerStars Hand #122879873845:  Hold'em No Limit ($0.05/$0.10 USD) - 2016/03/18 22:52:08 ET
Table 'Gemini' 6-max Seat #6 is the button
Seat 1: SyN7001 ($10.74 in chips)
Seat 2: Teamboca05 ($11.16 in chips)
Seat 3: chipsdonator ($16.61 in chips)
Seat 4: Any2CardsRIU ($21.83 in chips)
Seat 5: tapouttazz9 ($19.61 in chips)
Seat 6: PettyRaise ($11.09 in chips)
SyN7001: posts small blind $0.05
Teamboca05: posts big blind $0.10
*** HOLE CARDS ***
Dealt to tapouttazz9 [2d Ac]
chipsdonator: raises $0.20 to $0.30
Any2CardsRIU: folds
tapouttazz9: folds
PettyRaise: folds
SyN7001: folds
Teamboca05: folds
Uncalled bet ($0.20) returned to chipsdonator
chipsdonator collected $0.25 from pot
chipsdonator: doesn't show hand
*** SUMMARY ***
Total pot $0.25 | Rake $0
Seat 1: SyN7001 (small blind) folded before Flop
Seat 2: Teamboca05 (big blind) folded before Flop
Seat 3: chipsdonator collected ($0.25)
Seat 4: Any2CardsRIU folded before Flop (didn't bet)
Seat 5: tapouttazz9 folded before Flop (didn't bet)
Seat 6: PettyRaise (button) folded before Flop (didn't bet)


PokerStars Hand #122879873899:  Hold'em No Limit ($0.05/$0.10 USD) - 2016/03/18 22:52:24 ET
Table 'Gemini' 6-max Seat #1 is the button
Seat 1: SyN7001 ($10.69 in chips)
Seat 2: Teamboca05 ($11.06 in chips)
Seat 3: chipsdonator ($16.76 in chips)
Seat 4: Any2CardsRIU ($21.83 in chips)
Seat 5: tapouttazz9 ($19.61 in chips)
Seat 6: PettyRaise ($11.09 in chips)
Teamboca05: posts small blind $0.05
chipsdonator: posts big blind $0.10
*** HOLE CARDS ***
Dealt to tapouttazz9 [8s 4c]
Any2CardsRIU: folds
tapouttazz9: folds
PettyRaise: folds
SyN7001: folds
Teamboca05: folds
Uncalled bet ($0.05) returned to chipsdonator
chipsdonator collected $0.10 from pot
chipsdonator: doesn't show hand
*** SUMMARY ***
Total pot $0.10 | Rake $0
Seat 1: SyN7001 (button) folded before Flop (didn't bet)
Seat 2: Teamboca05 (small blind) folded before Flop
Seat 3: chipsdonator (big blind) collected ($0.10)
Seat 4: Any2CardsRIU folded before Flop (didn't bet)
Seat 5: tapouttazz9 folded before Flop (didn't bet)
Seat 6: PettyRaise folded before Flop (didn't bet)


PokerStars Hand #122879873971:  Hold'em No Limit ($0.05/$0.10 USD) - 2016/03/18 22:52:45 ET
Table 'Gemini' 6-max Seat #2 is the button
Seat 1: SyN7001 ($10.69 in chips)
Seat 2: Teamboca05 ($11.01 in chips)
Seat 3: chipsdonator ($16.81 in chips)
Seat 4: Any2CardsRIU ($21.83 in chips)
Seat 5: tapouttazz9 ($19.61 in chips)
Seat 6: PettyRaise ($11.09 in chips)
chipsdonator: posts small blind $0.05
Any2CardsRIU: posts big blind $0.10
*** HOLE CARDS ***
Dealt to tapouttazz9 [Th 9c]
tapouttazz9: folds
PettyRaise: folds
SyN7001: raises $0.20 to $0.30
Teamboca05: calls $0.30
chipsdonator: folds
Any2CardsRIU: folds
*** FLOP *** [8h Td 3d]
SyN7001: bets $0.50
Teamboca05: folds
Uncalled bet ($0.50) returned to SyN7001
SyN7001 collected $0.71 from pot
SyN7001: doesn't show hand
*** SUMMARY ***
Total pot $0.75 | Rake $0.04
Board [8h Td 3d]
Seat 1: SyN7001 collected ($0.71)
Seat 2: Teamboca05 (button) folded on the Flop
Seat 3: chipsdonator (small blind) folded before Flop
Seat 4: Any2CardsRIU (big blind) folded before Flop
Seat 5: tapouttazz9 folded before Flop (didn't bet)
Seat 6: PettyRaise folded before Flop (didn't bet)


PokerStars Hand #122879874069:  Hold'em No Limit ($0.05/$0.10 USD) - 2016/03/18 22:53:14 ET
Table 'Gemini' 6-max Seat #3 is the button
Seat 1: SyN7001 ($11.10 in chips)
Seat 2: Teamboca05 ($10.71 in chips)
Seat 3: chipsdonator ($16.76 in chips)
Seat 4: Any2CardsRIU ($21.73 in chips)
Seat 5: tapouttazz9 ($19.61 in chips)
Seat 6: PettyRaise ($11.09 in chips)
Any2CardsRIU: posts small blind $0.05
tapouttazz9: posts big blind $0.10
*** HOLE CARDS ***
Dealt to tapouttazz9 [Td 2s]
PettyRaise: folds
SyN7001: folds
Teamboca05: folds
chipsdonator: folds
Any2CardsRIU: raises $0.20 to $0.30
tapouttazz9: folds
Uncalled bet ($0.20) returned to Any2CardsRIU
Any2CardsRIU collected $0.20 from pot
Any2CardsRIU: doesn't show hand
*** SUMMARY ***
Total pot $0.20 | Rake $0
Seat 1: SyN7001 folded before Flop (didn't bet)
Seat 2: Teamboca05 folded before Flop (didn't bet)
Seat 3: chipsdonator (button) folded before Flop (didn't bet)
Seat 4: Any2CardsRIU (small blind) collected ($0.20)
Seat 5: tapouttazz9 (big blind) folded before Flop
Seat 6: PettyRaise folded before Flop (didn't bet)


PokerStars Hand #122879874149:  Hold'em No Limit ($0.05/$0.10 USD) - 2016/03/18 22:53:33 ET
Table 'Gemini' 6-max Seat #4 is the button
Seat 1: SyN7001 ($11.10 in chips)
Seat 2: Teamboca05 ($10.71 in chips)
Seat 3: chipsdonator ($16.76 in chips)
Seat 4: Any2CardsRIU ($21.83 in chips)
Seat 5: tapouttazz9 ($19.51 in chips)
Seat 6: PettyRaise ($11.09 in chips)
tapouttazz9: posts small blind $0.05
PettyRaise: posts big blind $0.10
*** HOLE CARDS ***
Dealt to tapouttazz9 [7s 2s]
SyN7001: folds
Teamboca05: folds
chipsdonator: folds
Any2CardsRIU: folds
tapouttazz9: folds
Uncalled bet ($0.05) returned to PettyRaise
PettyRaise collected $0.10 from pot
PettyRaise: doesn't show hand
*** SUMMARY ***
Total pot $0.10 | Rake $0
Seat 1: SyN7001 folded before Flop (didn't bet)
Seat 2: Teamboca05 folded before Flop (didn't bet)
Seat 3: chipsdonator folded before Flop (didn't bet)
Seat 4: Any2CardsRIU (button) folded before Flop (didn't bet)
Seat 5: tapouttazz9 (small blind) folded before Flop
Seat 6: PettyRaise (big blind) collected ($0.10)


PokerStars Hand #122879874192:  Hold'em No Limit ($0.05/$0.10 USD) - 2016/03/18 22:53:48 ET
Table 'Gemini' 6-max Seat #5 is the button
Seat 1: SyN7001 ($11.10 in chips)
Seat 2: Teamboca05 ($10.71 in chips)
Seat 3: chipsdonator ($16.76 in chips)
Seat 4: Any2CardsRIU ($21.83 in chips)
Seat 5: tapouttazz9 ($19.46 in chips)
Seat 6: PettyRaise ($11.14 in chips)
PettyRaise: posts small blind $0.05
SyN7001: posts big blind $0.10
*** HOLE CARDS ***
Dealt to tapouttazz9 [9s Kh]
Teamboca05: folds
chipsdonator: folds
Any2CardsRIU: folds
tapouttazz9: raises $0.10 to $0.20
Teamboca05 leaves the table
PettyRaise: folds
SyN7001: folds
Uncalled bet ($0.10) returned to tapouttazz9
tapouttazz9 collected $0.25 from pot
tapouttazz9: doesn't show hand
*** SUMMARY ***
Total pot $0.25 | Rake $0
Seat 1: SyN7001 (big blind) folded before Flop
Seat 2: Teamboca05 folded before Flop (didn't bet)
Seat 3: chipsdonator folded before Flop (didn't bet)
Seat 4: Any2CardsRIU folded before Flop (didn't bet)
Seat 5: tapouttazz9 (button) collected ($0.25)
Seat 6: PettyRaise (small blind) folded before Flop


PokerStars Hand #122879874245:  Hold'em No Limit ($0.05/$0.10 USD) - 2016/03/18 22:54:03 ET
Table 'Gemini' 6-max Seat #6 is the button
Seat 1: SyN7001 ($11 in chips)
Seat 3: chipsdonator ($16.76 in chips)
Seat 4: Any2CardsRIU ($21.83 in chips)
Seat 5: tapouttazz9 ($19.61 in chips)
Seat 6: PettyRaise ($11.09 in chips)
SyN7001: posts small blind $0.05
chipsdonator: posts big blind $0.10
*** HOLE CARDS ***
Dealt to tapouttazz9 [Jd Th]
Any2CardsRIU: raises $0.20 to $0.30
tapouttazz9: folds
PettyRaise: folds
SyN7001: folds
chipsdonator: folds
Uncalled bet ($0.20) returned to Any2CardsRIU
Any2CardsRIU collected $0.25 from pot
Any2CardsRIU: doesn't show hand
*** SUMMARY ***
Total pot $0.25 | Rake $0
Seat 1: SyN7001 (small blind) folded before Flop
Seat 3: chipsdonator (big blind) folded before Flop
Seat 4: Any2CardsRIU collected ($0.25)
Seat 5: tapouttazz9 folded before Flop (didn't bet)
Seat 6: PettyRaise (button) folded before Flop (didn't bet)


PokerStars Hand #122879874341:  Hold'em No Limit ($0.05/$0.10 USD) - 2016/03/18 22:54:31 ET
Table 'Gemini' 6-max Seat #1 is the button
Seat 1: SyN7001 ($10.95 in chips)
Seat 3: chipsdonator ($16.66 in chips)
Seat 4: Any2CardsRIU ($21.98 in chips)
Seat 5: tapouttazz9 ($19.61 in chips)
Seat 6: PettyRaise ($11.09 in chips)
chipsdonator: posts small blind $0.05
Any2CardsRIU: posts big blind $0.10
*** HOLE CARDS ***
Dealt to tapouttazz9 [4h 3c]
tapouttazz9: folds
PettyRaise: folds
SyN7001: raises $0.20 to $0.30
chipsdonator: folds
Any2CardsRIU: calls $0.20
*** FLOP *** [Qc Qs Ad]
Any2CardsRIU: checks
SyN7001: bets $0.50
Any2CardsRIU: calls $0.50
*** TURN *** [Qc Qs Ad] [8s]
Any2CardsRIU: bets $0.80
SyN7001: raises $1.70 to $2.50
Any2CardsRIU: calls $1.70
*** RIVER *** [Qc Qs Ad 8s] [7s]
Any2CardsRIU: bets $4
PettyRaise is disconnected
SyN7001: folds
Uncalled bet ($4) returned to Any2CardsRIU
Any2CardsRIU collected $6.32 from pot
Any2CardsRIU: doesn't show hand
*** SUMMARY ***
Total pot $6.65 | Rake $0.33
Board [Qc Qs Ad 8s 7s]
Seat 1: SyN7001 (button) folded on the River
Seat 3: chipsdonator (small blind) folded before Flop
Seat 4: Any2CardsRIU (big blind) collected ($6.32)
Seat 5: tapouttazz9 folded before Flop (didn't bet)
Seat 6: PettyRaise folded before Flop (didn't bet)


PokerStars Hand #122879874744:  Hold'em No Limit ($0.05/$0.10 USD) - 2016/03/18 22:56:25 ET
Table 'Gemini' 6-max Seat #3 is the button
Seat 1: SyN7001 ($10 in chips)
Seat 3: chipsdonator ($16.61 in chips)
Seat 4: Any2CardsRIU ($25 in chips)
Seat 5: tapouttazz9 ($19.61 in chips)
Seat 6: PettyRaise ($11.09 in chips)
Any2CardsRIU: posts small blind $0.05
tapouttazz9: posts big blind $0.10
*** HOLE CARDS ***
Dealt to tapouttazz9 [8s Tc]
PettyRaise is connected
PettyRaise: folds
SyN7001: folds
chipsdonator: folds
Any2CardsRIU: calls $0.05
tapouttazz9: checks
*** FLOP *** [3s 5h Jc]
Any2CardsRIU: checks
tapouttazz9: bets $0.19
Any2CardsRIU: folds
Uncalled bet ($0.19) returned to tapouttazz9
tapouttazz9 collected $0.19 from pot
tapouttazz9: doesn't show hand
*** SUMMARY ***
Total pot $0.20 | Rake $0.01
Board [3s 5h Jc]
Seat 1: SyN7001 folded before Flop (didn't bet)
Seat 3: chipsdonator (button) folded before Flop (didn't bet)
Seat 4: Any2CardsRIU (small blind) folded on the Flop
Seat 5: tapouttazz9 (big blind) collected ($0.19)
Seat 6: PettyRaise folded before Flop (didn't bet)


PokerStars Hand #122879874881:  Hold'em No Limit ($0.05/$0.10 USD) - 2016/03/18 22:57:03 ET
Table 'Gemini' 6-max Seat #4 is the button
Seat 1: SyN7001 ($10 in chips)
Seat 3: chipsdonator ($16.61 in chips)
Seat 4: Any2CardsRIU ($24.90 in chips)
Seat 5: tapouttazz9 ($19.70 in chips)
Seat 6: PettyRaise ($11.09 in chips)
tapouttazz9: posts small blind $0.05
PettyRaise: posts big blind $0.10
*** HOLE CARDS ***
Dealt to tapouttazz9 [5h 2d]
SyN7001: folds
chipsdonator: raises $0.20 to $0.30
Any2CardsRIU: calls $0.30
tapouttazz9: folds
PettyRaise: folds
*** FLOP *** [Ah 5s 7d]
chipsdonator: bets $0.71
Any2CardsRIU: folds
Uncalled bet ($0.71) returned to chipsdonator
chipsdonator collected $0.71 from pot
chipsdonator: doesn't show hand
*** SUMMARY ***
Total pot $0.75 | Rake $0.04
Board [Ah 5s 7d]
Seat 1: SyN7001 folded before Flop (didn't bet)
Seat 3: chipsdonator collected ($0.71)
Seat 4: Any2CardsRIU (button) folded on the Flop
Seat 5: tapouttazz9 (small blind) folded before Flop
Seat 6: PettyRaise (big blind) folded before Flop


PokerStars Hand #122879874989:  Hold'em No Limit ($0.05/$0.10 USD) - 2016/03/18 22:57:31 ET
Table 'Gemini' 6-max Seat #5 is the button
Seat 1: SyN7001 ($10 in chips)
Seat 3: chipsdonator ($17.02 in chips)
Seat 4: Any2CardsRIU ($24.60 in chips)
Seat 5: tapouttazz9 ($19.65 in chips)
Seat 6: PettyRaise ($10.99 in chips)
PettyRaise: posts small blind $0.05
SyN7001: posts big blind $0.10
*** HOLE CARDS ***
Dealt to tapouttazz9 [Ts 4h]
chipsdonator: raises $0.20 to $0.30
Any2CardsRIU: folds
tapouttazz9: folds
PettyRaise: folds
SyN7001: folds
Uncalled bet ($0.20) returned to chipsdonator
chipsdonator collected $0.25 from pot
chipsdonator: doesn't show hand
*** SUMMARY ***
Total pot $0.25 | Rake $0
Seat 1: SyN7001 (big blind) folded before Flop
Seat 3: chipsdonator collected ($0.25)
Seat 4: Any2CardsRIU folded before Flop (didn't bet)
Seat 5: tapouttazz9 (button) folded before Flop (didn't bet)
Seat 6: PettyRaise (small blind) folded before Flop


PokerStars Hand #122879875022:  Hold'em No Limit ($0.05/$0.10 USD) - 2016/03/18 22:57:42 ET
Table 'Gemini' 6-max Seat #6 is the button
Seat 1: SyN7001 ($10 in chips)
Seat 3: chipsdonator ($17.17 in chips)
Seat 4: Any2CardsRIU ($24.60 in chips)
Seat 5: tapouttazz9 ($19.65 in chips)
Seat 6: PettyRaise ($10.94 in chips)
SyN7001: posts small blind $0.05
chipsdonator: posts big blind $0.10
*** HOLE CARDS ***
Dealt to tapouttazz9 [2d 4s]
Any2CardsRIU: folds
tapouttazz9: folds
PettyRaise: raises $0.20 to $0.30
SyN7001: raises $0.80 to $1.10
chipsdonator: folds
PettyRaise: folds
Uncalled bet ($0.80) returned to SyN7001
SyN7001 collected $0.70 from pot
SyN7001: doesn't show hand
*** SUMMARY ***
Total pot $0.70 | Rake $0
Seat 1: SyN7001 (small blind) collected ($0.70)
Seat 3: chipsdonator (big blind) folded before Flop
Seat 4: Any2CardsRIU folded before Flop (didn't bet)
Seat 5: tapouttazz9 folded before Flop (didn't bet)
Seat 6: PettyRaise (button) folded before Flop


PokerStars Hand #122879875103:  Hold'em No Limit ($0.05/$0.10 USD) - 2016/03/18 22:58:10 ET
Table 'Gemini' 6-max Seat #1 is the button
Seat 1: SyN7001 ($10.40 in chips)
Seat 3: chipsdonator ($17.07 in chips)
Seat 4: Any2CardsRIU ($24.60 in chips)
Seat 5: tapouttazz9 ($19.65 in chips)
Seat 6: PettyRaise ($10.64 in chips)
chipsdonator: posts small blind $0.05
Any2CardsRIU: posts big blind $0.10
*** HOLE CARDS ***
Dealt to tapouttazz9 [5c Qh]
tapouttazz9: folds
PettyRaise: folds
SyN7001: folds
chipsdonator: calls $0.05
Any2CardsRIU: raises $0.25 to $0.35
chipsdonator: folds
Uncalled bet ($0.25) returned to Any2CardsRIU
Any2CardsRIU collected $0.20 from pot
Any2CardsRIU: doesn't show hand
*** SUMMARY ***
Total pot $0.20 | Rake $0
Seat 1: SyN7001 (button) folded before Flop (didn't bet)
Seat 3: chipsdonator (small blind) folded before Flop
Seat 4: Any2CardsRIU (big blind) collected ($0.20)
Seat 5: tapouttazz9 folded before Flop (didn't bet)
Seat 6: PettyRaise folded before Flop (didn't bet)


PokerStars Hand #122879875163:  Hold'em No Limit ($0.05/$0.10 USD) - 2016/03/18 22:58:31 ET
Table 'Gemini' 6-max Seat #3 is the button
Seat 1: SyN7001 ($10.40 in chips)
Seat 3: chipsdonator ($16.97 in chips)
Seat 4: Any2CardsRIU ($24.70 in chips)
Seat 5: tapouttazz9 ($19.65 in chips)
Seat 6: PettyRaise ($10.64 in chips)
Any2CardsRIU: posts small blind $0.05
tapouttazz9: posts big blind $0.10
*** HOLE CARDS ***
Dealt to tapouttazz9 [8c 8d]
PettyRaise: raises $0.20 to $0.30
SyN7001: folds
chipsdonator: folds
Any2CardsRIU: folds
tapouttazz9: calls $0.20
*** FLOP *** [9d 8h 2h]
tapouttazz9: checks
PettyRaise: bets $0.35
tapouttazz9: raises $0.35 to $0.70
PettyRaise: folds
Uncalled bet ($0.35) returned to tapouttazz9
tapouttazz9 collected $1.28 from pot
tapouttazz9: doesn't show hand
*** SUMMARY ***
Total pot $1.35 | Rake $0.07
Board [9d 8h 2h]
Seat 1: SyN7001 folded before Flop (didn't bet)
Seat 3: chipsdonator (button) folded before Flop (didn't bet)
Seat 4: Any2CardsRIU (small blind) folded before Flop
Seat 5: tapouttazz9 (big blind) collected ($1.28)
Seat 6: PettyRaise folded on the Flop


PokerStars Hand #122879875255:  Hold'em No Limit ($0.05/$0.10 USD) - 2016/03/18 22:59:05 ET
Table 'Gemini' 6-max Seat #4 is the button
Seat 1: SyN7001 ($10.40 in chips)
Seat 3: chipsdonator ($16.97 in chips)
Seat 4: Any2CardsRIU ($24.65 in chips)
Seat 5: tapouttazz9 ($20.28 in chips)
Seat 6: PettyRaise ($9.99 in chips)
tapouttazz9: posts small blind $0.05
PettyRaise: posts big blind $0.10
*** HOLE CARDS ***
Dealt to tapouttazz9 [9c Ks]
SyN7001: folds
chipsdonator: folds
Any2CardsRIU: folds
tapouttazz9: raises $0.10 to $0.20
PettyRaise: folds
Uncalled bet ($0.10) returned to tapouttazz9
tapouttazz9 collected $0.20 from pot
tapouttazz9: doesn't show hand
*** SUMMARY ***
Total pot $0.20 | Rake $0
Seat 1: SyN7001 folded before Flop (didn't bet)
Seat 3: chipsdonator folded before Flop (didn't bet)
Seat 4: Any2CardsRIU (button) folded before Flop (didn't bet)
Seat 5: tapouttazz9 (small blind) collected ($0.20)
Seat 6: PettyRaise (big blind) folded before Flop


PokerStars Hand #122879875336:  Hold'em No Limit ($0.05/$0.10 USD) - 2016/03/18 22:59:35 ET
Table 'Gemini' 6-max Seat #5 is the button
Seat 1: SyN7001 ($10.40 in chips)
Seat 3: chipsdonator ($16.97 in chips)
Seat 4: Any2CardsRIU ($24.65 in chips)
Seat 5: tapouttazz9 ($20.38 in chips)
Seat 6: PettyRaise ($9.89 in chips)
PettyRaise: posts small blind $0.05
SyN7001: posts big blind $0.10
*** HOLE CARDS ***
Dealt to tapouttazz9 [Ks 3c]
chipsdonator: folds
Any2CardsRIU: folds
tapouttazz9: folds
PettyRaise: raises $0.20 to $0.30
SyN7001: raises $0.80 to $1.10
PettyRaise: folds
Uncalled bet ($0.80) returned to SyN7001
SyN7001 collected $0.60 from pot
SyN7001: doesn't show hand
*** SUMMARY ***
Total pot $0.60 | Rake $0
Seat 1: SyN7001 (big blind) collected ($0.60)
Seat 3: chipsdonator folded before Flop (didn't bet)
Seat 4: Any2CardsRIU folded before Flop (didn't bet)
Seat 5: tapouttazz9 (button) folded before Flop (didn't bet)
Seat 6: PettyRaise (small blind) folded before Flop


PokerStars Hand #122879875395:  Hold'em No Limit ($0.05/$0.10 USD) - 2016/03/18 22:59:57 ET
Table 'Gemini' 6-max Seat #6 is the button
Seat 1: SyN7001 ($10.70 in chips)
Seat 3: chipsdonator ($16.97 in chips)
Seat 4: Any2CardsRIU ($24.65 in chips)
Seat 5: tapouttazz9 ($20.38 in chips)
Seat 6: PettyRaise ($9.59 in chips)
SyN7001: posts small blind $0.05
chipsdonator: posts big blind $0.10
*** HOLE CARDS ***
Dealt to tapouttazz9 [8d 4s]
Any2CardsRIU: folds
tapouttazz9: folds
PettyRaise: raises $0.20 to $0.30
SyN7001: folds
chipsdonator: folds
Uncalled bet ($0.20) returned to PettyRaise
PettyRaise collected $0.25 from pot
PettyRaise: doesn't show hand
*** SUMMARY ***
Total pot $0.25 | Rake $0
Seat 1: SyN7001 (small blind) folded before Flop
Seat 3: chipsdonator (big blind) folded before Flop
Seat 4: Any2CardsRIU folded before Flop (didn't bet)
Seat 5: tapouttazz9 folded before Flop (didn't bet)
Seat 6: PettyRaise (button) collected ($0.25)


PokerStars Hand #122879875440:  Hold'em No Limit ($0.05/$0.10 USD) - 2016/03/18 23:00:12 ET
Table 'Gemini' 6-max Seat #1 is the button
Seat 1: SyN7001 ($10.65 in chips)
Seat 3: chipsdonator ($16.87 in chips)
Seat 4: Any2CardsRIU ($24.65 in chips)
Seat 5: tapouttazz9 ($20.38 in chips)
Seat 6: PettyRaise ($9.74 in chips)
chipsdonator: posts small blind $0.05
Any2CardsRIU: posts big blind $0.10
*** HOLE CARDS ***
Dealt to tapouttazz9 [5h Kc]
tapouttazz9: folds
PettyRaise: folds
SyN7001: raises $0.20 to $0.30
chipsdonator: folds
Any2CardsRIU: folds
Uncalled bet ($0.20) returned to SyN7001
SyN7001 collected $0.25 from pot
SyN7001: doesn't show hand
*** SUMMARY ***
Total pot $0.25 | Rake $0
Seat 1: SyN7001 (button) collected ($0.25)
Seat 3: chipsdonator (small blind) folded before Flop
Seat 4: Any2CardsRIU (big blind) folded before Flop
Seat 5: tapouttazz9 folded before Flop (didn't bet)
Seat 6: PettyRaise folded before Flop (didn't bet)


PokerStars Hand #122879875501:  Hold'em No Limit ($0.05/$0.10 USD) - 2016/03/18 23:00:29 ET
Table 'Gemini' 6-max Seat #3 is the button
Seat 1: SyN7001 ($10.80 in chips)
Seat 3: chipsdonator ($16.82 in chips)
Seat 4: Any2CardsRIU ($24.55 in chips)
Seat 5: tapouttazz9 ($20.38 in chips)
Seat 6: PettyRaise ($9.74 in chips)
Any2CardsRIU: posts small blind $0.05
tapouttazz9: posts big blind $0.10
*** HOLE CARDS ***
Dealt to tapouttazz9 [9h 8c]
PettyRaise: folds
SyN7001: folds
chipsdonator: folds
Any2CardsRIU: raises $0.20 to $0.30
tapouttazz9: calls $0.20
*** FLOP *** [9s 5h 3h]
Any2CardsRIU: checks
tapouttazz9: bets $0.28
Any2CardsRIU: folds
Uncalled bet ($0.28) returned to tapouttazz9
tapouttazz9 collected $0.57 from pot
tapouttazz9: doesn't show hand
*** SUMMARY ***
Total pot $0.60 | Rake $0.03
Board [9s 5h 3h]
Seat 1: SyN7001 folded before Flop (didn't bet)
Seat 3: chipsdonator (button) folded before Flop (didn't bet)
Seat 4: Any2CardsRIU (small blind) folded on the Flop
Seat 5: tapouttazz9 (big blind) collected ($0.57)
Seat 6: PettyRaise folded before Flop (didn't bet)


PokerStars Hand #122879875581:  Hold'em No Limit ($0.05/$0.10 USD) - 2016/03/18 23:00:54 ET
Table 'Gemini' 6-max Seat #4 is the button
Seat 1: SyN7001 ($10.80 in chips)
Seat 3: chipsdonator ($16.82 in chips)
Seat 4: Any2CardsRIU ($24.25 in chips)
Seat 5: tapouttazz9 ($20.65 in chips)
Seat 6: PettyRaise ($9.74 in chips)
tapouttazz9: posts small blind $0.05
PettyRaise: posts big blind $0.10
*** HOLE CARDS ***
Dealt to tapouttazz9 [Td 5s]
SyN7001: folds
chipsdonator: folds
Any2CardsRIU: folds
tapouttazz9: folds
Uncalled bet ($0.05) returned to PettyRaise
PettyRaise collected $0.10 from pot
PettyRaise: doesn't show hand
*** SUMMARY ***
Total pot $0.10 | Rake $0
Seat 1: SyN7001 folded before Flop (didn't bet)
Seat 3: chipsdonator folded before Flop (didn't bet)
Seat 4: Any2CardsRIU (button) folded before Flop (didn't bet)
Seat 5: tapouttazz9 (small blind) folded before Flop
Seat 6: PettyRaise (big blind) collected ($0.10)


PokerStars Hand #122879875613:  Hold'em No Limit ($0.05/$0.10 USD) - 2016/03/18 23:01:06 ET
Table 'Gemini' 6-max Seat #5 is the button
Seat 1: SyN7001 ($10.80 in chips)
Seat 3: chipsdonator ($16.82 in chips)
Seat 4: Any2CardsRIU ($24.25 in chips)
Seat 5: tapouttazz9 ($20.60 in chips)
Seat 6: PettyRaise ($9.79 in chips)
PettyRaise: posts small blind $0.05
SyN7001: posts big blind $0.10
*** HOLE CARDS ***
Dealt to tapouttazz9 [Qc 3h]
chipsdonator: raises $0.30 to $0.40
Any2CardsRIU: folds
tapouttazz9: folds
PettyRaise: folds
SyN7001: folds
Uncalled bet ($0.30) returned to chipsdonator
chipsdonator collected $0.25 from pot
chipsdonator: doesn't show hand
*** SUMMARY ***
Total pot $0.25 | Rake $0
Seat 1: SyN7001 (big blind) folded before Flop
Seat 3: chipsdonator collected ($0.25)
Seat 4: Any2CardsRIU folded before Flop (didn't bet)
Seat 5: tapouttazz9 (button) folded before Flop (didn't bet)
Seat 6: PettyRaise (small blind) folded before Flop


PokerStars Hand #122879875646:  Hold'em No Limit ($0.05/$0.10 USD) - 2016/03/18 23:01:18 ET
Table 'Gemini' 6-max Seat #6 is the button
Seat 1: SyN7001 ($10.70 in chips)
Seat 3: chipsdonator ($16.97 in chips)
Seat 4: Any2CardsRIU ($24.25 in chips)
Seat 5: tapouttazz9 ($20.60 in chips)
Seat 6: PettyRaise ($9.74 in chips)
SyN7001: posts small blind $0.05
chipsdonator: posts big blind $0.10
*** HOLE CARDS ***
Dealt to tapouttazz9 [Td 8d]
Any2CardsRIU: folds
Any2CardsRIU leaves the table
tapouttazz9: folds
PettyRaise: folds
SyN7001: folds
Uncalled bet ($0.05) returned to chipsdonator
chipsdonator collected $0.10 from pot
chipsdonator: doesn't show hand
*** SUMMARY ***
Total pot $0.10 | Rake $0
Seat 1: SyN7001 (small blind) folded before Flop
Seat 3: chipsdonator (big blind) collected ($0.10)
Seat 4: Any2CardsRIU folded before Flop (didn't bet)
Seat 5: tapouttazz9 folded before Flop (didn't bet)
Seat 6: PettyRaise (button) folded before Flop (didn't bet)


PokerStars Hand #122879875739:  Hold'em No Limit ($0.05/$0.10 USD) - 2016/03/18 23:01:46 ET
Table 'Gemini' 6-max Seat #1 is the button
Seat 1: SyN7001 ($10.65 in chips)
Seat 3: chipsdonator ($17.02 in chips)
Seat 5: tapouttazz9 ($20.60 in chips)
Seat 6: PettyRaise ($9.74 in chips)
chipsdonator: posts small blind $0.05
tapouttazz9: posts big blind $0.10
*** HOLE CARDS ***
Dealt to tapouttazz9 [9c 3c]
Mtown35 joins the table at seat #2
PettyRaise: folds
SyN7001: folds
chipsdonator: calls $0.05
tapouttazz9: checks
*** FLOP *** [Ts 4h Jc]
chipsdonator: checks
tapouttazz9: checks
*** TURN *** [Ts 4h Jc] [Td]
chipsdonator: checks
tapouttazz9: checks
*** RIVER *** [Ts 4h Jc Td] [Kd]
chipsdonator: checks
tapouttazz9: checks
*** SHOW DOWN ***
chipsdonator: shows [5d Ad] (a pair of Tens)
tapouttazz9: mucks hand
chipsdonator collected $0.19 from pot
*** SUMMARY ***
Total pot $0.20 | Rake $0.01
Board [Ts 4h Jc Td Kd]
Seat 1: SyN7001 (button) folded before Flop (didn't bet)
Seat 3: chipsdonator (small blind) showed [5d Ad] and won ($0.19) with a pair of Tens
Seat 5: tapouttazz9 (big blind) mucked [9c 3c]
Seat 6: PettyRaise folded before Flop (didn't bet)


PokerStars Hand #122879875842:  Hold'em No Limit ($0.05/$0.10 USD) - 2016/03/18 23:02:18 ET
Table 'Gemini' 6-max Seat #3 is the button
Seat 1: SyN7001 ($10.65 in chips)
Seat 2: Mtown35 ($10 in chips)
Seat 3: chipsdonator ($17.11 in chips)
Seat 5: tapouttazz9 ($20.50 in chips)
Seat 6: PettyRaise ($9.74 in chips)
tapouttazz9: posts small blind $0.05
PettyRaise: posts big blind $0.10
Mtown35: posts big blind $0.10
*** HOLE CARDS ***
Dealt to tapouttazz9 [6c Js]
SyN7001: folds
Mtown35: checks
chipsdonator: folds
tapouttazz9: folds
PettyRaise: checks
*** FLOP *** [5c 4h Ah]
PettyRaise: bets $0.20
Mtown35: folds
Uncalled bet ($0.20) returned to PettyRaise
ohWELLLL joins the table at seat #4
PettyRaise collected $0.24 from pot
PettyRaise: doesn't show hand
*** SUMMARY ***
Total pot $0.25 | Rake $0.01
Board [5c 4h Ah]
Seat 1: SyN7001 folded before Flop (didn't bet)
Seat 2: Mtown35 folded on the Flop
Seat 3: chipsdonator (button) folded before Flop (didn't bet)
Seat 5: tapouttazz9 (small blind) folded before Flop
Seat 6: PettyRaise (big blind) collected ($0.24)


PokerStars Hand #122879875947:  Hold'em No Limit ($0.05/$0.10 USD) - 2016/03/18 23:02:52 ET
Table 'Gemini' 6-max Seat #5 is the button
Seat 1: SyN7001 ($10.65 in chips)
Seat 2: Mtown35 ($9.90 in chips)
Seat 3: chipsdonator ($17.11 in chips)
Seat 5: tapouttazz9 ($20.45 in chips)
Seat 6: PettyRaise ($9.88 in chips)
PettyRaise: posts small blind $0.05
SyN7001: posts big blind $0.10
ohWELLLL: sits out
*** HOLE CARDS ***
Dealt to tapouttazz9 [3d Ts]
Mtown35: raises $0.20 to $0.30
chipsdonator: calls $0.30
tapouttazz9: folds
PettyRaise: folds
SyN7001: folds
*** FLOP *** [2s Th 5h]
Mtown35: bets $0.30
chipsdonator: folds
Uncalled bet ($0.30) returned to Mtown35
Mtown35 collected $0.71 from pot
Mtown35: doesn't show hand
*** SUMMARY ***
Total pot $0.75 | Rake $0.04
Board [2s Th 5h]
Seat 1: SyN7001 (big blind) folded before Flop
Seat 2: Mtown35 collected ($0.71)
Seat 3: chipsdonator folded on the Flop
Seat 5: tapouttazz9 (button) folded before Flop (didn't bet)
Seat 6: PettyRaise (small blind) folded before Flop


PokerStars Hand #122879876033:  Hold'em No Limit ($0.05/$0.10 USD) - 2016/03/18 23:03:21 ET
Table 'Gemini' 6-max Seat #6 is the button
Seat 1: SyN7001 ($10.55 in chips)
Seat 2: Mtown35 ($10.31 in chips)
Seat 3: chipsdonator ($16.81 in chips)
Seat 5: tapouttazz9 ($20.45 in chips)
Seat 6: PettyRaise ($9.83 in chips)
SyN7001: posts small blind $0.05
Mtown35: posts big blind $0.10
ohWELLLL: sits out
*** HOLE CARDS ***
Dealt to tapouttazz9 [4s 9d]
chipsdonator: raises $0.20 to $0.30
tapouttazz9: folds
PettyRaise: folds
SyN7001: folds
Mtown35: folds
Uncalled bet ($0.20) returned to chipsdonator
SyN7001 leaves the table
chipsdonator collected $0.25 from pot
chipsdonator: doesn't show hand
*** SUMMARY ***
Total pot $0.25 | Rake $0
Seat 1: SyN7001 (small blind) folded before Flop
Seat 2: Mtown35 (big blind) folded before Flop
Seat 3: chipsdonator collected ($0.25)
Seat 5: tapouttazz9 folded before Flop (didn't bet)
Seat 6: PettyRaise (button) folded before Flop (didn't bet)


PokerStars Hand #122879876087:  Hold'em No Limit ($0.05/$0.10 USD) - 2016/03/18 23:03:39 ET
Table 'Gemini' 6-max Seat #2 is the button
Seat 2: Mtown35 ($10.21 in chips)
Seat 3: chipsdonator ($16.96 in chips)
Seat 4: ohWELLLL ($10 in chips)
Seat 5: tapouttazz9 ($20.45 in chips)
Seat 6: PettyRaise ($9.83 in chips)
chipsdonator: posts small blind $0.05
ohWELLLL: posts big blind $0.10
*** HOLE CARDS ***
Dealt to tapouttazz9 [6s Ts]
tapouttazz9: folds
PettyRaise: folds
Mtown35: raises $0.30 to $0.40
chipsdonator: folds
ohWELLLL: folds
Uncalled bet ($0.30) returned to Mtown35
Mtown35 collected $0.25 from pot
Mtown35: doesn't show hand
*** SUMMARY ***
Total pot $0.25 | Rake $0
Seat 2: Mtown35 (button) collected ($0.25)
Seat 3: chipsdonator (small blind) folded before Flop
Seat 4: ohWELLLL (big blind) folded before Flop
Seat 5: tapouttazz9 folded before Flop (didn't bet)
Seat 6: PettyRaise folded before Flop (didn't bet)


PokerStars Hand #122879876154:  Hold'em No Limit ($0.05/$0.10 USD) - 2016/03/18 23:04:01 ET
Table 'Gemini' 6-max Seat #3 is the button
Seat 2: Mtown35 ($10.36 in chips)
Seat 3: chipsdonator ($16.91 in chips)
Seat 4: ohWELLLL ($9.90 in chips)
Seat 5: tapouttazz9 ($20.45 in chips)
Seat 6: PettyRaise ($9.83 in chips)
ohWELLLL: posts small blind $0.05
tapouttazz9: posts big blind $0.10
*** HOLE CARDS ***
Dealt to tapouttazz9 [6d 5h]
PettyRaise: folds
Mtown35: folds
chipsdonator: folds
ohWELLLL: folds
Uncalled bet ($0.05) returned to tapouttazz9
tapouttazz9 collected $0.10 from pot
tapouttazz9: doesn't show hand
*** SUMMARY ***
Total pot $0.10 | Rake $0
Seat 2: Mtown35 folded before Flop (didn't bet)
Seat 3: chipsdonator (button) folded before Flop (didn't bet)
Seat 4: ohWELLLL (small blind) folded before Flop
Seat 5: tapouttazz9 (big blind) collected ($0.10)
Seat 6: PettyRaise folded before Flop (didn't bet)


PokerStars Hand #122879876191:  Hold'em No Limit ($0.05/$0.10 USD) - 2016/03/18 23:04:14 ET
Table 'Gemini' 6-max Seat #4 is the button
Seat 2: Mtown35 ($10.36 in chips)
Seat 3: chipsdonator ($16.91 in chips)
Seat 4: ohWELLLL ($9.85 in chips)
Seat 5: tapouttazz9 ($20.50 in chips)
Seat 6: PettyRaise ($9.83 in chips)
tapouttazz9: posts small blind $0.05
PettyRaise: posts big blind $0.10
*** HOLE CARDS ***
Dealt to tapouttazz9 [9d Jh]
Mtown35: folds
chipsdonator: folds
ohWELLLL: folds
tapouttazz9: folds
Uncalled bet ($0.05) returned to PettyRaise
PettyRaise collected $0.10 from pot
PettyRaise: doesn't show hand
*** SUMMARY ***
Total pot $0.10 | Rake $0
Seat 2: Mtown35 folded before Flop (didn't bet)
Seat 3: chipsdonator folded before Flop (didn't bet)
Seat 4: ohWELLLL (button) folded before Flop (didn't bet)
Seat 5: tapouttazz9 (small blind) folded before Flop
Seat 6: PettyRaise (big blind) collected ($0.10)


PokerStars Hand #122879876249:  Hold'em No Limit ($0.05/$0.10 USD) - 2016/03/18 23:04:31 ET
Table 'Gemini' 6-max Seat #5 is the button
Seat 2: Mtown35 ($10.36 in chips)
Seat 3: chipsdonator ($16.91 in chips)
Seat 4: ohWELLLL ($9.85 in chips)
Seat 5: tapouttazz9 ($20.45 in chips)
Seat 6: PettyRaise ($9.88 in chips)
PettyRaise: posts small blind $0.05
Mtown35: posts big blind $0.10
*** HOLE CARDS ***
Dealt to tapouttazz9 [2c 6h]
chipsdonator: folds
ohWELLLL: folds
tapouttazz9: folds
PettyRaise: raises $0.20 to $0.30
Mtown35: folds
Uncalled bet ($0.20) returned to PettyRaise
PettyRaise collected $0.20 from pot
PettyRaise: doesn't show hand
*** SUMMARY ***
Total pot $0.20 | Rake $0
Seat 2: Mtown35 (big blind) folded before Flop
Seat 3: chipsdonator folded before Flop (didn't bet)
Seat 4: ohWELLLL folded before Flop (didn't bet)
Seat 5: tapouttazz9 (button) folded before Flop (didn't bet)
Seat 6: PettyRaise (small blind) collected ($0.20)


PokerStars Hand #122879876309:  Hold'em No Limit ($0.05/$0.10 USD) - 2016/03/18 23:04:52 ET
Table 'Gemini' 6-max Seat #6 is the button
Seat 2: Mtown35 ($10.26 in chips)
Seat 3: chipsdonator ($16.91 in chips)
Seat 4: ohWELLLL ($9.85 in chips)
Seat 5: tapouttazz9 ($20.45 in chips)
Seat 6: PettyRaise ($9.98 in chips)
Mtown35: posts small blind $0.05
chipsdonator: posts big blind $0.10
*** HOLE CARDS ***
Dealt to tapouttazz9 [9d 4s]
ohWELLLL: folds
tapouttazz9: folds
PettyRaise: raises $0.20 to $0.30
Mtown35: folds
chipsdonator: folds
Uncalled bet ($0.20) returned to PettyRaise
PettyRaise collected $0.25 from pot
PettyRaise: doesn't show hand
*** SUMMARY ***
Total pot $0.25 | Rake $0
Seat 2: Mtown35 (small blind) folded before Flop
Seat 3: chipsdonator (big blind) folded before Flop
Seat 4: ohWELLLL folded before Flop (didn't bet)
Seat 5: tapouttazz9 folded before Flop (didn't bet)
Seat 6: PettyRaise (button) collected ($0.25)


PokerStars Hand #122879876384:  Hold'em No Limit ($0.05/$0.10 USD) - 2016/03/18 23:05:14 ET
Table 'Gemini' 6-max Seat #2 is the button
Seat 2: Mtown35 ($10.21 in chips)
Seat 3: chipsdonator ($16.81 in chips)
Seat 4: ohWELLLL ($9.85 in chips)
Seat 5: tapouttazz9 ($20.45 in chips)
Seat 6: PettyRaise ($10.13 in chips)
chipsdonator: posts small blind $0.05
ohWELLLL: posts big blind $0.10
*** HOLE CARDS ***
Dealt to tapouttazz9 [9c Qh]
tapouttazz9: folds
PettyRaise: folds
Mtown35: raises $0.10 to $0.20
chipsdonator: folds
ohWELLLL: folds
Uncalled bet ($0.10) returned to Mtown35
Mtown35 collected $0.25 from pot
Mtown35: doesn't show hand
*** SUMMARY ***
Total pot $0.25 | Rake $0
Seat 2: Mtown35 (button) collected ($0.25)
Seat 3: chipsdonator (small blind) folded before Flop
Seat 4: ohWELLLL (big blind) folded before Flop
Seat 5: tapouttazz9 folded before Flop (didn't bet)
Seat 6: PettyRaise folded before Flop (didn't bet)


PokerStars Hand #122879876460:  Hold'em No Limit ($0.05/$0.10 USD) - 2016/03/18 23:05:44 ET
Table 'Gemini' 6-max Seat #3 is the button
Seat 2: Mtown35 ($10.36 in chips)
Seat 3: chipsdonator ($16.76 in chips)
Seat 4: ohWELLLL ($9.75 in chips)
Seat 5: tapouttazz9 ($20.45 in chips)
Seat 6: PettyRaise ($10.13 in chips)
ohWELLLL: posts small blind $0.05
tapouttazz9: posts big blind $0.10
*** HOLE CARDS ***
Dealt to tapouttazz9 [Kc 3c]
PettyRaise: folds
Mtown35: calls $0.10
chipsdonator: folds
ohWELLLL: folds
tapouttazz9: checks
*** FLOP *** [5h 6c 5d]
tapouttazz9: checks
Mtown35: bets $0.20
tapouttazz9: calls $0.20
*** TURN *** [5h 6c 5d] [Ac]
tapouttazz9: checks
Mtown35: bets $0.20
tapouttazz9: calls $0.20
*** RIVER *** [5h 6c 5d Ac] [7h]
tapouttazz9: checks
Mtown35: checks
*** SHOW DOWN ***
tapouttazz9: shows [Kc 3c] (a pair of Fives)
Mtown35: shows [Ah 6s] (two pair, Aces and Sixes)
Mtown35 collected $1 from pot
*** SUMMARY ***
Total pot $1.05 | Rake $0.05
Board [5h 6c 5d Ac 7h]
Seat 2: Mtown35 showed [Ah 6s] and won ($1) with two pair, Aces and Sixes
Seat 3: chipsdonator (button) folded before Flop (didn't bet)
Seat 4: ohWELLLL (small blind) folded before Flop
Seat 5: tapouttazz9 (big blind) showed [Kc 3c] and lost with a pair of Fives
Seat 6: PettyRaise folded before Flop (didn't bet)


PokerStars Hand #122879876588:  Hold'em No Limit ($0.05/$0.10 USD) - 2016/03/18 23:06:25 ET
Table 'Gemini' 6-max Seat #4 is the button
Seat 2: Mtown35 ($10.86 in chips)
Seat 3: chipsdonator ($16.76 in chips)
Seat 4: ohWELLLL ($9.70 in chips)
Seat 5: tapouttazz9 ($19.95 in chips)
Seat 6: PettyRaise ($10.13 in chips)
tapouttazz9: posts small blind $0.05
PettyRaise: posts big blind $0.10
*** HOLE CARDS ***
Dealt to tapouttazz9 [9d Js]
Mtown35: folds
chipsdonator: folds
ohWELLLL: raises $0.20 to $0.30
tapouttazz9: folds
PettyRaise: folds
Uncalled bet ($0.20) returned to ohWELLLL
ohWELLLL collected $0.25 from pot
ohWELLLL: doesn't show hand
*** SUMMARY ***
Total pot $0.25 | Rake $0
Seat 2: Mtown35 folded before Flop (didn't bet)
Seat 3: chipsdonator folded before Flop (didn't bet)
Seat 4: ohWELLLL (button) collected ($0.25)
Seat 5: tapouttazz9 (small blind) folded before Flop
Seat 6: PettyRaise (big blind) folded before Flop


PokerStars Hand #122879876634:  Hold'em No Limit ($0.05/$0.10 USD) - 2016/03/18 23:06:40 ET
Table 'Gemini' 6-max Seat #5 is the button
Seat 2: Mtown35 ($10.86 in chips)
Seat 3: chipsdonator ($16.76 in chips)
Seat 4: ohWELLLL ($9.85 in chips)
Seat 5: tapouttazz9 ($19.90 in chips)
Seat 6: PettyRaise ($10.03 in chips)
PettyRaise: posts small blind $0.05
Mtown35: posts big blind $0.10
*** HOLE CARDS ***
Dealt to tapouttazz9 [3c 4s]
chipsdonator: folds
ohWELLLL: folds
tapouttazz9: folds
PettyRaise: folds
Uncalled bet ($0.05) returned to Mtown35
Mtown35 collected $0.10 from pot
Mtown35: doesn't show hand
*** SUMMARY ***
Total pot $0.10 | Rake $0
Seat 2: Mtown35 (big blind) collected ($0.10)
Seat 3: chipsdonator folded before Flop (didn't bet)
Seat 4: ohWELLLL folded before Flop (didn't bet)
Seat 5: tapouttazz9 (button) folded before Flop (didn't bet)
Seat 6: PettyRaise (small blind) folded before Flop


PokerStars Hand #122879876698:  Hold'em No Limit ($0.05/$0.10 USD) - 2016/03/18 23:07:09 ET
Table 'Gemini' 6-max Seat #6 is the button
Seat 2: Mtown35 ($10.91 in chips)
Seat 3: chipsdonator ($16.76 in chips)
Seat 4: ohWELLLL ($9.85 in chips)
Seat 5: tapouttazz9 ($19.90 in chips)
Seat 6: PettyRaise ($9.98 in chips)
Mtown35: posts small blind $0.05
chipsdonator: posts big blind $0.10
*** HOLE CARDS ***
Dealt to tapouttazz9 [Th 6h]
ohWELLLL: folds
tapouttazz9: folds
PettyRaise: raises $0.20 to $0.30
Mtown35: folds
chipsdonator: folds
Uncalled bet ($0.20) returned to PettyRaise
PettyRaise collected $0.25 from pot
PettyRaise: doesn't show hand
MCMplumber joins the table at seat #1
*** SUMMARY ***
Total pot $0.25 | Rake $0
Seat 2: Mtown35 (small blind) folded before Flop
Seat 3: chipsdonator (big blind) folded before Flop
Seat 4: ohWELLLL folded before Flop (didn't bet)
Seat 5: tapouttazz9 folded before Flop (didn't bet)
Seat 6: PettyRaise (button) collected ($0.25)


PokerStars Hand #122879876751:  Hold'em No Limit ($0.05/$0.10 USD) - 2016/03/18 23:07:25 ET
Table 'Gemini' 6-max Seat #2 is the button
Seat 2: Mtown35 ($10.86 in chips)
Seat 3: chipsdonator ($16.66 in chips)
Seat 4: ohWELLLL ($9.85 in chips)
Seat 5: tapouttazz9 ($19.90 in chips)
Seat 6: PettyRaise ($10.13 in chips)
chipsdonator: posts small blind $0.05
ohWELLLL: posts big blind $0.10
MCMplumber: sits out
*** HOLE CARDS ***
Dealt to tapouttazz9 [7h Js]
tapouttazz9: folds
PettyRaise: raises $0.25 to $0.35
Mtown35: calls $0.35
chipsdonator: calls $0.30
ohWELLLL: folds
*** FLOP *** [2c 9c 5d]
chipsdonator: checks
PettyRaise: checks
Mtown35: checks
*** TURN *** [2c 9c 5d] [8c]
chipsdonator: checks
PettyRaise: checks
Mtown35: checks
*** RIVER *** [2c 9c 5d 8c] [7c]
chipsdonator: bets $0.50
PettyRaise: folds
Mtown35: folds
Uncalled bet ($0.50) returned to chipsdonator
chipsdonator collected $1.09 from pot
chipsdonator: doesn't show hand
*** SUMMARY ***
Total pot $1.15 | Rake $0.06
Board [2c 9c 5d 8c 7c]
Seat 2: Mtown35 (button) folded on the River
Seat 3: chipsdonator (small blind) collected ($1.09)
Seat 4: ohWELLLL (big blind) folded before Flop
Seat 5: tapouttazz9 folded before Flop (didn't bet)
Seat 6: PettyRaise folded on the River


PokerStars Hand #150673539137:  Hold'em No Limit ($0.05/$0.10 USD) - 2016/03/29 15:54:32 ET
Table 'Corvus' 6-max Seat #2 is the button
Seat 1: AgresiveOne ($7.06 in chips)
Seat 2: DTDTVDAVE ($22.50 in chips)
Seat 3: JerseyPS ($14.06 in chips)
Seat 4: tapouttazz9 ($8 in chips)
Seat 6: Any2WillDo56 ($12.53 in chips)
JerseyPS: posts small blind $0.05
tapouttazz9: posts big blind $0.10
*** HOLE CARDS ***
Dealt to tapouttazz9 [Ks Kc]
Any2WillDo56: folds
AgresiveOne: folds
DTDTVDAVE: raises $0.15 to $0.25
JerseyPS: folds
tapouttazz9: raises $0.55 to $0.80
DTDTVDAVE: folds
Uncalled bet ($0.55) returned to tapouttazz9
tapouttazz9 collected $0.55 from pot
tapouttazz9: doesn't show hand
*** SUMMARY ***
Total pot $0.55 | Rake $0
Seat 1: AgresiveOne folded before Flop (didn't bet)
Seat 2: DTDTVDAVE (button) folded before Flop
Seat 3: JerseyPS (small blind) folded before Flop
Seat 4: tapouttazz9 (big blind) collected ($0.55)
Seat 6: Any2WillDo56 folded before Flop (didn't bet)


PokerStars Hand #150673539218:  Hold'em No Limit ($0.05/$0.10 USD) - 2016/03/29 15:54:52 ET
Table 'Corvus' 6-max Seat #3 is the button
Seat 1: AgresiveOne ($7.06 in chips)
Seat 2: DTDTVDAVE ($22.25 in chips)
Seat 3: JerseyPS ($14.01 in chips)
Seat 4: tapouttazz9 ($8.30 in chips)
Seat 6: Any2WillDo56 ($12.53 in chips)
tapouttazz9: posts small blind $0.05
Any2WillDo56: posts big blind $0.10
*** HOLE CARDS ***
Dealt to tapouttazz9 [5h 2h]
AgresiveOne: folds
DTDTVDAVE: folds
JerseyPS: raises $0.20 to $0.30
tapouttazz9: folds
Any2WillDo56: folds
Uncalled bet ($0.20) returned to JerseyPS
JerseyPS collected $0.25 from pot
JerseyPS: doesn't show hand
*** SUMMARY ***
Total pot $0.25 | Rake $0
Seat 1: AgresiveOne folded before Flop (didn't bet)
Seat 2: DTDTVDAVE folded before Flop (didn't bet)
Seat 3: JerseyPS (button) collected ($0.25)
Seat 4: tapouttazz9 (small blind) folded before Flop
Seat 6: Any2WillDo56 (big blind) folded before Flop


PokerStars Hand #150673539303:  Hold'em No Limit ($0.05/$0.10 USD) - 2016/03/29 15:55:16 ET
Table 'Corvus' 6-max Seat #4 is the button
Seat 1: AgresiveOne ($7.06 in chips)
Seat 2: DTDTVDAVE ($22.25 in chips)
Seat 3: JerseyPS ($14.16 in chips)
Seat 4: tapouttazz9 ($10 in chips)
Seat 6: Any2WillDo56 ($12.43 in chips)
Any2WillDo56: posts small blind $0.05
AgresiveOne: posts big blind $0.10
*** HOLE CARDS ***
Dealt to tapouttazz9 [8c 4s]
DTDTVDAVE: folds
JerseyPS: folds
tapouttazz9: folds
Any2WillDo56: folds
Uncalled bet ($0.05) returned to AgresiveOne
AgresiveOne collected $0.10 from pot
AgresiveOne: doesn't show hand
*** SUMMARY ***
Total pot $0.10 | Rake $0
Seat 1: AgresiveOne (big blind) collected ($0.10)
Seat 2: DTDTVDAVE folded before Flop (didn't bet)
Seat 3: JerseyPS folded before Flop (didn't bet)
Seat 4: tapouttazz9 (button) folded before Flop (didn't bet)
Seat 6: Any2WillDo56 (small blind) folded before Flop


PokerStars Hand #150673539353:  Hold'em No Limit ($0.05/$0.10 USD) - 2016/03/29 15:55:28 ET
Table 'Corvus' 6-max Seat #6 is the button
Seat 1: AgresiveOne ($7.11 in chips)
Seat 2: DTDTVDAVE ($22.25 in chips)
Seat 3: JerseyPS ($14.16 in chips)
Seat 4: tapouttazz9 ($10 in chips)
Seat 6: Any2WillDo56 ($12.38 in chips)
AgresiveOne: posts small blind $0.05
DTDTVDAVE: posts big blind $0.10
*** HOLE CARDS ***
Dealt to tapouttazz9 [2h 7h]
JerseyPS: raises $0.10 to $0.20
tapouttazz9: folds
Any2WillDo56: calls $0.20
AgresiveOne: folds
DTDTVDAVE: calls $0.10
*** FLOP *** [Qd 4d Kd]
DTDTVDAVE: bets $0.45
JerseyPS: folds
Any2WillDo56: folds
Uncalled bet ($0.45) returned to DTDTVDAVE
DTDTVDAVE collected $0.62 from pot
DTDTVDAVE: doesn't show hand
*** SUMMARY ***
Total pot $0.65 | Rake $0.03
Board [Qd 4d Kd]
Seat 1: AgresiveOne (small blind) folded before Flop
Seat 2: DTDTVDAVE (big blind) collected ($0.62)
Seat 3: JerseyPS folded on the Flop
Seat 4: tapouttazz9 folded before Flop (didn't bet)
Seat 6: Any2WillDo56 (button) folded on the Flop


PokerStars Hand #150673539464:  Hold'em No Limit ($0.05/$0.10 USD) - 2016/03/29 15:56:00 ET
Table 'Corvus' 6-max Seat #1 is the button
Seat 1: AgresiveOne ($7.06 in chips)
Seat 2: DTDTVDAVE ($22.67 in chips)
Seat 3: JerseyPS ($13.96 in chips)
Seat 4: tapouttazz9 ($10 in chips)
Seat 6: Any2WillDo56 ($12.18 in chips)
DTDTVDAVE: posts small blind $0.05
JerseyPS: posts big blind $0.10
*** HOLE CARDS ***
Dealt to tapouttazz9 [6d Kd]
tapouttazz9: folds
Any2WillDo56: raises $0.10 to $0.20
AgresiveOne: calls $0.20
DTDTVDAVE: calls $0.15
JerseyPS: calls $0.10
*** FLOP *** [6h 9h Jd]
DTDTVDAVE: checks
JerseyPS: checks
Any2WillDo56: checks
AgresiveOne: checks
*** TURN *** [6h 9h Jd] [Th]
DTDTVDAVE: checks
JerseyPS: bets $0.38
Any2WillDo56: calls $0.38
AgresiveOne: calls $0.38
DTDTVDAVE: folds
*** RIVER *** [6h 9h Jd Th] [8c]
JerseyPS: bets $1.38
Any2WillDo56: calls $1.38
AgresiveOne: folds
*** SHOW DOWN ***
JerseyPS: shows [3d Qd] (a straight, Eight to Queen)
Any2WillDo56: mucks hand
JerseyPS collected $4.46 from pot
*** SUMMARY ***
Total pot $4.70 | Rake $0.24
Board [6h 9h Jd Th 8c]
Seat 1: AgresiveOne (button) folded on the River
Seat 2: DTDTVDAVE (small blind) folded on the Turn
Seat 3: JerseyPS (big blind) showed [3d Qd] and won ($4.46) with a straight, Eight to Queen
Seat 4: tapouttazz9 folded before Flop (didn't bet)
Seat 6: Any2WillDo56 mucked [Ah 7c]


PokerStars Hand #150673539690:  Hold'em No Limit ($0.05/$0.10 USD) - 2016/03/29 15:57:06 ET
Table 'Corvus' 6-max Seat #2 is the button
Seat 1: AgresiveOne ($6.48 in chips)
Seat 2: DTDTVDAVE ($22.47 in chips)
Seat 3: JerseyPS ($16.46 in chips)
Seat 4: tapouttazz9 ($10 in chips)
Seat 6: Any2WillDo56 ($10.22 in chips)
JerseyPS: posts small blind $0.05
tapouttazz9: posts big blind $0.10
*** HOLE CARDS ***
Dealt to tapouttazz9 [3h Kh]
Any2WillDo56: folds
AgresiveOne: folds
DTDTVDAVE: raises $0.15 to $0.25
JerseyPS: folds
tapouttazz9: folds
Uncalled bet ($0.15) returned to DTDTVDAVE
DTDTVDAVE collected $0.25 from pot
DTDTVDAVE: doesn't show hand
*** SUMMARY ***
Total pot $0.25 | Rake $0
Seat 1: AgresiveOne folded before Flop (didn't bet)
Seat 2: DTDTVDAVE (button) collected ($0.25)
Seat 3: JerseyPS (small blind) folded before Flop
Seat 4: tapouttazz9 (big blind) folded before Flop
Seat 6: Any2WillDo56 folded before Flop (didn't bet)


PokerStars Hand #150673539763:  Hold'em No Limit ($0.05/$0.10 USD) - 2016/03/29 15:57:30 ET
Table 'Corvus' 6-max Seat #3 is the button
Seat 1: AgresiveOne ($6.48 in chips)
Seat 2: DTDTVDAVE ($22.62 in chips)
Seat 3: JerseyPS ($16.41 in chips)
Seat 4: tapouttazz9 ($9.90 in chips)
Seat 6: Any2WillDo56 ($10.22 in chips)
tapouttazz9: posts small blind $0.05
Any2WillDo56: posts big blind $0.10
*** HOLE CARDS ***
Dealt to tapouttazz9 [Ah Jd]
AgresiveOne: folds
DTDTVDAVE: raises $0.15 to $0.25
JerseyPS: folds
tapouttazz9: calls $0.20
Any2WillDo56: calls $0.15
*** FLOP *** [Th 4d 2c]
tapouttazz9: checks
Any2WillDo56: bets $0.35
DTDTVDAVE: calls $0.35
tapouttazz9: folds
*** TURN *** [Th 4d 2c] [7c]
Any2WillDo56: bets $0.69
DTDTVDAVE: calls $0.69
*** RIVER *** [Th 4d 2c 7c] [8h]
Any2WillDo56: bets $1.34
DTDTVDAVE: folds
Uncalled bet ($1.34) returned to Any2WillDo56
Any2WillDo56 collected $2.69 from pot
Any2WillDo56: doesn't show hand
*** SUMMARY ***
Total pot $2.83 | Rake $0.14
Board [Th 4d 2c 7c 8h]
Seat 1: AgresiveOne folded before Flop (didn't bet)
Seat 2: DTDTVDAVE folded on the River
Seat 3: JerseyPS (button) folded before Flop (didn't bet)
Seat 4: tapouttazz9 (small blind) folded on the Flop
Seat 6: Any2WillDo56 (big blind) collected ($2.69)


PokerStars Hand #150673539932:  Hold'em No Limit ($0.05/$0.10 USD) - 2016/03/29 15:58:20 ET
Table 'Corvus' 6-max Seat #4 is the button
Seat 1: AgresiveOne ($6.48 in chips)
Seat 2: DTDTVDAVE ($21.33 in chips)
Seat 3: JerseyPS ($16.41 in chips)
Seat 4: tapouttazz9 ($9.65 in chips)
Seat 6: Any2WillDo56 ($11.62 in chips)
Any2WillDo56: posts small blind $0.05
AgresiveOne: posts big blind $0.10
*** HOLE CARDS ***
Dealt to tapouttazz9 [4h 4s]
DTDTVDAVE: folds
JerseyPS: folds
tapouttazz9: raises $0.10 to $0.20
Any2WillDo56: calls $0.15
AgresiveOne: calls $0.10
*** FLOP *** [6h 2s Qd]
Any2WillDo56: bets $0.28
AgresiveOne: folds
tapouttazz9: folds
Uncalled bet ($0.28) returned to Any2WillDo56
Any2WillDo56 collected $0.57 from pot
Any2WillDo56: doesn't show hand
*** SUMMARY ***
Total pot $0.60 | Rake $0.03
Board [6h 2s Qd]
Seat 1: AgresiveOne (big blind) folded on the Flop
Seat 2: DTDTVDAVE folded before Flop (didn't bet)
Seat 3: JerseyPS folded before Flop (didn't bet)
Seat 4: tapouttazz9 (button) folded on the Flop
Seat 6: Any2WillDo56 (small blind) collected ($0.57)


PokerStars Hand #150675084017:  Hold'em No Limit ($0.05/$0.10 USD) - 2016/03/29 15:58:44 ET
Table 'Corvus' 6-max Seat #6 is the button
Seat 1: AgresiveOne ($6.28 in chips)
Seat 2: DTDTVDAVE ($21.33 in chips)
Seat 3: JerseyPS ($16.41 in chips)
Seat 4: tapouttazz9 ($9.45 in chips)
Seat 6: Any2WillDo56 ($11.99 in chips)
AgresiveOne: posts small blind $0.05
DTDTVDAVE: posts big blind $0.10
*** HOLE CARDS ***
Dealt to tapouttazz9 [Jd 6h]
JerseyPS: folds
tapouttazz9: folds
Any2WillDo56: calls $0.10
AgresiveOne: folds
DTDTVDAVE: checks
*** FLOP *** [5h 4c Kh]
DTDTVDAVE: bets $0.18
Any2WillDo56: folds
Uncalled bet ($0.18) returned to DTDTVDAVE
DTDTVDAVE collected $0.24 from pot
DTDTVDAVE: doesn't show hand
*** SUMMARY ***
Total pot $0.25 | Rake $0.01
Board [5h 4c Kh]
Seat 1: AgresiveOne (small blind) folded before Flop
Seat 2: DTDTVDAVE (big blind) collected ($0.24)
Seat 3: JerseyPS folded before Flop (didn't bet)
Seat 4: tapouttazz9 folded before Flop (didn't bet)
Seat 6: Any2WillDo56 (button) folded on the Flop


PokerStars Hand #150675084094:  Hold'em No Limit ($0.05/$0.10 USD) - 2016/03/29 15:59:05 ET
Table 'Corvus' 6-max Seat #1 is the button
Seat 1: AgresiveOne ($6.23 in chips)
Seat 2: DTDTVDAVE ($21.47 in chips)
Seat 4: tapouttazz9 ($9.45 in chips)
Seat 6: Any2WillDo56 ($11.89 in chips)
DTDTVDAVE: posts small blind $0.05
JerseyPS: is sitting out
tapouttazz9: posts big blind $0.10
*** HOLE CARDS ***
Dealt to tapouttazz9 [5c Ah]
Any2WillDo56: raises $0.20 to $0.30
AgresiveOne: calls $0.30
DTDTVDAVE: folds
tapouttazz9: folds
*** FLOP *** [Ac 2h Ks]
Any2WillDo56: bets $0.35
AgresiveOne: calls $0.35
*** TURN *** [Ac 2h Ks] [Th]
Any2WillDo56: checks
AgresiveOne: checks
*** RIVER *** [Ac 2h Ks Th] [7h]
Any2WillDo56: checks
AgresiveOne: checks
*** SHOW DOWN ***
Any2WillDo56: shows [9d Td] (a pair of Tens)
AgresiveOne: shows [Kh Qs] (a pair of Kings)
AgresiveOne collected $1.38 from pot
*** SUMMARY ***
Total pot $1.45 | Rake $0.07
Board [Ac 2h Ks Th 7h]
Seat 1: AgresiveOne (button) showed [Kh Qs] and won ($1.38) with a pair of Kings
Seat 2: DTDTVDAVE (small blind) folded before Flop
Seat 4: tapouttazz9 (big blind) folded before Flop
Seat 6: Any2WillDo56 showed [9d Td] and lost with a pair of Tens


PokerStars Hand #150675084231:  Hold'em No Limit ($0.05/$0.10 USD) - 2016/03/29 15:59:44 ET
Table 'Corvus' 6-max Seat #2 is the button
Seat 1: AgresiveOne ($6.96 in chips)
Seat 2: DTDTVDAVE ($21.42 in chips)
Seat 4: tapouttazz9 ($9.35 in chips)
Seat 6: Any2WillDo56 ($11.24 in chips)
tapouttazz9: posts small blind $0.05
Any2WillDo56: posts big blind $0.10
*** HOLE CARDS ***
Dealt to tapouttazz9 [Qd Js]
AgresiveOne: raises $0.15 to $0.25
DTDTVDAVE: folds
tapouttazz9: folds
Any2WillDo56: folds
Uncalled bet ($0.15) returned to AgresiveOne
AgresiveOne collected $0.25 from pot
AgresiveOne: doesn't show hand
*** SUMMARY ***
Total pot $0.25 | Rake $0
Seat 1: AgresiveOne collected ($0.25)
Seat 2: DTDTVDAVE (button) folded before Flop (didn't bet)
Seat 4: tapouttazz9 (small blind) folded before Flop
Seat 6: Any2WillDo56 (big blind) folded before Flop


PokerStars Hand #150675084257:  Hold'em No Limit ($0.05/$0.10 USD) - 2016/03/29 15:59:54 ET
Table 'Corvus' 6-max Seat #4 is the button
Seat 1: AgresiveOne ($7.11 in chips)
Seat 2: DTDTVDAVE ($21.42 in chips)
Seat 4: tapouttazz9 ($9.30 in chips)
Seat 6: Any2WillDo56 ($11.14 in chips)
Any2WillDo56: posts small blind $0.05
AgresiveOne: posts big blind $0.10
*** HOLE CARDS ***
Dealt to tapouttazz9 [4d Ac]
DTDTVDAVE: folds
tapouttazz9: folds
Any2WillDo56: folds
Uncalled bet ($0.05) returned to AgresiveOne
AgresiveOne collected $0.10 from pot
AgresiveOne: doesn't show hand
*** SUMMARY ***
Total pot $0.10 | Rake $0
Seat 1: AgresiveOne (big blind) collected ($0.10)
Seat 2: DTDTVDAVE folded before Flop (didn't bet)
Seat 4: tapouttazz9 (button) folded before Flop (didn't bet)
Seat 6: Any2WillDo56 (small blind) folded before Flop


PokerStars Hand #150675084307:  Hold'em No Limit ($0.05/$0.10 USD) - 2016/03/29 16:00:07 ET
Table 'Corvus' 6-max Seat #6 is the button
Seat 1: AgresiveOne ($7.16 in chips)
Seat 2: DTDTVDAVE ($21.42 in chips)
Seat 4: tapouttazz9 ($9.30 in chips)
Seat 6: Any2WillDo56 ($11.09 in chips)
AgresiveOne: posts small blind $0.05
DTDTVDAVE: posts big blind $0.10
*** HOLE CARDS ***
Dealt to tapouttazz9 [Jc 8c]
tapouttazz9: folds
Any2WillDo56: folds
AgresiveOne: calls $0.05
DTDTVDAVE: raises $0.30 to $0.40
AgresiveOne: calls $0.30
*** FLOP *** [9c Ah Js]
AgresiveOne: checks
DTDTVDAVE: checks
*** TURN *** [9c Ah Js] [7c]
JerseyPS leaves the table
AgresiveOne: checks
bfelixs joins the table at seat #3
DTDTVDAVE: bets $0.50
AgresiveOne: calls $0.50
*** RIVER *** [9c Ah Js 7c] [4c]
TomBrady200 was removed from the table for failing to post
AgresiveOne: bets $0.85
DTDTVDAVE: calls $0.85
*** SHOW DOWN ***
AgresiveOne: shows [Ts Kh] (high card Ace)
DTDTVDAVE: shows [Jh Tc] (a pair of Jacks)
DTDTVDAVE collected $3.32 from pot
*** SUMMARY ***
Total pot $3.50 | Rake $0.18
Board [9c Ah Js 7c 4c]
Seat 1: AgresiveOne (small blind) showed [Ts Kh] and lost with high card Ace
Seat 2: DTDTVDAVE (big blind) showed [Jh Tc] and won ($3.32) with a pair of Jacks
Seat 4: tapouttazz9 folded before Flop (didn't bet)
Seat 6: Any2WillDo56 (button) folded before Flop (didn't bet)


PokerStars Hand #150675084552:  Hold'em No Limit ($0.05/$0.10 USD) - 2016/03/29 16:01:19 ET
Table 'Corvus' 6-max Seat #1 is the button
Seat 1: AgresiveOne ($5.41 in chips)
Seat 2: DTDTVDAVE ($22.99 in chips)
Seat 3: bfelixs ($10 in chips)
Seat 4: tapouttazz9 ($9.30 in chips)
Seat 6: Any2WillDo56 ($11.09 in chips)
DTDTVDAVE: posts small blind $0.05
bfelixs: posts big blind $0.10
*** HOLE CARDS ***
Dealt to tapouttazz9 [9h 2s]
tapouttazz9: folds
Any2WillDo56: raises $0.10 to $0.20
AgresiveOne: calls $0.20
DTDTVDAVE: calls $0.15
bfelixs: folds
*** FLOP *** [Qh 9d 5c]
DTDTVDAVE: checks
Any2WillDo56: bets $0.66
AgresiveOne: calls $0.66
DTDTVDAVE: raises $1.74 to $2.40
Any2WillDo56: folds
AgresiveOne: folds
Uncalled bet ($1.74) returned to DTDTVDAVE
DTDTVDAVE collected $2.55 from pot
DTDTVDAVE: doesn't show hand
*** SUMMARY ***
Total pot $2.68 | Rake $0.13
Board [Qh 9d 5c]
Seat 1: AgresiveOne (button) folded on the Flop
Seat 2: DTDTVDAVE (small blind) collected ($2.55)
Seat 3: bfelixs (big blind) folded before Flop
Seat 4: tapouttazz9 folded before Flop (didn't bet)
Seat 6: Any2WillDo56 folded on the Flop


PokerStars Hand #150675084761:  Hold'em No Limit ($0.05/$0.10 USD) - 2016/03/29 16:02:12 ET
Table 'Corvus' 6-max Seat #2 is the button
Seat 1: AgresiveOne ($4.55 in chips)
Seat 2: DTDTVDAVE ($24.68 in chips)
Seat 3: bfelixs ($10 in chips)
Seat 4: tapouttazz9 ($9.30 in chips)
Seat 6: Any2WillDo56 ($10.23 in chips)
bfelixs: posts small blind $0.05
tapouttazz9: posts big blind $0.10
*** HOLE CARDS ***
Dealt to tapouttazz9 [9h 6s]
Any2WillDo56: folds
AgresiveOne: folds
DTDTVDAVE: folds
bfelixs: folds
Uncalled bet ($0.05) returned to tapouttazz9
tapouttazz9 collected $0.10 from pot
tapouttazz9: doesn't show hand
*** SUMMARY ***
Total pot $0.10 | Rake $0
Seat 1: AgresiveOne folded before Flop (didn't bet)
Seat 2: DTDTVDAVE (button) folded before Flop (didn't bet)
Seat 3: bfelixs (small blind) folded before Flop
Seat 4: tapouttazz9 (big blind) collected ($0.10)
Seat 6: Any2WillDo56 folded before Flop (didn't bet)


PokerStars Hand #150675084817:  Hold'em No Limit ($0.05/$0.10 USD) - 2016/03/29 16:02:29 ET
Table 'Corvus' 6-max Seat #3 is the button
Seat 1: AgresiveOne ($10 in chips)
Seat 2: DTDTVDAVE ($24.68 in chips)
Seat 3: bfelixs ($10 in chips)
Seat 4: tapouttazz9 ($9.35 in chips)
Seat 6: Any2WillDo56 ($10.23 in chips)
tapouttazz9: posts small blind $0.05
Any2WillDo56: posts big blind $0.10
*** HOLE CARDS ***
Dealt to tapouttazz9 [9h 8d]
AgresiveOne: folds
balon-nj246 joins the table at seat #5
DTDTVDAVE: raises $0.15 to $0.25
bfelixs: folds
tapouttazz9: folds
Any2WillDo56: raises $0.15 to $0.40
DTDTVDAVE: calls $0.15
*** FLOP *** [Qc Tc 2h]
Any2WillDo56: checks
DTDTVDAVE: checks
*** TURN *** [Qc Tc 2h] [4c]
Any2WillDo56: bets $0.81
DTDTVDAVE: calls $0.81
*** RIVER *** [Qc Tc 2h 4c] [4h]
Any2WillDo56: bets $2.35
DTDTVDAVE: folds
Uncalled bet ($2.35) returned to Any2WillDo56
Any2WillDo56 collected $2.35 from pot
Any2WillDo56: doesn't show hand
*** SUMMARY ***
Total pot $2.47 | Rake $0.12
Board [Qc Tc 2h 4c 4h]
Seat 1: AgresiveOne folded before Flop (didn't bet)
Seat 2: DTDTVDAVE folded on the River
Seat 3: bfelixs (button) folded before Flop (didn't bet)
Seat 4: tapouttazz9 (small blind) folded before Flop
Seat 6: Any2WillDo56 (big blind) collected ($2.35)


PokerStars Hand #150675084955:  Hold'em No Limit ($0.05/$0.10 USD) - 2016/03/29 16:03:10 ET
Table 'Corvus' 6-max Seat #4 is the button
Seat 1: AgresiveOne ($10 in chips)
Seat 2: DTDTVDAVE ($23.47 in chips)
Seat 3: bfelixs ($10 in chips)
Seat 4: tapouttazz9 ($9.30 in chips)
Seat 6: Any2WillDo56 ($11.37 in chips)
balon-nj246 will be allowed to play after the button
Any2WillDo56: posts small blind $0.05
AgresiveOne: posts big blind $0.10
*** HOLE CARDS ***
Dealt to tapouttazz9 [8d 7h]
DTDTVDAVE: folds
bfelixs: folds
tapouttazz9: folds
Any2WillDo56: folds
Uncalled bet ($0.05) returned to AgresiveOne
AgresiveOne collected $0.10 from pot
AgresiveOne: doesn't show hand
*** SUMMARY ***
Total pot $0.10 | Rake $0
Seat 1: AgresiveOne (big blind) collected ($0.10)
Seat 2: DTDTVDAVE folded before Flop (didn't bet)
Seat 3: bfelixs folded before Flop (didn't bet)
Seat 4: tapouttazz9 (button) folded before Flop (didn't bet)
Seat 6: Any2WillDo56 (small blind) folded before Flop


PokerStars Hand #150675084981:  Hold'em No Limit ($0.05/$0.10 USD) - 2016/03/29 16:03:19 ET
Table 'Corvus' 6-max Seat #6 is the button
Seat 1: AgresiveOne ($10.05 in chips)
Seat 2: DTDTVDAVE ($23.47 in chips)
Seat 3: bfelixs ($10 in chips)
Seat 4: tapouttazz9 ($9.30 in chips)
Seat 6: Any2WillDo56 ($11.32 in chips)
AgresiveOne: posts small blind $0.05
DTDTVDAVE: posts big blind $0.10
balon-nj246: sits out
*** HOLE CARDS ***
Dealt to tapouttazz9 [5c Ks]
bfelixs: folds
tapouttazz9: folds
Any2WillDo56: folds
AgresiveOne: folds
Uncalled bet ($0.05) returned to DTDTVDAVE
DTDTVDAVE collected $0.10 from pot
DTDTVDAVE: doesn't show hand
*** SUMMARY ***
Total pot $0.10 | Rake $0
Seat 1: AgresiveOne (small blind) folded before Flop
Seat 2: DTDTVDAVE (big blind) collected ($0.10)
Seat 3: bfelixs folded before Flop (didn't bet)
Seat 4: tapouttazz9 folded before Flop (didn't bet)
Seat 6: Any2WillDo56 (button) folded before Flop (didn't bet)


PokerStars Hand #150675085020:  Hold'em No Limit ($0.05/$0.10 USD) - 2016/03/29 16:03:26 ET
Table 'Corvus' 6-max Seat #1 is the button
Seat 1: AgresiveOne ($10 in chips)
Seat 2: DTDTVDAVE ($23.52 in chips)
Seat 3: bfelixs ($10 in chips)
Seat 4: tapouttazz9 ($9.30 in chips)
Seat 6: Any2WillDo56 ($11.32 in chips)
DTDTVDAVE: posts small blind $0.05
bfelixs: posts big blind $0.10
balon-nj246: sits out
*** HOLE CARDS ***
Dealt to tapouttazz9 [Qd 6h]
tapouttazz9: folds
Any2WillDo56: raises $0.10 to $0.20
AgresiveOne: folds
DTDTVDAVE: calls $0.15
bfelixs: folds
*** FLOP *** [8d 4h 2c]
DTDTVDAVE: checks
Any2WillDo56: bets $0.24
DTDTVDAVE: calls $0.24
*** TURN *** [8d 4h 2c] [5c]
DTDTVDAVE: checks
Any2WillDo56: bets $0.93
DTDTVDAVE: folds
Uncalled bet ($0.93) returned to Any2WillDo56
Any2WillDo56 collected $0.93 from pot
Any2WillDo56: doesn't show hand
*** SUMMARY ***
Total pot $0.98 | Rake $0.05
Board [8d 4h 2c 5c]
Seat 1: AgresiveOne (button) folded before Flop (didn't bet)
Seat 2: DTDTVDAVE (small blind) folded on the Turn
Seat 3: bfelixs (big blind) folded before Flop
Seat 4: tapouttazz9 folded before Flop (didn't bet)
Seat 6: Any2WillDo56 collected ($0.93)


PokerStars Hand #150675085191:  Hold'em No Limit ($0.05/$0.10 USD) - 2016/03/29 16:04:13 ET
Table 'Corvus' 6-max Seat #2 is the button
Seat 1: AgresiveOne ($10 in chips)
Seat 2: DTDTVDAVE ($23.08 in chips)
Seat 3: bfelixs ($10 in chips)
Seat 4: tapouttazz9 ($9.30 in chips)
Seat 6: Any2WillDo56 ($11.81 in chips)
bfelixs: posts small blind $0.05
tapouttazz9: posts big blind $0.10
balon-nj246: sits out
*** HOLE CARDS ***
Dealt to tapouttazz9 [4s 8h]
Any2WillDo56: folds
AgresiveOne: raises $0.15 to $0.25
DTDTVDAVE: folds
bfelixs: folds
tapouttazz9: folds
Uncalled bet ($0.15) returned to AgresiveOne
AgresiveOne collected $0.25 from pot
AgresiveOne: doesn't show hand
*** SUMMARY ***
Total pot $0.25 | Rake $0
Seat 1: AgresiveOne collected ($0.25)
Seat 2: DTDTVDAVE (button) folded before Flop (didn't bet)
Seat 3: bfelixs (small blind) folded before Flop
Seat 4: tapouttazz9 (big blind) folded before Flop
Seat 6: Any2WillDo56 folded before Flop (didn't bet)


PokerStars Hand #150675085256:  Hold'em No Limit ($0.05/$0.10 USD) - 2016/03/29 16:04:28 ET
Table 'Corvus' 6-max Seat #3 is the button
Seat 1: AgresiveOne ($10.15 in chips)
Seat 2: DTDTVDAVE ($23.08 in chips)
Seat 3: bfelixs ($10 in chips)
Seat 4: tapouttazz9 ($9.20 in chips)
Seat 5: balon-nj246 ($4 in chips)
Seat 6: Any2WillDo56 ($11.81 in chips)
tapouttazz9: posts small blind $0.05
balon-nj246: posts big blind $0.10
*** HOLE CARDS ***
Dealt to tapouttazz9 [7c 5c]
Any2WillDo56: folds
AgresiveOne: folds
DTDTVDAVE: folds
bfelixs: folds
tapouttazz9: folds
Uncalled bet ($0.05) returned to balon-nj246
balon-nj246 collected $0.10 from pot
*** SUMMARY ***
Total pot $0.10 | Rake $0
Seat 1: AgresiveOne folded before Flop (didn't bet)
Seat 2: DTDTVDAVE folded before Flop (didn't bet)
Seat 3: bfelixs (button) folded before Flop (didn't bet)
Seat 4: tapouttazz9 (small blind) folded before Flop
Seat 5: balon-nj246 (big blind) collected ($0.10)
Seat 6: Any2WillDo56 folded before Flop (didn't bet)


PokerStars Hand #150675085309:  Hold'em No Limit ($0.05/$0.10 USD) - 2016/03/29 16:04:40 ET
Table 'Corvus' 6-max Seat #4 is the button
Seat 1: AgresiveOne ($10.15 in chips)
Seat 2: DTDTVDAVE ($23.08 in chips)
Seat 3: bfelixs ($10 in chips)
Seat 4: tapouttazz9 ($9.15 in chips)
Seat 5: balon-nj246 ($4.05 in chips)
Seat 6: Any2WillDo56 ($11.81 in chips)
balon-nj246: posts small blind $0.05
Any2WillDo56: posts big blind $0.10
*** HOLE CARDS ***
Dealt to tapouttazz9 [4h 8s]
AgresiveOne: folds
DTDTVDAVE: folds
bfelixs: folds
tapouttazz9: folds
balon-nj246: folds
Uncalled bet ($0.05) returned to Any2WillDo56
Any2WillDo56 collected $0.10 from pot
Any2WillDo56: doesn't show hand
*** SUMMARY ***
Total pot $0.10 | Rake $0
Seat 1: AgresiveOne folded before Flop (didn't bet)
Seat 2: DTDTVDAVE folded before Flop (didn't bet)
Seat 3: bfelixs folded before Flop (didn't bet)
Seat 4: tapouttazz9 (button) folded before Flop (didn't bet)
Seat 5: balon-nj246 (small blind) folded before Flop
Seat 6: Any2WillDo56 (big blind) collected ($0.10)


PokerStars Hand #150675085340:  Hold'em No Limit ($0.05/$0.10 USD) - 2016/03/29 16:04:48 ET
Table 'Corvus' 6-max Seat #5 is the button
Seat 1: AgresiveOne ($10.15 in chips)
Seat 2: DTDTVDAVE ($23.08 in chips)
Seat 3: bfelixs ($10 in chips)
Seat 4: tapouttazz9 ($9.15 in chips)
Seat 5: balon-nj246 ($4 in chips)
Seat 6: Any2WillDo56 ($11.86 in chips)
Any2WillDo56: posts small blind $0.05
AgresiveOne: posts big blind $0.10
*** HOLE CARDS ***
Dealt to tapouttazz9 [Ts 6c]
DTDTVDAVE: folds
bfelixs: folds
tapouttazz9: folds
balon-nj246: folds
Any2WillDo56: raises $0.10 to $0.20
AgresiveOne: calls $0.10
*** FLOP *** [Qd 4h Qh]
Any2WillDo56: bets $0.38
AgresiveOne: calls $0.38
*** TURN *** [Qd 4h Qh] [5h]
Any2WillDo56: bets $1.10
AgresiveOne: folds
Uncalled bet ($1.10) returned to Any2WillDo56
Any2WillDo56 collected $1.10 from pot
Any2WillDo56: doesn't show hand
*** SUMMARY ***
Total pot $1.16 | Rake $0.06
Board [Qd 4h Qh 5h]
Seat 1: AgresiveOne (big blind) folded on the Turn
Seat 2: DTDTVDAVE folded before Flop (didn't bet)
Seat 3: bfelixs folded before Flop (didn't bet)
Seat 4: tapouttazz9 folded before Flop (didn't bet)
Seat 5: balon-nj246 (button) folded before Flop (didn't bet)
Seat 6: Any2WillDo56 (small blind) collected ($1.10)


PokerStars Hand #150675085455:  Hold'em No Limit ($0.05/$0.10 USD) - 2016/03/29 16:05:19 ET
Table 'Corvus' 6-max Seat #6 is the button
Seat 1: AgresiveOne ($9.57 in chips)
Seat 2: DTDTVDAVE ($23.08 in chips)
Seat 3: bfelixs ($10 in chips)
Seat 4: tapouttazz9 ($9.15 in chips)
Seat 5: balon-nj246 ($4 in chips)
Seat 6: Any2WillDo56 ($12.38 in chips)
AgresiveOne: posts small blind $0.05
DTDTVDAVE: posts big blind $0.10
*** HOLE CARDS ***
Dealt to tapouttazz9 [5c 9c]
bfelixs: folds
tapouttazz9: folds
balon-nj246: raises $0.20 to $0.30
Any2WillDo56: raises $0.75 to $1.05
AgresiveOne: folds
DTDTVDAVE: folds
balon-nj246: calls $0.75
*** FLOP *** [Ac 5d Jc]
balon-nj246: checks
Any2WillDo56: checks
*** TURN *** [Ac 5d Jc] [As]
balon-nj246: bets $2.95 and is all-in
Any2WillDo56: calls $2.95
*** RIVER *** [Ac 5d Jc As] [Td]
*** SHOW DOWN ***
balon-nj246: shows [6s 6c] (two pair, Aces and Sixes)
Any2WillDo56: shows [Qs Qc] (two pair, Aces and Queens)
Any2WillDo56 collected $7.74 from pot
*** SUMMARY ***
Total pot $8.15 | Rake $0.41
Board [Ac 5d Jc As Td]
Seat 1: AgresiveOne (small blind) folded before Flop
Seat 2: DTDTVDAVE (big blind) folded before Flop
Seat 3: bfelixs folded before Flop (didn't bet)
Seat 4: tapouttazz9 folded before Flop (didn't bet)
Seat 5: balon-nj246 showed [6s 6c] and lost with two pair, Aces and Sixes
Seat 6: Any2WillDo56 (button) showed [Qs Qc] and won ($7.74) with two pair, Aces and Queens


PokerStars Hand #150675085592:  Hold'em No Limit ($0.05/$0.10 USD) - 2016/03/29 16:05:56 ET
Table 'Corvus' 6-max Seat #1 is the button
Seat 1: AgresiveOne ($9.52 in chips)
Seat 2: DTDTVDAVE ($22.98 in chips)
Seat 3: bfelixs ($10 in chips)
Seat 4: tapouttazz9 ($9.15 in chips)
Seat 6: Any2WillDo56 ($16.12 in chips)
DTDTVDAVE: posts small blind $0.05
bfelixs: posts big blind $0.10
*** HOLE CARDS ***
Dealt to tapouttazz9 [3h 8d]
tapouttazz9: folds
Any2WillDo56: folds
AgresiveOne: folds
DTDTVDAVE: raises $0.20 to $0.30
bfelixs: calls $0.20
*** FLOP *** [6s 9c 4c]
Any2WillDo56 leaves the table
DTDTVDAVE: checks
bfelixs: bets $0.29
DTDTVDAVE: folds
Uncalled bet ($0.29) returned to bfelixs
bfelixs collected $0.57 from pot
bfelixs: doesn't show hand
*** SUMMARY ***
Total pot $0.60 | Rake $0.03
Board [6s 9c 4c]
Seat 1: AgresiveOne (button) folded before Flop (didn't bet)
Seat 2: DTDTVDAVE (small blind) folded on the Flop
Seat 3: bfelixs (big blind) collected ($0.57)
Seat 4: tapouttazz9 folded before Flop (didn't bet)
Seat 6: Any2WillDo56 folded before Flop (didn't bet)


PokerStars Hand #150675085688:  Hold'em No Limit ($0.05/$0.10 USD) - 2016/03/29 16:06:19 ET
Table 'Corvus' 6-max Seat #2 is the button
Seat 1: AgresiveOne ($9.52 in chips)
Seat 2: DTDTVDAVE ($22.68 in chips)
Seat 3: bfelixs ($10.27 in chips)
Seat 4: tapouttazz9 ($9.15 in chips)
Seat 5: balon-nj246 ($4 in chips)
bfelixs: posts small blind $0.05
tapouttazz9: posts big blind $0.10
*** HOLE CARDS ***
Dealt to tapouttazz9 [3s 6c]
nickyblinds joins the table at seat #6
balon-nj246: folds
AgresiveOne: folds
DTDTVDAVE: raises $0.15 to $0.25
bfelixs: raises $0.55 to $0.80
tapouttazz9: folds
DTDTVDAVE: folds
Uncalled bet ($0.55) returned to bfelixs
bfelixs collected $0.60 from pot
bfelixs: doesn't show hand
*** SUMMARY ***
Total pot $0.60 | Rake $0
Seat 1: AgresiveOne folded before Flop (didn't bet)
Seat 2: DTDTVDAVE (button) folded before Flop
Seat 3: bfelixs (small blind) collected ($0.60)
Seat 4: tapouttazz9 (big blind) folded before Flop
Seat 5: balon-nj246 folded before Flop (didn't bet)


PokerStars Hand #150675085792:  Hold'em No Limit ($0.05/$0.10 USD) - 2016/03/29 16:06:45 ET
Table 'Corvus' 6-max Seat #3 is the button
Seat 1: AgresiveOne ($9.52 in chips)
Seat 2: DTDTVDAVE ($22.43 in chips)
Seat 3: bfelixs ($10.62 in chips)
Seat 4: tapouttazz9 ($9.05 in chips)
Seat 5: balon-nj246 ($4 in chips)
tapouttazz9: posts small blind $0.05
balon-nj246: posts big blind $0.10
nickyblinds: sits out
*** HOLE CARDS ***
Dealt to tapouttazz9 [Kh Td]
AgresiveOne: folds
DTDTVDAVE: raises $0.15 to $0.25
bfelixs: folds
tapouttazz9: folds
balon-nj246: folds
Uncalled bet ($0.15) returned to DTDTVDAVE
DTDTVDAVE collected $0.25 from pot
DTDTVDAVE: doesn't show hand
*** SUMMARY ***
Total pot $0.25 | Rake $0
Seat 1: AgresiveOne folded before Flop (didn't bet)
Seat 2: DTDTVDAVE collected ($0.25)
Seat 3: bfelixs (button) folded before Flop (didn't bet)
Seat 4: tapouttazz9 (small blind) folded before Flop
Seat 5: balon-nj246 (big blind) folded before Flop


PokerStars Hand #150675085905:  Hold'em No Limit ($0.05/$0.10 USD) - 2016/03/29 16:07:13 ET
Table 'Corvus' 6-max Seat #4 is the button
Seat 1: AgresiveOne ($9.52 in chips)
Seat 2: DTDTVDAVE ($22.58 in chips)
Seat 3: bfelixs ($10.62 in chips)
Seat 4: tapouttazz9 ($9 in chips)
Seat 5: balon-nj246 ($3.90 in chips)
Seat 6: nickyblinds ($10 in chips)
balon-nj246: posts small blind $0.05
nickyblinds: posts big blind $0.10
*** HOLE CARDS ***
Dealt to tapouttazz9 [5d 8c]
AgresiveOne: folds
DTDTVDAVE: folds
bfelixs: folds
tapouttazz9: folds
balon-nj246: calls $0.05
nickyblinds: raises $0.20 to $0.30
balon-nj246: calls $0.20
*** FLOP *** [Jh 2h 2s]
balon-nj246: checks
nickyblinds: bets $0.37
balon-nj246: folds
Uncalled bet ($0.37) returned to nickyblinds
nickyblinds collected $0.57 from pot
nickyblinds: doesn't show hand
*** SUMMARY ***
Total pot $0.60 | Rake $0.03
Board [Jh 2h 2s]
Seat 1: AgresiveOne folded before Flop (didn't bet)
Seat 2: DTDTVDAVE folded before Flop (didn't bet)
Seat 3: bfelixs folded before Flop (didn't bet)
Seat 4: tapouttazz9 (button) folded before Flop (didn't bet)
Seat 5: balon-nj246 (small blind) folded on the Flop
Seat 6: nickyblinds (big blind) collected ($0.57)


PokerStars Hand #150675086006:  Hold'em No Limit ($0.05/$0.10 USD) - 2016/03/29 16:07:35 ET
Table 'Corvus' 6-max Seat #5 is the button
Seat 1: AgresiveOne ($9.52 in chips)
Seat 2: DTDTVDAVE ($22.58 in chips)
Seat 3: bfelixs ($10.62 in chips)
Seat 4: tapouttazz9 ($9 in chips)
Seat 5: balon-nj246 ($3.60 in chips)
Seat 6: nickyblinds ($10.27 in chips)
nickyblinds: posts small blind $0.05
AgresiveOne: posts big blind $0.10
*** HOLE CARDS ***
Dealt to tapouttazz9 [7h Ac]
DTDTVDAVE: folds
bfelixs: folds
tapouttazz9: folds
balon-nj246: raises $0.25 to $0.35
nickyblinds: raises $0.80 to $1.15
AgresiveOne: folds
balon-nj246: calls $0.80
*** FLOP *** [7d 5c Js]
nickyblinds: bets $1
balon-nj246: calls $1
*** TURN *** [7d 5c Js] [6h]
nickyblinds: bets $4.18
balon-nj246: calls $1.45 and is all-in
Uncalled bet ($2.73) returned to nickyblinds
*** RIVER *** [7d 5c Js 6h] [Qd]
*** SHOW DOWN ***
nickyblinds: shows [Kd 8d] (high card King)
balon-nj246: shows [9d 6d] (a pair of Sixes)
balon-nj246 collected $6.94 from pot
*** SUMMARY ***
Total pot $7.30 | Rake $0.36
Board [7d 5c Js 6h Qd]
Seat 1: AgresiveOne (big blind) folded before Flop
Seat 2: DTDTVDAVE folded before Flop (didn't bet)
Seat 3: bfelixs folded before Flop (didn't bet)
Seat 4: tapouttazz9 folded before Flop (didn't bet)
Seat 5: balon-nj246 (button) showed [9d 6d] and won ($6.94) with a pair of Sixes
Seat 6: nickyblinds (small blind) showed [Kd 8d] and lost with high card King


PokerStars Hand #150675086200:  Hold'em No Limit ($0.05/$0.10 USD) - 2016/03/29 16:08:24 ET
Table 'Corvus' 6-max Seat #6 is the button
Seat 1: AgresiveOne ($9.42 in chips)
Seat 2: DTDTVDAVE ($22.58 in chips)
Seat 3: bfelixs ($10.62 in chips)
Seat 4: tapouttazz9 ($9 in chips)
Seat 5: balon-nj246 ($6.94 in chips)
Seat 6: nickyblinds ($10 in chips)
AgresiveOne: posts small blind $0.05
DTDTVDAVE: posts big blind $0.10
*** HOLE CARDS ***
Dealt to tapouttazz9 [4s 6d]
bfelixs: folds
tapouttazz9: folds
balon-nj246: calls $0.10
nickyblinds: folds
AgresiveOne: folds
DTDTVDAVE: raises $0.30 to $0.40
balon-nj246: calls $0.30
*** FLOP *** [Ts 6c 2s]
DTDTVDAVE: bets $0.55
balon-nj246: folds
Uncalled bet ($0.55) returned to DTDTVDAVE
DTDTVDAVE collected $0.81 from pot
DTDTVDAVE: doesn't show hand
*** SUMMARY ***
Total pot $0.85 | Rake $0.04
Board [Ts 6c 2s]
Seat 1: AgresiveOne (small blind) folded before Flop
Seat 2: DTDTVDAVE (big blind) collected ($0.81)
Seat 3: bfelixs folded before Flop (didn't bet)
Seat 4: tapouttazz9 folded before Flop (didn't bet)
Seat 5: balon-nj246 folded on the Flop
Seat 6: nickyblinds (button) folded before Flop (didn't bet)


PokerStars Hand #150675086287:  Hold'em No Limit ($0.05/$0.10 USD) - 2016/03/29 16:08:51 ET
Table 'Corvus' 6-max Seat #1 is the button
Seat 1: AgresiveOne ($9.37 in chips)
Seat 2: DTDTVDAVE ($22.99 in chips)
Seat 3: bfelixs ($10.62 in chips)
Seat 4: tapouttazz9 ($9 in chips)
Seat 5: balon-nj246 ($6.54 in chips)
Seat 6: nickyblinds ($10 in chips)
DTDTVDAVE: posts small blind $0.05
bfelixs: posts big blind $0.10
*** HOLE CARDS ***
Dealt to tapouttazz9 [Td Tc]
tapouttazz9: raises $0.20 to $0.30
balon-nj246: folds
nickyblinds: folds
AgresiveOne: calls $0.30
DTDTVDAVE: folds
bfelixs: calls $0.20
*** FLOP *** [Jc 4s Jd]
bfelixs: checks
tapouttazz9: bets $0.67
AgresiveOne: folds
bfelixs: calls $0.67
*** TURN *** [Jc 4s Jd] [As]
bfelixs: checks
tapouttazz9: bets $1.09
bfelixs: raises $1.66 to $2.75
tapouttazz9: folds
Uncalled bet ($1.66) returned to bfelixs
bfelixs collected $4.25 from pot
bfelixs: doesn't show hand
*** SUMMARY ***
Total pot $4.47 | Rake $0.22
Board [Jc 4s Jd As]
Seat 1: AgresiveOne (button) folded on the Flop
Seat 2: DTDTVDAVE (small blind) folded before Flop
Seat 3: bfelixs (big blind) collected ($4.25)
Seat 4: tapouttazz9 folded on the Turn
Seat 5: balon-nj246 folded before Flop (didn't bet)
Seat 6: nickyblinds folded before Flop (didn't bet)


PokerStars Hand #150675086572:  Hold'em No Limit ($0.05/$0.10 USD) - 2016/03/29 16:10:06 ET
Table 'Corvus' 6-max Seat #2 is the button
Seat 1: AgresiveOne ($9.07 in chips)
Seat 2: DTDTVDAVE ($22.94 in chips)
Seat 3: bfelixs ($12.81 in chips)
Seat 4: tapouttazz9 ($6.94 in chips)
Seat 5: balon-nj246 ($6.54 in chips)
Seat 6: nickyblinds ($10 in chips)
bfelixs: posts small blind $0.05
tapouttazz9: posts big blind $0.10
*** HOLE CARDS ***
Dealt to tapouttazz9 [7c 9d]
balon-nj246: folds
nickyblinds: folds
AgresiveOne: folds
DTDTVDAVE: raises $0.15 to $0.25
bfelixs: folds
tapouttazz9: folds
Uncalled bet ($0.15) returned to DTDTVDAVE
DTDTVDAVE collected $0.25 from pot
DTDTVDAVE: doesn't show hand
*** SUMMARY ***
Total pot $0.25 | Rake $0
Seat 1: AgresiveOne folded before Flop (didn't bet)
Seat 2: DTDTVDAVE (button) collected ($0.25)
Seat 3: bfelixs (small blind) folded before Flop
Seat 4: tapouttazz9 (big blind) folded before Flop
Seat 5: balon-nj246 folded before Flop (didn't bet)
Seat 6: nickyblinds folded before Flop (didn't bet)


PokerStars Hand #150675086629:  Hold'em No Limit ($0.05/$0.10 USD) - 2016/03/29 16:10:21 ET
Table 'Corvus' 6-max Seat #3 is the button
Seat 1: AgresiveOne ($9.07 in chips)
Seat 2: DTDTVDAVE ($23.09 in chips)
Seat 3: bfelixs ($12.76 in chips)
Seat 4: tapouttazz9 ($9.90 in chips)
Seat 5: balon-nj246 ($6.54 in chips)
Seat 6: nickyblinds ($10 in chips)
tapouttazz9: posts small blind $0.05
balon-nj246: posts big blind $0.10
*** HOLE CARDS ***
Dealt to tapouttazz9 [Ad Ts]
nickyblinds: folds
AgresiveOne: folds
DTDTVDAVE: raises $0.15 to $0.25
bfelixs: calls $0.25
tapouttazz9: calls $0.20
balon-nj246: calls $0.15
*** FLOP *** [Ac 7c 3c]
tapouttazz9: bets $0.95
balon-nj246: folds
DTDTVDAVE: folds
bfelixs: folds
Uncalled bet ($0.95) returned to tapouttazz9
tapouttazz9 collected $0.95 from pot
tapouttazz9: doesn't show hand
*** SUMMARY ***
Total pot $1 | Rake $0.05
Board [Ac 7c 3c]
Seat 1: AgresiveOne folded before Flop (didn't bet)
Seat 2: DTDTVDAVE folded on the Flop
Seat 3: bfelixs (button) folded on the Flop
Seat 4: tapouttazz9 (small blind) collected ($0.95)
Seat 5: balon-nj246 (big blind) folded on the Flop
Seat 6: nickyblinds folded before Flop (didn't bet)


PokerStars Hand #150675086750:  Hold'em No Limit ($0.05/$0.10 USD) - 2016/03/29 16:10:51 ET
Table 'Corvus' 6-max Seat #4 is the button
Seat 1: AgresiveOne ($9.07 in chips)
Seat 2: DTDTVDAVE ($22.84 in chips)
Seat 3: bfelixs ($12.51 in chips)
Seat 4: tapouttazz9 ($10.60 in chips)
Seat 5: balon-nj246 ($6.29 in chips)
Seat 6: nickyblinds ($10 in chips)
balon-nj246: posts small blind $0.05
nickyblinds: posts big blind $0.10
*** HOLE CARDS ***
Dealt to tapouttazz9 [Ts 6s]
AgresiveOne: folds
DTDTVDAVE: folds
bfelixs: folds
tapouttazz9: folds
balon-nj246: folds
Uncalled bet ($0.05) returned to nickyblinds
nickyblinds collected $0.10 from pot
nickyblinds: doesn't show hand
*** SUMMARY ***
Total pot $0.10 | Rake $0
Seat 1: AgresiveOne folded before Flop (didn't bet)
Seat 2: DTDTVDAVE folded before Flop (didn't bet)
Seat 3: bfelixs folded before Flop (didn't bet)
Seat 4: tapouttazz9 (button) folded before Flop (didn't bet)
Seat 5: balon-nj246 (small blind) folded before Flop
Seat 6: nickyblinds (big blind) collected ($0.10)


PokerStars Hand #150675086811:  Hold'em No Limit ($0.05/$0.10 USD) - 2016/03/29 16:11:05 ET
Table 'Corvus' 6-max Seat #5 is the button
Seat 1: AgresiveOne ($9.07 in chips)
Seat 2: DTDTVDAVE ($22.84 in chips)
Seat 3: bfelixs ($12.51 in chips)
Seat 4: tapouttazz9 ($10.60 in chips)
Seat 5: balon-nj246 ($6.24 in chips)
Seat 6: nickyblinds ($10.05 in chips)
nickyblinds: posts small blind $0.05
AgresiveOne: posts big blind $0.10
*** HOLE CARDS ***
Dealt to tapouttazz9 [4h Jc]
DTDTVDAVE: folds
bfelixs: folds
tapouttazz9: folds
balon-nj246: folds
nickyblinds: folds
Uncalled bet ($0.05) returned to AgresiveOne
AgresiveOne collected $0.10 from pot
AgresiveOne: doesn't show hand
*** SUMMARY ***
Total pot $0.10 | Rake $0
Seat 1: AgresiveOne (big blind) collected ($0.10)
Seat 2: DTDTVDAVE folded before Flop (didn't bet)
Seat 3: bfelixs folded before Flop (didn't bet)
Seat 4: tapouttazz9 folded before Flop (didn't bet)
Seat 5: balon-nj246 (button) folded before Flop (didn't bet)
Seat 6: nickyblinds (small blind) folded before Flop


PokerStars Hand #150675086854:  Hold'em No Limit ($0.05/$0.10 USD) - 2016/03/29 16:11:17 ET
Table 'Corvus' 6-max Seat #6 is the button
Seat 1: AgresiveOne ($9.12 in chips)
Seat 2: DTDTVDAVE ($22.84 in chips)
Seat 3: bfelixs ($12.51 in chips)
Seat 4: tapouttazz9 ($10.60 in chips)
Seat 5: balon-nj246 ($6.24 in chips)
Seat 6: nickyblinds ($10 in chips)
AgresiveOne: posts small blind $0.05
DTDTVDAVE: posts big blind $0.10
*** HOLE CARDS ***
Dealt to tapouttazz9 [2h 7s]
bfelixs: folds
tapouttazz9: folds
balon-nj246: folds
nickyblinds: raises $0.15 to $0.25
AgresiveOne: raises $0.60 to $0.85
DTDTVDAVE: folds
nickyblinds: calls $0.60
*** FLOP *** [9s 5h As]
AgresiveOne: bets $0.85
nickyblinds: calls $0.85
*** TURN *** [9s 5h As] [9h]
AgresiveOne: checks
nickyblinds: bets $2.21
AgresiveOne: folds
Uncalled bet ($2.21) returned to nickyblinds
nickyblinds collected $3.32 from pot
nickyblinds: doesn't show hand
*** SUMMARY ***
Total pot $3.50 | Rake $0.18
Board [9s 5h As 9h]
Seat 1: AgresiveOne (small blind) folded on the Turn
Seat 2: DTDTVDAVE (big blind) folded before Flop
Seat 3: bfelixs folded before Flop (didn't bet)
Seat 4: tapouttazz9 folded before Flop (didn't bet)
Seat 5: balon-nj246 folded before Flop (didn't bet)
Seat 6: nickyblinds (button) collected ($3.32)


PokerStars Hand #150675086979:  Hold'em No Limit ($0.05/$0.10 USD) - 2016/03/29 16:11:47 ET
Table 'Corvus' 6-max Seat #1 is the button
Seat 1: AgresiveOne ($7.42 in chips)
Seat 2: DTDTVDAVE ($22.74 in chips)
Seat 3: bfelixs ($12.51 in chips)
Seat 4: tapouttazz9 ($10.60 in chips)
Seat 5: balon-nj246 ($6.24 in chips)
Seat 6: nickyblinds ($11.62 in chips)
DTDTVDAVE: posts small blind $0.05
bfelixs: posts big blind $0.10
*** HOLE CARDS ***
Dealt to tapouttazz9 [Ac Jc]
tapouttazz9: raises $0.10 to $0.20
balon-nj246: calls $0.20
nickyblinds: folds
AgresiveOne: folds
DTDTVDAVE: folds
bfelixs: folds
*** FLOP *** [Kc 5s Jh]
tapouttazz9: checks
balon-nj246: checks
*** TURN *** [Kc 5s Jh] [3d]
tapouttazz9: bets $0.26
balon-nj246: folds
Uncalled bet ($0.26) returned to tapouttazz9
tapouttazz9 collected $0.52 from pot
tapouttazz9: doesn't show hand
*** SUMMARY ***
Total pot $0.55 | Rake $0.03
Board [Kc 5s Jh 3d]
Seat 1: AgresiveOne (button) folded before Flop (didn't bet)
Seat 2: DTDTVDAVE (small blind) folded before Flop
Seat 3: bfelixs (big blind) folded before Flop
Seat 4: tapouttazz9 collected ($0.52)
Seat 5: balon-nj246 folded on the Turn
Seat 6: nickyblinds folded before Flop (didn't bet)


PokerStars Hand #150675087068:  Hold'em No Limit ($0.05/$0.10 USD) - 2016/03/29 16:12:10 ET
Table 'Corvus' 6-max Seat #2 is the button
Seat 1: AgresiveOne ($7.42 in chips)
Seat 2: DTDTVDAVE ($22.69 in chips)
Seat 3: bfelixs ($12.41 in chips)
Seat 4: tapouttazz9 ($10.92 in chips)
Seat 5: balon-nj246 ($6.04 in chips)
Seat 6: nickyblinds ($11.62 in chips)
bfelixs: posts small blind $0.05
tapouttazz9: posts big blind $0.10
*** HOLE CARDS ***
Dealt to tapouttazz9 [4d 8s]
balon-nj246: raises $0.20 to $0.30
nickyblinds: folds
AgresiveOne: calls $0.30
DTDTVDAVE: folds
bfelixs: folds
tapouttazz9: folds
*** FLOP *** [2h 9s 5d]
balon-nj246: bets $0.35
AgresiveOne: calls $0.35
*** TURN *** [2h 9s 5d] [Js]
balon-nj246: checks
AgresiveOne: checks
*** RIVER *** [2h 9s 5d Js] [8d]
balon-nj246: checks
AgresiveOne: bets $0.69
balon-nj246: calls $0.69
*** SHOW DOWN ***
AgresiveOne: shows [3h 4h] (high card Jack)
balon-nj246: shows [3s 3c] (a pair of Threes)
balon-nj246 collected $2.69 from pot
*** SUMMARY ***
Total pot $2.83 | Rake $0.14
Board [2h 9s 5d Js 8d]
Seat 1: AgresiveOne showed [3h 4h] and lost with high card Jack
Seat 2: DTDTVDAVE (button) folded before Flop (didn't bet)
Seat 3: bfelixs (small blind) folded before Flop
Seat 4: tapouttazz9 (big blind) folded before Flop
Seat 5: balon-nj246 showed [3s 3c] and won ($2.69) with a pair of Threes
Seat 6: nickyblinds folded before Flop (didn't bet)


PokerStars Hand #150675087225:  Hold'em No Limit ($0.05/$0.10 USD) - 2016/03/29 16:12:48 ET
Table 'Corvus' 6-max Seat #3 is the button
Seat 1: AgresiveOne ($6.08 in chips)
Seat 2: DTDTVDAVE ($22.69 in chips)
Seat 3: bfelixs ($12.36 in chips)
Seat 4: tapouttazz9 ($10.82 in chips)
Seat 5: balon-nj246 ($7.39 in chips)
Seat 6: nickyblinds ($11.62 in chips)
tapouttazz9: posts small blind $0.05
balon-nj246: posts big blind $0.10
*** HOLE CARDS ***
Dealt to tapouttazz9 [Jd 8c]
nickyblinds: folds
AgresiveOne: folds
DTDTVDAVE: raises $0.15 to $0.25
bfelixs: folds
tapouttazz9: folds
balon-nj246: calls $0.15
*** FLOP *** [Ac 9c 4c]
balon-nj246: checks
DTDTVDAVE: bets $0.35
balon-nj246: folds
Uncalled bet ($0.35) returned to DTDTVDAVE
DTDTVDAVE collected $0.52 from pot
DTDTVDAVE: doesn't show hand
*** SUMMARY ***
Total pot $0.55 | Rake $0.03
Board [Ac 9c 4c]
Seat 1: AgresiveOne folded before Flop (didn't bet)
Seat 2: DTDTVDAVE collected ($0.52)
Seat 3: bfelixs (button) folded before Flop (didn't bet)
Seat 4: tapouttazz9 (small blind) folded before Flop
Seat 5: balon-nj246 (big blind) folded on the Flop
Seat 6: nickyblinds folded before Flop (didn't bet)


PokerStars Hand #150675087293:  Hold'em No Limit ($0.05/$0.10 USD) - 2016/03/29 16:13:08 ET
Table 'Corvus' 6-max Seat #4 is the button
Seat 1: AgresiveOne ($6.08 in chips)
Seat 2: DTDTVDAVE ($22.96 in chips)
Seat 3: bfelixs ($12.36 in chips)
Seat 4: tapouttazz9 ($10.77 in chips)
Seat 5: balon-nj246 ($7.14 in chips)
Seat 6: nickyblinds ($11.62 in chips)
balon-nj246: posts small blind $0.05
nickyblinds: posts big blind $0.10
*** HOLE CARDS ***
Dealt to tapouttazz9 [7c 6s]
AgresiveOne: folds
DTDTVDAVE: folds
bfelixs: raises $0.20 to $0.30
tapouttazz9: folds
balon-nj246: folds
nickyblinds: calls $0.20
*** FLOP *** [Ad Jc 4d]
nickyblinds: checks
bfelixs: checks
*** TURN *** [Ad Jc 4d] [Th]
nickyblinds: bets $0.41
bfelixs: calls $0.41
*** RIVER *** [Ad Jc 4d Th] [Ks]
nickyblinds: checks
bfelixs: checks
*** SHOW DOWN ***
nickyblinds: shows [Ts 7s] (a pair of Tens)
bfelixs: shows [Ac 6d] (a pair of Aces)
bfelixs collected $1.40 from pot
*** SUMMARY ***
Total pot $1.47 | Rake $0.07
Board [Ad Jc 4d Th Ks]
Seat 1: AgresiveOne folded before Flop (didn't bet)
Seat 2: DTDTVDAVE folded before Flop (didn't bet)
Seat 3: bfelixs showed [Ac 6d] and won ($1.40) with a pair of Aces
Seat 4: tapouttazz9 (button) folded before Flop (didn't bet)
Seat 5: balon-nj246 (small blind) folded before Flop
Seat 6: nickyblinds (big blind) showed [Ts 7s] and lost with a pair of Tens


PokerStars Hand #150675087474:  Hold'em No Limit ($0.05/$0.10 USD) - 2016/03/29 16:13:53 ET
Table 'Corvus' 6-max Seat #5 is the button
Seat 1: AgresiveOne ($6.08 in chips)
Seat 2: DTDTVDAVE ($22.96 in chips)
Seat 3: bfelixs ($13.05 in chips)
Seat 4: tapouttazz9 ($10.77 in chips)
Seat 5: balon-nj246 ($7.09 in chips)
Seat 6: nickyblinds ($10.91 in chips)
nickyblinds: posts small blind $0.05
AgresiveOne: posts big blind $0.10
*** HOLE CARDS ***
Dealt to tapouttazz9 [5s 3h]
DTDTVDAVE: folds
bfelixs: folds
tapouttazz9: folds
balon-nj246: folds
nickyblinds: raises $0.20 to $0.30
AgresiveOne: folds
Uncalled bet ($0.20) returned to nickyblinds
nickyblinds collected $0.20 from pot
nickyblinds: doesn't show hand
*** SUMMARY ***
Total pot $0.20 | Rake $0
Seat 1: AgresiveOne (big blind) folded before Flop
Seat 2: DTDTVDAVE folded before Flop (didn't bet)
Seat 3: bfelixs folded before Flop (didn't bet)
Seat 4: tapouttazz9 folded before Flop (didn't bet)
Seat 5: balon-nj246 (button) folded before Flop (didn't bet)
Seat 6: nickyblinds (small blind) collected ($0.20)


PokerStars Hand #150675087625:  Hold'em No Limit ($0.05/$0.10 USD) - 2016/03/29 16:14:33 ET
Table 'Corvus' 6-max Seat #6 is the button
Seat 1: AgresiveOne ($5.98 in chips)
Seat 2: DTDTVDAVE ($22.96 in chips)
Seat 3: bfelixs ($13.05 in chips)
Seat 4: tapouttazz9 ($10.77 in chips)
Seat 5: balon-nj246 ($7.09 in chips)
Seat 6: nickyblinds ($11.01 in chips)
AgresiveOne: posts small blind $0.05
DTDTVDAVE: posts big blind $0.10
*** HOLE CARDS ***
Dealt to tapouttazz9 [8h Th]
bfelixs: raises $0.20 to $0.30
tapouttazz9: folds
balon-nj246: calls $0.30
nickyblinds: calls $0.30
AgresiveOne: calls $0.25
DTDTVDAVE: calls $0.20
*** FLOP *** [7s 5s 4c]
AgresiveOne: checks
DTDTVDAVE: checks
bfelixs: bets $0.73
balon-nj246: calls $0.73
nickyblinds: folds
AgresiveOne: folds
DTDTVDAVE: folds
*** TURN *** [7s 5s 4c] [9c]
AgresiveOne leaves the table
bfelixs: checks
balon-nj246: checks
*** RIVER *** [7s 5s 4c 9c] [8d]
bfelixs: checks
balon-nj246: bets $1.40
bfelixs: folds
Uncalled bet ($1.40) returned to balon-nj246
balon-nj246 collected $2.81 from pot
*** SUMMARY ***
Total pot $2.96 | Rake $0.15
Board [7s 5s 4c 9c 8d]
Seat 1: AgresiveOne (small blind) folded on the Flop
Seat 2: DTDTVDAVE (big blind) folded on the Flop
Seat 3: bfelixs folded on the River
Seat 4: tapouttazz9 folded before Flop (didn't bet)
Seat 5: balon-nj246 collected ($2.81)
Seat 6: nickyblinds (button) folded on the Flop


PokerStars Hand #150675088001:  Hold'em No Limit ($0.05/$0.10 USD) - 2016/03/29 16:16:04 ET
Table 'Corvus' 6-max Seat #2 is the button
Seat 2: DTDTVDAVE ($22.66 in chips)
Seat 3: bfelixs ($12.02 in chips)
Seat 4: tapouttazz9 ($10.77 in chips)
Seat 5: balon-nj246 ($8.87 in chips)
Seat 6: nickyblinds ($10.71 in chips)
bfelixs: posts small blind $0.05
tapouttazz9: posts big blind $0.10
*** HOLE CARDS ***
Dealt to tapouttazz9 [4d Qh]
balon-nj246: calls $0.10
nickyblinds: folds
DTDTVDAVE: folds
bfelixs: folds
tapouttazz9: checks
*** FLOP *** [2h 3s 6s]
Deemino30 joins the table at seat #1
tapouttazz9: checks
balon-nj246: checks
*** TURN *** [2h 3s 6s] [Kc]
tapouttazz9: checks
balon-nj246: checks
*** RIVER *** [2h 3s 6s Kc] [6d]
tapouttazz9: checks
balon-nj246: checks
*** SHOW DOWN ***
tapouttazz9: shows [4d Qh] (a pair of Sixes)
balon-nj246: shows [Qd Td] (a pair of Sixes - King+Queen+Ten kicker)
balon-nj246 collected $0.24 from pot
*** SUMMARY ***
Total pot $0.25 | Rake $0.01
Board [2h 3s 6s Kc 6d]
Seat 2: DTDTVDAVE (button) folded before Flop (didn't bet)
Seat 3: bfelixs (small blind) folded before Flop
Seat 4: tapouttazz9 (big blind) showed [4d Qh] and lost with a pair of Sixes
Seat 5: balon-nj246 showed [Qd Td] and won ($0.24) with a pair of Sixes
Seat 6: nickyblinds folded before Flop (didn't bet)


PokerStars Hand #150675088112:  Hold'em No Limit ($0.05/$0.10 USD) - 2016/03/29 16:16:37 ET
Table 'Corvus' 6-max Seat #3 is the button
Seat 1: Deemino30 ($8 in chips)
Seat 2: DTDTVDAVE ($22.66 in chips)
Seat 3: bfelixs ($11.97 in chips)
Seat 4: tapouttazz9 ($10.67 in chips)
Seat 5: balon-nj246 ($9.01 in chips)
Seat 6: nickyblinds ($10.71 in chips)
tapouttazz9: posts small blind $0.05
balon-nj246: posts big blind $0.10
Deemino30: posts big blind $0.10
*** HOLE CARDS ***
Dealt to tapouttazz9 [3h 7s]
nickyblinds: folds
nickyblinds leaves the table
Deemino30: checks
DTDTVDAVE: folds
bfelixs: folds
tapouttazz9: folds
balon-nj246: checks
*** FLOP *** [6s 2s 8s]
balon-nj246: checks
Deemino30: checks
*** TURN *** [6s 2s 8s] [Ah]
balon-nj246: checks
Deemino30: checks
*** RIVER *** [6s 2s 8s Ah] [Ad]
balon-nj246: checks
Deemino30: checks
*** SHOW DOWN ***
balon-nj246: shows [5s Jc] (a pair of Aces)
Deemino30: shows [6c Td] (two pair, Aces and Sixes)
Deemino30 collected $0.24 from pot
*** SUMMARY ***
Total pot $0.25 | Rake $0.01
Board [6s 2s 8s Ah Ad]
Seat 1: Deemino30 showed [6c Td] and won ($0.24) with two pair, Aces and Sixes
Seat 2: DTDTVDAVE folded before Flop (didn't bet)
Seat 3: bfelixs (button) folded before Flop (didn't bet)
Seat 4: tapouttazz9 (small blind) folded before Flop
Seat 5: balon-nj246 (big blind) showed [5s Jc] and lost with a pair of Aces
Seat 6: nickyblinds folded before Flop (didn't bet)


PokerStars Hand #150675088289:  Hold'em No Limit ($0.05/$0.10 USD) - 2016/03/29 16:17:22 ET
Table 'Corvus' 6-max Seat #4 is the button
Seat 1: Deemino30 ($8.14 in chips)
Seat 2: DTDTVDAVE ($22.66 in chips)
Seat 3: bfelixs ($11.97 in chips)
Seat 4: tapouttazz9 ($10.62 in chips)
Seat 5: balon-nj246 ($8.91 in chips)
balon-nj246: posts small blind $0.05
Deemino30: posts big blind $0.10
*** HOLE CARDS ***
Dealt to tapouttazz9 [7d 8s]
DTDTVDAVE: folds
bfelixs: folds
tapouttazz9: folds
balon-nj246: calls $0.05
Deemino30: checks
*** FLOP *** [Ah 6s 4h]
balon-nj246: bets $0.10
Deemino30: folds
Uncalled bet ($0.10) returned to balon-nj246
balon-nj246 collected $0.19 from pot
*** SUMMARY ***
Total pot $0.20 | Rake $0.01
Board [Ah 6s 4h]
Seat 1: Deemino30 (big blind) folded on the Flop
Seat 2: DTDTVDAVE folded before Flop (didn't bet)
Seat 3: bfelixs folded before Flop (didn't bet)
Seat 4: tapouttazz9 (button) folded before Flop (didn't bet)
Seat 5: balon-nj246 (small blind) collected ($0.19)


PokerStars Hand #150675088401:  Hold'em No Limit ($0.05/$0.10 USD) - 2016/03/29 16:17:45 ET
Table 'Corvus' 6-max Seat #5 is the button
Seat 1: Deemino30 ($8.04 in chips)
Seat 2: DTDTVDAVE ($22.66 in chips)
Seat 3: bfelixs ($11.97 in chips)
Seat 4: tapouttazz9 ($10.62 in chips)
Seat 5: balon-nj246 ($9 in chips)
Deemino30: posts small blind $0.05
DTDTVDAVE: posts big blind $0.10
*** HOLE CARDS ***
Dealt to tapouttazz9 [3h 4s]
bfelixs: folds
tapouttazz9: folds
balon-nj246: folds
Deemino30: calls $0.05
DTDTVDAVE: raises $0.30 to $0.40
Deemino30: calls $0.30
*** FLOP *** [9d Js 7s]
Deemino30: checks
DTDTVDAVE: bets $0.55
Deemino30: folds
Uncalled bet ($0.55) returned to DTDTVDAVE
DTDTVDAVE collected $0.76 from pot
DTDTVDAVE: doesn't show hand
*** SUMMARY ***
Total pot $0.80 | Rake $0.04
Board [9d Js 7s]
Seat 1: Deemino30 (small blind) folded on the Flop
Seat 2: DTDTVDAVE (big blind) collected ($0.76)
Seat 3: bfelixs folded before Flop (didn't bet)
Seat 4: tapouttazz9 folded before Flop (didn't bet)
Seat 5: balon-nj246 (button) folded before Flop (didn't bet)


PokerStars Hand #150675088557:  Hold'em No Limit ($0.05/$0.10 USD) - 2016/03/29 16:18:19 ET
Table 'Corvus' 6-max Seat #1 is the button
Seat 1: Deemino30 ($7.64 in chips)
Seat 2: DTDTVDAVE ($23.02 in chips)
Seat 3: bfelixs ($11.97 in chips)
Seat 4: tapouttazz9 ($10.62 in chips)
Seat 5: balon-nj246 ($9 in chips)
DTDTVDAVE: posts small blind $0.05
bfelixs: posts big blind $0.10
*** HOLE CARDS ***
Dealt to tapouttazz9 [4h 9s]
tapouttazz9: folds
balon-nj246: folds
Deemino30: folds
ballajay3 joins the table at seat #6
DTDTVDAVE: calls $0.05
bfelixs: raises $0.35 to $0.45
DTDTVDAVE: folds
Uncalled bet ($0.35) returned to bfelixs
bfelixs collected $0.20 from pot
bfelixs: doesn't show hand
*** SUMMARY ***
Total pot $0.20 | Rake $0
Seat 1: Deemino30 (button) folded before Flop (didn't bet)
Seat 2: DTDTVDAVE (small blind) folded before Flop
Seat 3: bfelixs (big blind) collected ($0.20)
Seat 4: tapouttazz9 folded before Flop (didn't bet)
Seat 5: balon-nj246 folded before Flop (didn't bet)


PokerStars Hand #150675088663:  Hold'em No Limit ($0.05/$0.10 USD) - 2016/03/29 16:18:45 ET
Table 'Corvus' 6-max Seat #2 is the button
Seat 1: Deemino30 ($7.64 in chips)
Seat 2: DTDTVDAVE ($22.92 in chips)
Seat 3: bfelixs ($12.07 in chips)
Seat 4: tapouttazz9 ($10.62 in chips)
Seat 5: balon-nj246 ($9 in chips)
bfelixs: posts small blind $0.05
tapouttazz9: posts big blind $0.10
ballajay3: sits out
*** HOLE CARDS ***
Dealt to tapouttazz9 [5h Kh]
balon-nj246: folds
Deemino30: raises $0.20 to $0.30
DTDTVDAVE: folds
bfelixs: folds
tapouttazz9: folds
Uncalled bet ($0.20) returned to Deemino30
Deemino30 collected $0.25 from pot
Deemino30: doesn't show hand
*** SUMMARY ***
Total pot $0.25 | Rake $0
Seat 1: Deemino30 collected ($0.25)
Seat 2: DTDTVDAVE (button) folded before Flop (didn't bet)
Seat 3: bfelixs (small blind) folded before Flop
Seat 4: tapouttazz9 (big blind) folded before Flop
Seat 5: balon-nj246 folded before Flop (didn't bet)


PokerStars Hand #150675088811:  Hold'em No Limit ($0.05/$0.10 USD) - 2016/03/29 16:19:20 ET
Table 'Corvus' 6-max Seat #3 is the button
Seat 1: Deemino30 ($7.79 in chips)
Seat 2: DTDTVDAVE ($22.92 in chips)
Seat 3: bfelixs ($12.02 in chips)
Seat 4: tapouttazz9 ($10.52 in chips)
Seat 5: balon-nj246 ($9 in chips)
tapouttazz9: posts small blind $0.05
balon-nj246: posts big blind $0.10
ballajay3: sits out
*** HOLE CARDS ***
Dealt to tapouttazz9 [7h Tc]
Deemino30: folds
DTDTVDAVE: raises $0.15 to $0.25
bfelixs: folds
tapouttazz9: folds
balon-nj246: folds
Uncalled bet ($0.15) returned to DTDTVDAVE
DTDTVDAVE collected $0.25 from pot
DTDTVDAVE: doesn't show hand
*** SUMMARY ***
Total pot $0.25 | Rake $0
Seat 1: Deemino30 folded before Flop (didn't bet)
Seat 2: DTDTVDAVE collected ($0.25)
Seat 3: bfelixs (button) folded before Flop (didn't bet)
Seat 4: tapouttazz9 (small blind) folded before Flop
Seat 5: balon-nj246 (big blind) folded before Flop


PokerStars Hand #150675088847:  Hold'em No Limit ($0.05/$0.10 USD) - 2016/03/29 16:19:34 ET
Table 'Corvus' 6-max Seat #4 is the button
Seat 1: Deemino30 ($7.79 in chips)
Seat 2: DTDTVDAVE ($23.07 in chips)
Seat 3: bfelixs ($12.02 in chips)
Seat 4: tapouttazz9 ($10.47 in chips)
Seat 5: balon-nj246 ($8.90 in chips)
Seat 6: ballajay3 ($10 in chips)
balon-nj246: posts small blind $0.05
ballajay3: posts big blind $0.10
*** HOLE CARDS ***
Dealt to tapouttazz9 [Th 9s]
Deemino30: folds
DTDTVDAVE: folds
bfelixs: folds
tapouttazz9: folds
balon-nj246: folds
Uncalled bet ($0.05) returned to ballajay3
ballajay3 collected $0.10 from pot
ballajay3: doesn't show hand
*** SUMMARY ***
Total pot $0.10 | Rake $0
Seat 1: Deemino30 folded before Flop (didn't bet)
Seat 2: DTDTVDAVE folded before Flop (didn't bet)
Seat 3: bfelixs folded before Flop (didn't bet)
Seat 4: tapouttazz9 (button) folded before Flop (didn't bet)
Seat 5: balon-nj246 (small blind) folded before Flop
Seat 6: ballajay3 (big blind) collected ($0.10)


PokerStars Hand #150675088948:  Hold'em No Limit ($0.05/$0.10 USD) - 2016/03/29 16:19:59 ET
Table 'Corvus' 6-max Seat #5 is the button
Seat 1: Deemino30 ($7.79 in chips)
Seat 2: DTDTVDAVE ($23.07 in chips)
Seat 3: bfelixs ($12.02 in chips)
Seat 4: tapouttazz9 ($10.47 in chips)
Seat 5: balon-nj246 ($8.85 in chips)
Seat 6: ballajay3 ($10.05 in chips)
ballajay3: posts small blind $0.05
Deemino30: posts big blind $0.10
*** HOLE CARDS ***
Dealt to tapouttazz9 [5c As]
DTDTVDAVE: folds
bfelixs: raises $0.20 to $0.30
tapouttazz9: folds
balon-nj246: calls $0.30
ballajay3: folds
Deemino30: calls $0.20
*** FLOP *** [Jh 4s Kc]
Deemino30: checks
bfelixs: checks
balon-nj246: checks
*** TURN *** [Jh 4s Kc] [8h]
Deemino30: bets $0.90
bfelixs: folds
balon-nj246: calls $0.90
*** RIVER *** [Jh 4s Kc 8h] [Th]
Deemino30: bets $1.30
balon-nj246: folds
Uncalled bet ($1.30) returned to Deemino30
Deemino30 collected $2.61 from pot
Deemino30: doesn't show hand
*** SUMMARY ***
Total pot $2.75 | Rake $0.14
Board [Jh 4s Kc 8h Th]
Seat 1: Deemino30 (big blind) collected ($2.61)
Seat 2: DTDTVDAVE folded before Flop (didn't bet)
Seat 3: bfelixs folded on the Turn
Seat 4: tapouttazz9 folded before Flop (didn't bet)
Seat 5: balon-nj246 (button) folded on the River
Seat 6: ballajay3 (small blind) folded before Flop


PokerStars Hand #150675089184:  Hold'em No Limit ($0.05/$0.10 USD) - 2016/03/29 16:21:01 ET
Table 'Corvus' 6-max Seat #6 is the button
Seat 1: Deemino30 ($9.20 in chips)
Seat 2: DTDTVDAVE ($23.07 in chips)
Seat 3: bfelixs ($11.72 in chips)
Seat 4: tapouttazz9 ($10.47 in chips)
Seat 5: balon-nj246 ($7.65 in chips)
Seat 6: ballajay3 ($10 in chips)
Deemino30: posts small blind $0.05
DTDTVDAVE: posts big blind $0.10
*** HOLE CARDS ***
Dealt to tapouttazz9 [Qc 2s]
bfelixs: folds
tapouttazz9: folds
balon-nj246: folds
ballajay3: calls $0.10
Deemino30: calls $0.05
DTDTVDAVE: checks
*** FLOP *** [Qh 9s 9h]
Deemino30: checks
DTDTVDAVE: bets $0.18
ballajay3: folds
Deemino30: folds
Uncalled bet ($0.18) returned to DTDTVDAVE
DTDTVDAVE collected $0.28 from pot
DTDTVDAVE: doesn't show hand
*** SUMMARY ***
Total pot $0.30 | Rake $0.02
Board [Qh 9s 9h]
Seat 1: Deemino30 (small blind) folded on the Flop
Seat 2: DTDTVDAVE (big blind) collected ($0.28)
Seat 3: bfelixs folded before Flop (didn't bet)
Seat 4: tapouttazz9 folded before Flop (didn't bet)
Seat 5: balon-nj246 folded before Flop (didn't bet)
Seat 6: ballajay3 (button) folded on the Flop


PokerStars Hand #150675089287:  Hold'em No Limit ($0.05/$0.10 USD) - 2016/03/29 16:21:27 ET
Table 'Corvus' 6-max Seat #1 is the button
Seat 1: Deemino30 ($9.10 in chips)
Seat 2: DTDTVDAVE ($23.25 in chips)
Seat 3: bfelixs ($11.72 in chips)
Seat 4: tapouttazz9 ($10.47 in chips)
Seat 5: balon-nj246 ($7.65 in chips)
Seat 6: ballajay3 ($9.90 in chips)
DTDTVDAVE: posts small blind $0.05
bfelixs: posts big blind $0.10
*** HOLE CARDS ***
Dealt to tapouttazz9 [Qs 6d]
tapouttazz9: folds
balon-nj246: calls $0.10
ballajay3: calls $0.10
Deemino30: folds
DTDTVDAVE: folds
bfelixs: checks
*** FLOP *** [Ts Ad As]
bfelixs: checks
balon-nj246: checks
ballajay3: bets $0.30
bfelixs: folds
balon-nj246: calls $0.30
*** TURN *** [Ts Ad As] [Ks]
balon-nj246: checks
ballajay3: checks
*** RIVER *** [Ts Ad As Ks] [Ac]
balon-nj246: checks
ballajay3: checks
*** SHOW DOWN ***
balon-nj246: shows [8s 4s] (a flush, Ace high)
ballajay3: shows [Kh Tc] (a full house, Aces full of Kings)
ballajay3 collected $0.90 from pot
*** SUMMARY ***
Total pot $0.95 | Rake $0.05
Board [Ts Ad As Ks Ac]
Seat 1: Deemino30 (button) folded before Flop (didn't bet)
Seat 2: DTDTVDAVE (small blind) folded before Flop
Seat 3: bfelixs (big blind) folded on the Flop
Seat 4: tapouttazz9 folded before Flop (didn't bet)
Seat 5: balon-nj246 showed [8s 4s] and lost with a flush, Ace high
Seat 6: ballajay3 showed [Kh Tc] and won ($0.90) with a full house, Aces full of Kings


PokerStars Hand #150675089468:  Hold'em No Limit ($0.05/$0.10 USD) - 2016/03/29 16:22:07 ET
Table 'Corvus' 6-max Seat #2 is the button
Seat 1: Deemino30 ($9.10 in chips)
Seat 2: DTDTVDAVE ($23.20 in chips)
Seat 3: bfelixs ($11.62 in chips)
Seat 4: tapouttazz9 ($10.47 in chips)
Seat 5: balon-nj246 ($7.25 in chips)
Seat 6: ballajay3 ($10.40 in chips)
bfelixs: posts small blind $0.05
tapouttazz9: posts big blind $0.10
*** HOLE CARDS ***
Dealt to tapouttazz9 [4c 6c]
balon-nj246: calls $0.10
ballajay3: calls $0.10
Deemino30: calls $0.10
DTDTVDAVE: folds
bfelixs: folds
tapouttazz9: checks
*** FLOP *** [Tc Kd Th]
tapouttazz9: checks
balon-nj246: checks
ballajay3: checks
Deemino30: bets $0.20
tapouttazz9: folds
balon-nj246: folds
ballajay3: folds
Uncalled bet ($0.20) returned to Deemino30
Deemino30 collected $0.43 from pot
Deemino30: doesn't show hand
*** SUMMARY ***
Total pot $0.45 | Rake $0.02
Board [Tc Kd Th]
Seat 1: Deemino30 collected ($0.43)
Seat 2: DTDTVDAVE (button) folded before Flop (didn't bet)
Seat 3: bfelixs (small blind) folded before Flop
Seat 4: tapouttazz9 (big blind) folded on the Flop
Seat 5: balon-nj246 folded on the Flop
Seat 6: ballajay3 folded on the Flop


PokerStars Hand #150675089643:  Hold'em No Limit ($0.05/$0.10 USD) - 2016/03/29 16:22:50 ET
Table 'Corvus' 6-max Seat #3 is the button
Seat 1: Deemino30 ($9.43 in chips)
Seat 2: DTDTVDAVE ($23.20 in chips)
Seat 3: bfelixs ($11.57 in chips)
Seat 4: tapouttazz9 ($10.37 in chips)
Seat 5: balon-nj246 ($7.15 in chips)
Seat 6: ballajay3 ($10.30 in chips)
tapouttazz9: posts small blind $0.05
balon-nj246: posts big blind $0.10
*** HOLE CARDS ***
Dealt to tapouttazz9 [Td 8d]
ballajay3: calls $0.10
Deemino30: folds
DTDTVDAVE: folds
bfelixs: folds
tapouttazz9: folds
balon-nj246: checks
*** FLOP *** [9d Qd 7c]
balon-nj246: checks
ballajay3: bets $0.20
balon-nj246: folds
Uncalled bet ($0.20) returned to ballajay3
ballajay3 collected $0.24 from pot
ballajay3: doesn't show hand
*** SUMMARY ***
Total pot $0.25 | Rake $0.01
Board [9d Qd 7c]
Seat 1: Deemino30 folded before Flop (didn't bet)
Seat 2: DTDTVDAVE folded before Flop (didn't bet)
Seat 3: bfelixs (button) folded before Flop (didn't bet)
Seat 4: tapouttazz9 (small blind) folded before Flop
Seat 5: balon-nj246 (big blind) folded on the Flop
Seat 6: ballajay3 collected ($0.24)


PokerStars Hand #150675089762:  Hold'em No Limit ($0.05/$0.10 USD) - 2016/03/29 16:23:13 ET
Table 'Corvus' 6-max Seat #4 is the button
Seat 1: Deemino30 ($9.43 in chips)
Seat 2: DTDTVDAVE ($23.20 in chips)
Seat 3: bfelixs ($11.57 in chips)
Seat 4: tapouttazz9 ($10.32 in chips)
Seat 5: balon-nj246 ($7.05 in chips)
Seat 6: ballajay3 ($10.44 in chips)
balon-nj246: posts small blind $0.05
ballajay3: posts big blind $0.10
*** HOLE CARDS ***
Dealt to tapouttazz9 [2d Kh]
Deemino30: folds
DTDTVDAVE: folds
bfelixs: folds
tapouttazz9: folds
balon-nj246: calls $0.05
ballajay3: checks
*** FLOP *** [Ks 4s 9s]
balon-nj246: checks
ballajay3: checks
*** TURN *** [Ks 4s 9s] [Kc]
balon-nj246: checks
ballajay3: bets $0.20
balon-nj246: folds
Uncalled bet ($0.20) returned to ballajay3
ballajay3 collected $0.19 from pot
ballajay3: doesn't show hand
*** SUMMARY ***
Total pot $0.20 | Rake $0.01
Board [Ks 4s 9s Kc]
Seat 1: Deemino30 folded before Flop (didn't bet)
Seat 2: DTDTVDAVE folded before Flop (didn't bet)
Seat 3: bfelixs folded before Flop (didn't bet)
Seat 4: tapouttazz9 (button) folded before Flop (didn't bet)
Seat 5: balon-nj246 (small blind) folded on the Turn
Seat 6: ballajay3 (big blind) collected ($0.19)


PokerStars Hand #150675089971:  Hold'em No Limit ($0.05/$0.10 USD) - 2016/03/29 16:23:59 ET
Table 'Corvus' 6-max Seat #5 is the button
Seat 1: Deemino30 ($9.43 in chips)
Seat 2: DTDTVDAVE ($23.20 in chips)
Seat 3: bfelixs ($11.57 in chips)
Seat 4: tapouttazz9 ($10.32 in chips)
Seat 5: balon-nj246 ($6.95 in chips)
Seat 6: ballajay3 ($10.53 in chips)
ballajay3: posts small blind $0.05
Deemino30: posts big blind $0.10
*** HOLE CARDS ***
Dealt to tapouttazz9 [Qd Jh]
DTDTVDAVE: folds
bfelixs: folds
tapouttazz9: folds
balon-nj246: folds
ballajay3: calls $0.05
Deemino30: checks
*** FLOP *** [Tc 8d Qc]
ballajay3: checks
Deemino30: bets $0.19
ballajay3: folds
Uncalled bet ($0.19) returned to Deemino30
Deemino30 collected $0.19 from pot
Deemino30: doesn't show hand
*** SUMMARY ***
Total pot $0.20 | Rake $0.01
Board [Tc 8d Qc]
Seat 1: Deemino30 (big blind) collected ($0.19)
Seat 2: DTDTVDAVE folded before Flop (didn't bet)
Seat 3: bfelixs folded before Flop (didn't bet)
Seat 4: tapouttazz9 folded before Flop (didn't bet)
Seat 5: balon-nj246 (button) folded before Flop (didn't bet)
Seat 6: ballajay3 (small blind) folded on the Flop


PokerStars Hand #150676765154:  Hold'em No Limit ($0.05/$0.10 USD) - 2016/03/29 16:24:19 ET
Table 'Corvus' 6-max Seat #6 is the button
Seat 1: Deemino30 ($9.52 in chips)
Seat 2: DTDTVDAVE ($23.20 in chips)
Seat 3: bfelixs ($11.57 in chips)
Seat 4: tapouttazz9 ($10.32 in chips)
Seat 5: balon-nj246 ($6.95 in chips)
Seat 6: ballajay3 ($10.43 in chips)
Deemino30: posts small blind $0.05
DTDTVDAVE: posts big blind $0.10
*** HOLE CARDS ***
Dealt to tapouttazz9 [9h Qc]
bfelixs: folds
tapouttazz9: folds
balon-nj246: folds
ballajay3: raises $0.20 to $0.30
Deemino30: folds
DTDTVDAVE: folds
Uncalled bet ($0.20) returned to ballajay3
ballajay3 collected $0.25 from pot
ballajay3: doesn't show hand
*** SUMMARY ***
Total pot $0.25 | Rake $0
Seat 1: Deemino30 (small blind) folded before Flop
Seat 2: DTDTVDAVE (big blind) folded before Flop
Seat 3: bfelixs folded before Flop (didn't bet)
Seat 4: tapouttazz9 folded before Flop (didn't bet)
Seat 5: balon-nj246 folded before Flop (didn't bet)
Seat 6: ballajay3 (button) collected ($0.25)


PokerStars Hand #150676765221:  Hold'em No Limit ($0.05/$0.10 USD) - 2016/03/29 16:24:33 ET
Table 'Corvus' 6-max Seat #1 is the button
Seat 1: Deemino30 ($9.47 in chips)
Seat 2: DTDTVDAVE ($23.10 in chips)
Seat 3: bfelixs ($11.57 in chips)
Seat 4: tapouttazz9 ($10.32 in chips)
Seat 5: balon-nj246 ($6.95 in chips)
Seat 6: ballajay3 ($10.58 in chips)
DTDTVDAVE: posts small blind $0.05
bfelixs: posts big blind $0.10
*** HOLE CARDS ***
Dealt to tapouttazz9 [Td Ad]
tapouttazz9: raises $0.15 to $0.25
balon-nj246: folds
ballajay3: calls $0.25
Deemino30: folds
DTDTVDAVE: folds
bfelixs: folds
*** FLOP *** [9s 6h 5c]
tapouttazz9: bets $0.46
ballajay3: folds
Uncalled bet ($0.46) returned to tapouttazz9
tapouttazz9 collected $0.62 from pot
tapouttazz9: doesn't show hand
*** SUMMARY ***
Total pot $0.65 | Rake $0.03
Board [9s 6h 5c]
Seat 1: Deemino30 (button) folded before Flop (didn't bet)
Seat 2: DTDTVDAVE (small blind) folded before Flop
Seat 3: bfelixs (big blind) folded before Flop
Seat 4: tapouttazz9 collected ($0.62)
Seat 5: balon-nj246 folded before Flop (didn't bet)
Seat 6: ballajay3 folded on the Flop


PokerStars Hand #150676765344:  Hold'em No Limit ($0.05/$0.10 USD) - 2016/03/29 16:25:02 ET
Table 'Corvus' 6-max Seat #2 is the button
Seat 1: Deemino30 ($9.47 in chips)
Seat 2: DTDTVDAVE ($23.05 in chips)
Seat 3: bfelixs ($11.47 in chips)
Seat 4: tapouttazz9 ($10.69 in chips)
Seat 5: balon-nj246 ($6.95 in chips)
Seat 6: ballajay3 ($10.33 in chips)
bfelixs: posts small blind $0.05
tapouttazz9: posts big blind $0.10
*** HOLE CARDS ***
Dealt to tapouttazz9 [7h Qh]
balon-nj246: calls $0.10
ballajay3: calls $0.10
Deemino30: calls $0.10
DTDTVDAVE: calls $0.10
bfelixs: raises $0.55 to $0.65
tapouttazz9: folds
balon-nj246: calls $0.55
ballajay3: folds
Deemino30: folds
DTDTVDAVE: folds
*** FLOP *** [4c 3c 6c]
bfelixs: bets $0.84
balon-nj246: calls $0.84
*** TURN *** [4c 3c 6c] [2d]
bfelixs: checks
balon-nj246: checks
*** RIVER *** [4c 3c 6c 2d] [9s]
bfelixs: checks
balon-nj246: checks
*** SHOW DOWN ***
bfelixs: shows [Ah Kd] (high card Ace)
balon-nj246: shows [9c As] (a pair of Nines)
balon-nj246 collected $3.21 from pot
*** SUMMARY ***
Total pot $3.38 | Rake $0.17
Board [4c 3c 6c 2d 9s]
Seat 1: Deemino30 folded before Flop
Seat 2: DTDTVDAVE (button) folded before Flop
Seat 3: bfelixs (small blind) showed [Ah Kd] and lost with high card Ace
Seat 4: tapouttazz9 (big blind) folded before Flop
Seat 5: balon-nj246 showed [9c As] and won ($3.21) with a pair of Nines
Seat 6: ballajay3 folded before Flop


PokerStars Hand #150676765782:  Hold'em No Limit ($0.05/$0.10 USD) - 2016/03/29 16:26:36 ET
Table 'Corvus' 6-max Seat #3 is the button
Seat 1: Deemino30 ($9.37 in chips)
Seat 2: DTDTVDAVE ($22.95 in chips)
Seat 3: bfelixs ($10 in chips)
Seat 4: tapouttazz9 ($10.59 in chips)
Seat 5: balon-nj246 ($8.67 in chips)
Seat 6: ballajay3 ($10.23 in chips)
tapouttazz9: posts small blind $0.05
balon-nj246: posts big blind $0.10
*** HOLE CARDS ***
Dealt to tapouttazz9 [5h 5d]
ballajay3: calls $0.10
Deemino30: folds
DTDTVDAVE: folds
bfelixs: folds
tapouttazz9: raises $0.10 to $0.20
balon-nj246: folds
ballajay3: calls $0.10
*** FLOP *** [Qh 3s 6s]
tapouttazz9: checks
ballajay3: bets $0.50
tapouttazz9: folds
Uncalled bet ($0.50) returned to ballajay3
ballajay3 collected $0.48 from pot
ballajay3: doesn't show hand
*** SUMMARY ***
Total pot $0.50 | Rake $0.02
Board [Qh 3s 6s]
Seat 1: Deemino30 folded before Flop (didn't bet)
Seat 2: DTDTVDAVE folded before Flop (didn't bet)
Seat 3: bfelixs (button) folded before Flop (didn't bet)
Seat 4: tapouttazz9 (small blind) folded on the Flop
Seat 5: balon-nj246 (big blind) folded before Flop
Seat 6: ballajay3 collected ($0.48)


PokerStars Hand #150676765928:  Hold'em No Limit ($0.05/$0.10 USD) - 2016/03/29 16:27:12 ET
Table 'Corvus' 6-max Seat #4 is the button
Seat 1: Deemino30 ($9.37 in chips)
Seat 2: DTDTVDAVE ($22.95 in chips)
Seat 3: bfelixs ($10 in chips)
Seat 4: tapouttazz9 ($10.39 in chips)
Seat 5: balon-nj246 ($8.57 in chips)
Seat 6: ballajay3 ($10.51 in chips)
balon-nj246: posts small blind $0.05
ballajay3: posts big blind $0.10
*** HOLE CARDS ***
Dealt to tapouttazz9 [As 8h]
Deemino30: folds
DTDTVDAVE: folds
bfelixs: folds
tapouttazz9: folds
balon-nj246: raises $0.10 to $0.20
ballajay3: folds
Uncalled bet ($0.10) returned to balon-nj246
balon-nj246 collected $0.20 from pot
*** SUMMARY ***
Total pot $0.20 | Rake $0
Seat 1: Deemino30 folded before Flop (didn't bet)
Seat 2: DTDTVDAVE folded before Flop (didn't bet)
Seat 3: bfelixs folded before Flop (didn't bet)
Seat 4: tapouttazz9 (button) folded before Flop (didn't bet)
Seat 5: balon-nj246 (small blind) collected ($0.20)
Seat 6: ballajay3 (big blind) folded before Flop


PokerStars Hand #150676766027:  Hold'em No Limit ($0.05/$0.10 USD) - 2016/03/29 16:27:34 ET
Table 'Corvus' 6-max Seat #5 is the button
Seat 1: Deemino30 ($9.37 in chips)
Seat 2: DTDTVDAVE ($22.95 in chips)
Seat 3: bfelixs ($10 in chips)
Seat 4: tapouttazz9 ($10.39 in chips)
Seat 5: balon-nj246 ($8.67 in chips)
Seat 6: ballajay3 ($10.41 in chips)
ballajay3: posts small blind $0.05
Deemino30: posts big blind $0.10
*** HOLE CARDS ***
Dealt to tapouttazz9 [Td 2c]
DTDTVDAVE: folds
bfelixs: folds
tapouttazz9: folds
balon-nj246: folds
ballajay3: calls $0.05
Deemino30: checks
*** FLOP *** [5d 4c Qd]
ballajay3: checks
Deemino30: checks
*** TURN *** [5d 4c Qd] [8s]
ballajay3: checks
Deemino30: checks
*** RIVER *** [5d 4c Qd 8s] [Tc]
ballajay3: checks
Deemino30: checks
*** SHOW DOWN ***
ballajay3: shows [6d 5s] (a pair of Fives)
Deemino30: mucks hand
ballajay3 collected $0.19 from pot
*** SUMMARY ***
Total pot $0.20 | Rake $0.01
Board [5d 4c Qd 8s Tc]
Seat 1: Deemino30 (big blind) mucked [2d As]
Seat 2: DTDTVDAVE folded before Flop (didn't bet)
Seat 3: bfelixs folded before Flop (didn't bet)
Seat 4: tapouttazz9 folded before Flop (didn't bet)
Seat 5: balon-nj246 (button) folded before Flop (didn't bet)
Seat 6: ballajay3 (small blind) showed [6d 5s] and won ($0.19) with a pair of Fives


PokerStars Hand #150676766339:  Hold'em No Limit ($0.05/$0.10 USD) - 2016/03/29 16:28:53 ET
Table 'Corvus' 6-max Seat #6 is the button
Seat 1: Deemino30 ($9.27 in chips)
Seat 2: DTDTVDAVE ($22.95 in chips)
Seat 3: bfelixs ($10 in chips)
Seat 4: tapouttazz9 ($10.39 in chips)
Seat 5: balon-nj246 ($8.67 in chips)
Seat 6: ballajay3 ($10.50 in chips)
Deemino30: posts small blind $0.05
DTDTVDAVE: posts big blind $0.10
*** HOLE CARDS ***
Dealt to tapouttazz9 [2d Qc]
bfelixs: folds
tapouttazz9: folds
balon-nj246: folds
ballajay3: calls $0.10
Deemino30: raises $0.20 to $0.30
DTDTVDAVE: calls $0.20
ballajay3: calls $0.20
*** FLOP *** [Ah Th 5c]
Deemino30: checks
DTDTVDAVE: checks
ballajay3: bets $0.50
Deemino30: folds
DTDTVDAVE: folds
Uncalled bet ($0.50) returned to ballajay3
ballajay3 collected $0.86 from pot
ballajay3: doesn't show hand
*** SUMMARY ***
Total pot $0.90 | Rake $0.04
Board [Ah Th 5c]
Seat 1: Deemino30 (small blind) folded on the Flop
Seat 2: DTDTVDAVE (big blind) folded on the Flop
Seat 3: bfelixs folded before Flop (didn't bet)
Seat 4: tapouttazz9 folded before Flop (didn't bet)
Seat 5: balon-nj246 folded before Flop (didn't bet)
Seat 6: ballajay3 (button) collected ($0.86)


PokerStars Hand #150676766520:  Hold'em No Limit ($0.05/$0.10 USD) - 2016/03/29 16:29:34 ET
Table 'Corvus' 6-max Seat #1 is the button
Seat 1: Deemino30 ($8.97 in chips)
Seat 2: DTDTVDAVE ($22.65 in chips)
Seat 3: bfelixs ($10 in chips)
Seat 4: tapouttazz9 ($10.39 in chips)
Seat 5: balon-nj246 ($8.67 in chips)
Seat 6: ballajay3 ($11.06 in chips)
DTDTVDAVE: posts small blind $0.05
bfelixs: posts big blind $0.10
*** HOLE CARDS ***
Dealt to tapouttazz9 [Kc 2h]
tapouttazz9: folds
balon-nj246: folds
ballajay3: calls $0.10
Deemino30: folds
DTDTVDAVE: folds
bfelixs: checks
*** FLOP *** [Ks As 3d]
bfelixs: checks
ballajay3: bets $0.20
bfelixs: folds
Uncalled bet ($0.20) returned to ballajay3
ballajay3 collected $0.24 from pot
ballajay3: doesn't show hand
*** SUMMARY ***
Total pot $0.25 | Rake $0.01
Board [Ks As 3d]
Seat 1: Deemino30 (button) folded before Flop (didn't bet)
Seat 2: DTDTVDAVE (small blind) folded before Flop
Seat 3: bfelixs (big blind) folded on the Flop
Seat 4: tapouttazz9 folded before Flop (didn't bet)
Seat 5: balon-nj246 folded before Flop (didn't bet)
Seat 6: ballajay3 collected ($0.24)


PokerStars Hand #150676766646:  Hold'em No Limit ($0.05/$0.10 USD) - 2016/03/29 16:30:05 ET
Table 'Corvus' 6-max Seat #2 is the button
Seat 1: Deemino30 ($8.97 in chips)
Seat 2: DTDTVDAVE ($22.60 in chips)
Seat 3: bfelixs ($10 in chips)
Seat 4: tapouttazz9 ($10.39 in chips)
Seat 5: balon-nj246 ($8.67 in chips)
Seat 6: ballajay3 ($11.20 in chips)
bfelixs: posts small blind $0.05
tapouttazz9: posts big blind $0.10
*** HOLE CARDS ***
Dealt to tapouttazz9 [2s 2c]
balon-nj246: calls $0.10
ballajay3: folds
Deemino30: calls $0.10
DTDTVDAVE has timed out
DTDTVDAVE: folds
bfelixs: calls $0.05
tapouttazz9: checks
*** FLOP *** [8c 9s Kc]
bfelixs: checks
tapouttazz9: checks
balon-nj246: checks
Deemino30: checks
*** TURN *** [8c 9s Kc] [6h]
bfelixs: checks
tapouttazz9: checks
balon-nj246: checks
Deemino30: checks
*** RIVER *** [8c 9s Kc 6h] [Th]
bfelixs: checks
tapouttazz9: checks
balon-nj246: checks
Deemino30: checks
*** SHOW DOWN ***
bfelixs: shows [3d 2d] (high card King)
tapouttazz9: shows [2s 2c] (a pair of Deuces)
balon-nj246: shows [6s 7s] (a straight, Six to Ten)
Deemino30: mucks hand
balon-nj246 collected $0.38 from pot
*** SUMMARY ***
Total pot $0.40 | Rake $0.02
Board [8c 9s Kc 6h Th]
Seat 1: Deemino30 mucked [Jd Td]
Seat 2: DTDTVDAVE (button) folded before Flop (didn't bet)
Seat 3: bfelixs (small blind) showed [3d 2d] and lost with high card King
Seat 4: tapouttazz9 (big blind) showed [2s 2c] and lost with a pair of Deuces
Seat 5: balon-nj246 showed [6s 7s] and won ($0.38) with a straight, Six to Ten
Seat 6: ballajay3 folded before Flop (didn't bet)


PokerStars Hand #150676766986:  Hold'em No Limit ($0.05/$0.10 USD) - 2016/03/29 16:31:17 ET
Table 'Corvus' 6-max Seat #3 is the button
Seat 1: Deemino30 ($8.87 in chips)
Seat 3: bfelixs ($10 in chips)
Seat 4: tapouttazz9 ($10.29 in chips)
Seat 5: balon-nj246 ($8.95 in chips)
Seat 6: ballajay3 ($11.20 in chips)
tapouttazz9: posts small blind $0.05
balon-nj246: posts big blind $0.10
*** HOLE CARDS ***
Dealt to tapouttazz9 [3h 3d]
ballajay3: calls $0.10
Deemino30: folds
bfelixs: calls $0.10
tapouttazz9: folds
balon-nj246: checks
*** FLOP *** [4h 2s 2d]
balon-nj246: checks
ballajay3: checks
bfelixs: checks
*** TURN *** [4h 2s 2d] [5s]
balon-nj246: checks
ballajay3: bets $0.30
bfelixs: folds
balon-nj246: folds
Uncalled bet ($0.30) returned to ballajay3
ballajay3 collected $0.33 from pot
ballajay3: doesn't show hand
*** SUMMARY ***
Total pot $0.35 | Rake $0.02
Board [4h 2s 2d 5s]
Seat 1: Deemino30 folded before Flop (didn't bet)
Seat 3: bfelixs (button) folded on the Turn
Seat 4: tapouttazz9 (small blind) folded before Flop
Seat 5: balon-nj246 (big blind) folded on the Turn
Seat 6: ballajay3 collected ($0.33)


PokerStars Hand #150676767136:  Hold'em No Limit ($0.05/$0.10 USD) - 2016/03/29 16:31:54 ET
Table 'Corvus' 6-max Seat #4 is the button
Seat 1: Deemino30 ($8.87 in chips)
Seat 3: bfelixs ($10 in chips)
Seat 4: tapouttazz9 ($10.24 in chips)
Seat 5: balon-nj246 ($8.85 in chips)
Seat 6: ballajay3 ($11.43 in chips)
balon-nj246: posts small blind $0.05
ballajay3: posts big blind $0.10
*** HOLE CARDS ***
Dealt to tapouttazz9 [7c 8s]
Deemino30: calls $0.10
bfelixs: folds
tapouttazz9: folds
balon-nj246: calls $0.05
ballajay3: checks
*** FLOP *** [6c Tc 4h]
balon-nj246: checks
ballajay3: checks
Deemino30: checks
*** TURN *** [6c Tc 4h] [2c]
balon-nj246: checks
ballajay3: bets $0.30
Deemino30: folds
balon-nj246: folds
Uncalled bet ($0.30) returned to ballajay3
ballajay3 collected $0.28 from pot
ballajay3: doesn't show hand
*** SUMMARY ***
Total pot $0.30 | Rake $0.02
Board [6c Tc 4h 2c]
Seat 1: Deemino30 folded on the Turn
Seat 3: bfelixs folded before Flop (didn't bet)
Seat 4: tapouttazz9 (button) folded before Flop (didn't bet)
Seat 5: balon-nj246 (small blind) folded on the Turn
Seat 6: ballajay3 (big blind) collected ($0.28)


PokerStars Hand #150676767271:  Hold'em No Limit ($0.05/$0.10 USD) - 2016/03/29 16:32:27 ET
Table 'Corvus' 6-max Seat #5 is the button
Seat 1: Deemino30 ($8.77 in chips)
Seat 3: bfelixs ($10 in chips)
Seat 4: tapouttazz9 ($10.24 in chips)
Seat 5: balon-nj246 ($8.75 in chips)
Seat 6: ballajay3 ($11.61 in chips)
ballajay3: posts small blind $0.05
Deemino30: posts big blind $0.10
*** HOLE CARDS ***
Dealt to tapouttazz9 [6h 7c]
bfelixs: folds
tapouttazz9: folds
balon-nj246: calls $0.10
ballajay3: calls $0.05
Deemino30: checks
*** FLOP *** [Jh Kh 4d]
ballajay3: checks
Deemino30: checks
balon-nj246: checks
*** TURN *** [Jh Kh 4d] [4h]
ballajay3: checks
Deemino30: checks
balon-nj246: checks
*** RIVER *** [Jh Kh 4d 4h] [7h]
ballajay3: bets $0.30
Deemino30: folds
balon-nj246: calls $0.30
*** SHOW DOWN ***
ballajay3: shows [Qh 3c] (a flush, King high)
balon-nj246: mucks hand
ballajay3 collected $0.86 from pot
*** SUMMARY ***
Total pot $0.90 | Rake $0.04
Board [Jh Kh 4d 4h 7h]
Seat 1: Deemino30 (big blind) folded on the River
Seat 3: bfelixs folded before Flop (didn't bet)
Seat 4: tapouttazz9 folded before Flop (didn't bet)
Seat 5: balon-nj246 (button) mucked [8h 9d]
Seat 6: ballajay3 (small blind) showed [Qh 3c] and won ($0.86) with a flush, King high


