PokerStars Hand #157027516110:  Hold'em No Limit ($0.05/$0.10 USD) - 2016/08/16 16:19:58 ET
Table 'Apus' 6-max Seat #2 is the button
Seat 1: sayhey48 ($9.08 in chips)
Seat 2: runbich ($10.47 in chips)
Seat 3: delm44 ($2.35 in chips)
Seat 5: tapouttazz9 ($8.32 in chips)
Seat 6: Biz_Markii ($7.23 in chips)
delm44: posts small blind $0.05
tapouttazz9: posts big blind $0.10
*** HOLE CARDS ***
Dealt to tapouttazz9 [5d 4h]
Biz_Markii: folds
sayhey48: calls $0.10
Biz_Markii leaves the table
runbich: calls $0.10
delm44: calls $0.05
tapouttazz9: checks
*** FLOP *** [8c 6c 7h]
delm44: checks
tapouttazz9: bets $0.19
sayhey48: calls $0.19
runbich: calls $0.19
delm44: folds
*** TURN *** [8c 6c 7h] [Jc]
tapouttazz9: checks
sayhey48: checks
runbich: bets $0.50
tapouttazz9: calls $0.50
sayhey48: folds
*** RIVER *** [8c 6c 7h Jc] [7d]
tapouttazz9: checks
runbich: bets $0.50
tapouttazz9: calls $0.50
*** SHOW DOWN ***
runbich: shows [3c Ac] (a flush, Ace high)
tapouttazz9: mucks hand
runbich collected $2.82 from pot
*** SUMMARY ***
Total pot $2.97 | Rake $0.15
Board [8c 6c 7h Jc 7d]
Seat 1: sayhey48 folded on the Turn
Seat 2: runbich (button) showed [3c Ac] and won ($2.82) with a flush, Ace high
Seat 3: delm44 (small blind) folded on the Flop
Seat 5: tapouttazz9 (big blind) mucked [5d 4h]
Seat 6: Biz_Markii folded before Flop (didn't bet)


PokerStars Hand #157027516372:  Hold'em No Limit ($0.05/$0.10 USD) - 2016/08/16 16:20:59 ET
Table 'Apus' 6-max Seat #3 is the button
Seat 1: sayhey48 ($8.79 in chips)
Seat 2: runbich ($12 in chips)
Seat 3: delm44 ($2.25 in chips)
Seat 5: tapouttazz9 ($7.03 in chips)
tapouttazz9: posts small blind $0.05
sayhey48: posts big blind $0.10
*** HOLE CARDS ***
Dealt to tapouttazz9 [Ah 7c]
runbich: folds
delm44: folds
tapouttazz9: folds
Uncalled bet ($0.05) returned to sayhey48
runbich leaves the table
sayhey48 collected $0.10 from pot
sayhey48: doesn't show hand
*** SUMMARY ***
Total pot $0.10 | Rake $0
Seat 1: sayhey48 (big blind) collected ($0.10)
Seat 2: runbich folded before Flop (didn't bet)
Seat 3: delm44 (button) folded before Flop (didn't bet)
Seat 5: tapouttazz9 (small blind) folded before Flop


PokerStars Hand #157027516401:  Hold'em No Limit ($0.05/$0.10 USD) - 2016/08/16 16:21:05 ET
Table 'Apus' 6-max Seat #5 is the button
Seat 1: sayhey48 ($8.84 in chips)
Seat 3: delm44 ($2.25 in chips)
Seat 5: tapouttazz9 ($6.98 in chips)
sayhey48: posts small blind $0.05
delm44: posts big blind $0.10
*** HOLE CARDS ***
Dealt to tapouttazz9 [Kh 7d]
tapouttazz9: folds
sayhey48: folds
Uncalled bet ($0.05) returned to delm44
delm44 collected $0.10 from pot
delm44: doesn't show hand
*** SUMMARY ***
Total pot $0.10 | Rake $0
Seat 1: sayhey48 (small blind) folded before Flop
Seat 3: delm44 (big blind) collected ($0.10)
Seat 5: tapouttazz9 (button) folded before Flop (didn't bet)


PokerStars Hand #157027516443:  Hold'em No Limit ($0.05/$0.10 USD) - 2016/08/16 16:21:13 ET
Table 'Apus' 6-max Seat #1 is the button
Seat 1: sayhey48 ($8.79 in chips)
Seat 3: delm44 ($2.30 in chips)
Seat 5: tapouttazz9 ($6.98 in chips)
delm44: posts small blind $0.05
tapouttazz9: posts big blind $0.10
*** HOLE CARDS ***
Dealt to tapouttazz9 [2s 8h]
sayhey48: folds
delm44: calls $0.05
tapouttazz9: checks
*** FLOP *** [4d Jd 6h]
delm44: checks
tapouttazz9: checks
*** TURN *** [4d Jd 6h] [9h]
delm44: checks
tapouttazz9: checks
*** RIVER *** [4d Jd 6h 9h] [4c]
delm44: checks
tapouttazz9: checks
*** SHOW DOWN ***
delm44: shows [8d Ac] (a pair of Fours)
tapouttazz9: mucks hand
delm44 collected $0.19 from pot
*** SUMMARY ***
Total pot $0.20 | Rake $0.01
Board [4d Jd 6h 9h 4c]
Seat 1: sayhey48 (button) folded before Flop (didn't bet)
Seat 3: delm44 (small blind) showed [8d Ac] and won ($0.19) with a pair of Fours
Seat 5: tapouttazz9 (big blind) mucked [2s 8h]


PokerStars Hand #157027516618:  Hold'em No Limit ($0.05/$0.10 USD) - 2016/08/16 16:21:53 ET
Table 'Apus' 6-max Seat #3 is the button
Seat 1: sayhey48 ($8.79 in chips)
Seat 3: delm44 ($2.39 in chips)
Seat 5: tapouttazz9 ($6.88 in chips)
tapouttazz9: posts small blind $0.05
sayhey48: posts big blind $0.10
*** HOLE CARDS ***
Dealt to tapouttazz9 [6d 8h]
delm44: folds
tapouttazz9: folds
Uncalled bet ($0.05) returned to sayhey48
sayhey48 collected $0.10 from pot
sayhey48: doesn't show hand
*** SUMMARY ***
Total pot $0.10 | Rake $0
Seat 1: sayhey48 (big blind) collected ($0.10)
Seat 3: delm44 (button) folded before Flop (didn't bet)
Seat 5: tapouttazz9 (small blind) folded before Flop


PokerStars Hand #157027516639:  Hold'em No Limit ($0.05/$0.10 USD) - 2016/08/16 16:21:58 ET
Table 'Apus' 6-max Seat #5 is the button
Seat 1: sayhey48 ($8.84 in chips)
Seat 3: delm44 ($2.39 in chips)
Seat 5: tapouttazz9 ($6.83 in chips)
sayhey48: posts small blind $0.05
delm44: posts big blind $0.10
*** HOLE CARDS ***
Dealt to tapouttazz9 [5s 3s]
tapouttazz9: folds
sayhey48: raises $0.20 to $0.30
delm44: calls $0.20
*** FLOP *** [Qh 9s 6s]
sayhey48: bets $0.20
delm44: calls $0.20
*** TURN *** [Qh 9s 6s] [6d]
sayhey48: checks
delm44: bets $0.47
sayhey48: folds
Uncalled bet ($0.47) returned to delm44
delm44 collected $0.95 from pot
delm44: doesn't show hand
*** SUMMARY ***
Total pot $1 | Rake $0.05
Board [Qh 9s 6s 6d]
Seat 1: sayhey48 (small blind) folded on the Turn
Seat 3: delm44 (big blind) collected ($0.95)
Seat 5: tapouttazz9 (button) folded before Flop (didn't bet)


PokerStars Hand #157027516793:  Hold'em No Limit ($0.05/$0.10 USD) - 2016/08/16 16:22:32 ET
Table 'Apus' 6-max Seat #3 is the button
Seat 1: sayhey48 ($8.34 in chips)
Seat 3: delm44 ($2.84 in chips)
delm44: posts small blind $0.05
sayhey48: posts big blind $0.10
*** HOLE CARDS ***
delm44: calls $0.05
ScubaD23 joins the table at seat #2
sayhey48: raises $0.30 to $0.40
delm44: folds
Uncalled bet ($0.30) returned to sayhey48
sayhey48 collected $0.20 from pot
sayhey48: doesn't show hand
*** SUMMARY ***
Total pot $0.20 | Rake $0
Seat 1: sayhey48 (big blind) collected ($0.20)
Seat 3: delm44 (button) (small blind) folded before Flop


PokerStars Hand #157027517318:  Hold'em No Limit ($0.05/$0.10 USD) - 2016/08/16 16:24:41 ET
Table 'Apus' 6-max Seat #2 is the button
Seat 2: Schug ($8 in chips)
Seat 3: dogboy1088 ($4 in chips)
Schug: posts small blind $0.05
dogboy1088: posts big blind $0.10
*** HOLE CARDS ***
Apt1a joins the table at seat #6
Schug: calls $0.05
dogboy1088: checks
*** FLOP *** [2c Qs 4d]
dogboy1088: checks
Schug: bets $0.10
dogboy1088: calls $0.10
*** TURN *** [2c Qs 4d] [Td]
dogboy1088: checks
Schug: checks
*** RIVER *** [2c Qs 4d Td] [7s]
dogboy1088: checks
Schug: checks
*** SHOW DOWN ***
dogboy1088: shows [Ts Ad] (a pair of Tens)
Schug: mucks hand
dogboy1088 collected $0.38 from pot
*** SUMMARY ***
Total pot $0.40 | Rake $0.02
Board [2c Qs 4d Td 7s]
Seat 2: Schug (button) (small blind) mucked
Seat 3: dogboy1088 (big blind) showed [Ts Ad] and won ($0.38) with a pair of Tens


PokerStars Hand #157027517385:  Hold'em No Limit ($0.05/$0.10 USD) - 2016/08/16 16:24:58 ET
Table 'Apus' 6-max Seat #3 is the button
Seat 2: Schug ($7.80 in chips)
Seat 3: dogboy1088 ($4.18 in chips)
dogboy1088: posts small blind $0.05
Schug: posts big blind $0.10
*** HOLE CARDS ***
dogboy1088: calls $0.05
Schug: checks
*** FLOP *** [4s 3c Tc]
Schug: checks
sayhey48 joins the table at seat #1
dogboy1088: bets $0.20
Schug: folds
Uncalled bet ($0.20) returned to dogboy1088
dogboy1088 collected $0.19 from pot
dogboy1088: doesn't show hand
*** SUMMARY ***
Total pot $0.20 | Rake $0.01
Board [4s 3c Tc]
Seat 2: Schug (big blind) folded on the Flop
Seat 3: dogboy1088 (button) (small blind) collected ($0.19)


PokerStars Hand #157027517438:  Hold'em No Limit ($0.05/$0.10 USD) - 2016/08/16 16:25:10 ET
Table 'Apus' 6-max Seat #2 is the button
Seat 2: Schug ($7.70 in chips)
Seat 3: dogboy1088 ($4.27 in chips)
Schug: posts small blind $0.05
dogboy1088: posts big blind $0.10
*** HOLE CARDS ***
Schug: calls $0.05
dogboy1088: checks
*** FLOP *** [8d Qd 8s]
dogboy1088: checks
Schug: checks
*** TURN *** [8d Qd 8s] [2c]
dogboy1088: bets $0.20
Schug: folds
Uncalled bet ($0.20) returned to dogboy1088
dogboy1088 collected $0.19 from pot
dogboy1088: doesn't show hand
*** SUMMARY ***
Total pot $0.20 | Rake $0.01
Board [8d Qd 8s 2c]
Seat 2: Schug (button) (small blind) folded on the Turn
Seat 3: dogboy1088 (big blind) collected ($0.19)


PokerStars Hand #157027517488:  Hold'em No Limit ($0.05/$0.10 USD) - 2016/08/16 16:25:22 ET
Table 'Apus' 6-max Seat #2 is the button
Seat 1: sayhey48 ($8.44 in chips)
Seat 2: Schug ($7.60 in chips)
Seat 3: dogboy1088 ($4.36 in chips)
dogboy1088: posts small blind $0.05
sayhey48: posts big blind $0.10
*** HOLE CARDS ***
Schug: calls $0.10
dogboy1088: calls $0.05
sayhey48: checks
*** FLOP *** [2c 8c 6h]
dogboy1088: checks
sayhey48: checks
Schug: checks
*** TURN *** [2c 8c 6h] [8d]
dogboy1088: checks
sayhey48: checks
Schug: checks
*** RIVER *** [2c 8c 6h 8d] [Jc]
dogboy1088: bets $0.20
sayhey48: folds
Schug: folds
Uncalled bet ($0.20) returned to dogboy1088
dogboy1088 collected $0.28 from pot
dogboy1088: doesn't show hand
*** SUMMARY ***
Total pot $0.30 | Rake $0.02
Board [2c 8c 6h 8d Jc]
Seat 1: sayhey48 (big blind) folded on the River
Seat 2: Schug (button) folded on the River
Seat 3: dogboy1088 (small blind) collected ($0.28)


PokerStars Hand #157027517638:  Hold'em No Limit ($0.05/$0.10 USD) - 2016/08/16 16:25:59 ET
Table 'Apus' 6-max Seat #3 is the button
Seat 1: sayhey48 ($8.34 in chips)
Seat 2: Schug ($7.50 in chips)
Seat 3: dogboy1088 ($4.54 in chips)
sayhey48: posts small blind $0.05
Schug: posts big blind $0.10
*** HOLE CARDS ***
dogboy1088: calls $0.10
sayhey48: raises $0.30 to $0.40
Schug: folds
dogboy1088: calls $0.30
*** FLOP *** [4c 7d 5s]
sayhey48: checks
dogboy1088: bets $0.86
sayhey48: raises $1.04 to $1.90
dogboy1088: calls $1.04
*** TURN *** [4c 7d 5s] [2c]
sayhey48: bets $2.23
dogboy1088: calls $2.23
*** RIVER *** [4c 7d 5s 2c] [Jc]
sayhey48: bets $0.10
dogboy1088: calls $0.01 and is all-in
Uncalled bet ($0.09) returned to sayhey48
*** SHOW DOWN ***
sayhey48: shows [7s 7c] (three of a kind, Sevens)
dogboy1088: shows [9c 9s] (a pair of Nines)
sayhey48 collected $8.72 from pot
*** SUMMARY ***
Total pot $9.18 | Rake $0.46
Board [4c 7d 5s 2c Jc]
Seat 1: sayhey48 (small blind) showed [7s 7c] and won ($8.72) with three of a kind, Sevens
Seat 2: Schug (big blind) folded before Flop
Seat 3: dogboy1088 (button) showed [9c 9s] and lost with a pair of Nines


PokerStars Hand #157027517818:  Hold'em No Limit ($0.05/$0.10 USD) - 2016/08/16 16:26:43 ET
Table 'Apus' 6-max Seat #1 is the button
Seat 1: sayhey48 ($12.52 in chips)
Seat 2: Schug ($7.40 in chips)
Seat 5: tapouttazz9 ($10 in chips)
Schug: posts small blind $0.05
tapouttazz9: posts big blind $0.10
*** HOLE CARDS ***
Dealt to tapouttazz9 [9d 9s]
sayhey48: folds
Schug: calls $0.05
tapouttazz9: checks
*** FLOP *** [6s As Jd]
Schug: bets $0.19
tapouttazz9: calls $0.19
*** TURN *** [6s As Jd] [5c]
Schug: bets $0.10
tapouttazz9: calls $0.10
*** RIVER *** [6s As Jd 5c] [Ah]
Schug: bets $0.10
tapouttazz9: raises $0.47 to $0.57
Schug: folds
Uncalled bet ($0.47) returned to tapouttazz9
tapouttazz9 collected $0.93 from pot
*** SUMMARY ***
Total pot $0.98 | Rake $0.05
Board [6s As Jd 5c Ah]
Seat 1: sayhey48 (button) folded before Flop (didn't bet)
Seat 2: Schug (small blind) folded on the River
Seat 5: tapouttazz9 (big blind) collected ($0.93)


PokerStars Hand #157027517942:  Hold'em No Limit ($0.05/$0.10 USD) - 2016/08/16 16:27:12 ET
Table 'Apus' 6-max Seat #2 is the button
Seat 1: sayhey48 ($12.52 in chips)
Seat 2: Schug ($6.91 in chips)
Seat 5: tapouttazz9 ($10.44 in chips)
dogboy1088 will be allowed to play after the button
tapouttazz9: posts small blind $0.05
sayhey48: posts big blind $0.10
*** HOLE CARDS ***
Dealt to tapouttazz9 [6s 8s]
Schug: calls $0.10
tapouttazz9: folds
sayhey48: raises $0.20 to $0.30
Schug: calls $0.20
*** FLOP *** [2h Ks 2s]
sayhey48: checks
Schug: checks
*** TURN *** [2h Ks 2s] [4d]
sayhey48: bets $0.20
Schug: calls $0.20
*** RIVER *** [2h Ks 2s 4d] [3h]
sayhey48: bets $0.30
Schug: calls $0.30
*** SHOW DOWN ***
sayhey48: shows [Ah 5d] (a straight, Ace to Five)
Schug: mucks hand
sayhey48 collected $1.57 from pot
*** SUMMARY ***
Total pot $1.65 | Rake $0.08
Board [2h Ks 2s 4d 3h]
Seat 1: sayhey48 (big blind) showed [Ah 5d] and won ($1.57) with a straight, Ace to Five
Seat 2: Schug (button) mucked [Qd Ac]
Seat 5: tapouttazz9 (small blind) folded before Flop


PokerStars Hand #157027518121:  Hold'em No Limit ($0.05/$0.10 USD) - 2016/08/16 16:27:58 ET
Table 'Apus' 6-max Seat #5 is the button
Seat 1: sayhey48 ($13.29 in chips)
Seat 2: Schug ($6.11 in chips)
Seat 5: tapouttazz9 ($10.39 in chips)
sayhey48: posts small blind $0.05
Schug: posts big blind $0.10
dogboy1088: sits out
*** HOLE CARDS ***
Dealt to tapouttazz9 [9s Qc]
tapouttazz9: folds
sayhey48: folds
Uncalled bet ($0.05) returned to Schug
Schug collected $0.10 from pot
Schug: doesn't show hand
*** SUMMARY ***
Total pot $0.10 | Rake $0
Seat 1: sayhey48 (small blind) folded before Flop
Seat 2: Schug (big blind) collected ($0.10)
Seat 5: tapouttazz9 (button) folded before Flop (didn't bet)


PokerStars Hand #157027518169:  Hold'em No Limit ($0.05/$0.10 USD) - 2016/08/16 16:28:07 ET
Table 'Apus' 6-max Seat #1 is the button
Seat 1: sayhey48 ($13.24 in chips)
Seat 2: Schug ($6.16 in chips)
Seat 3: dogboy1088 ($4 in chips)
Seat 5: tapouttazz9 ($10.39 in chips)
Schug: posts small blind $0.05
dogboy1088: posts big blind $0.10
*** HOLE CARDS ***
Dealt to tapouttazz9 [8d Kc]
tapouttazz9: folds
sayhey48: folds
Schug: calls $0.05
dogboy1088: checks
*** FLOP *** [3h Qs 8c]
Schug: checks
dogboy1088: checks
*** TURN *** [3h Qs 8c] [Qc]
Schug: checks
dogboy1088: checks
*** RIVER *** [3h Qs 8c Qc] [5h]
lefty0130 was removed from the table for failing to post
Schug: checks
dogboy1088: checks
*** SHOW DOWN ***
Schug: shows [9s 4d] (a pair of Queens)
dogboy1088: shows [Ts Jd] (a pair of Queens - Jack kicker)
dogboy1088 collected $0.19 from pot
*** SUMMARY ***
Total pot $0.20 | Rake $0.01
Board [3h Qs 8c Qc 5h]
Seat 1: sayhey48 (button) folded before Flop (didn't bet)
Seat 2: Schug (small blind) showed [9s 4d] and lost with a pair of Queens
Seat 3: dogboy1088 (big blind) showed [Ts Jd] and won ($0.19) with a pair of Queens
Seat 5: tapouttazz9 folded before Flop (didn't bet)


PokerStars Hand #157027518267:  Hold'em No Limit ($0.05/$0.10 USD) - 2016/08/16 16:28:30 ET
Table 'Apus' 6-max Seat #2 is the button
Seat 1: sayhey48 ($13.24 in chips)
Seat 2: Schug ($6.06 in chips)
Seat 3: dogboy1088 ($4.09 in chips)
Seat 5: tapouttazz9 ($10.39 in chips)
dogboy1088: posts small blind $0.05
tapouttazz9: posts big blind $0.10
*** HOLE CARDS ***
Dealt to tapouttazz9 [7s Qd]
sayhey48: folds
Schug: folds
dogboy1088: calls $0.05
tapouttazz9: checks
*** FLOP *** [2c 6s 2d]
dogboy1088: checks
tapouttazz9: checks
*** TURN *** [2c 6s 2d] [5c]
dogboy1088: checks
tapouttazz9: checks
*** RIVER *** [2c 6s 2d 5c] [7d]
dogboy1088: bets $0.20
tapouttazz9: calls $0.20
*** SHOW DOWN ***
dogboy1088: shows [Qs 9d] (a pair of Deuces)
tapouttazz9: shows [7s Qd] (two pair, Sevens and Deuces)
tapouttazz9 collected $0.57 from pot
*** SUMMARY ***
Total pot $0.60 | Rake $0.03
Board [2c 6s 2d 5c 7d]
Seat 1: sayhey48 folded before Flop (didn't bet)
Seat 2: Schug (button) folded before Flop (didn't bet)
Seat 3: dogboy1088 (small blind) showed [Qs 9d] and lost with a pair of Deuces
Seat 5: tapouttazz9 (big blind) showed [7s Qd] and won ($0.57) with two pair, Sevens and Deuces


PokerStars Hand #157027518358:  Hold'em No Limit ($0.05/$0.10 USD) - 2016/08/16 16:28:49 ET
Table 'Apus' 6-max Seat #3 is the button
Seat 1: sayhey48 ($13.24 in chips)
Seat 2: Schug ($6.06 in chips)
Seat 3: dogboy1088 ($3.79 in chips)
Seat 5: tapouttazz9 ($10.66 in chips)
tapouttazz9: posts small blind $0.05
sayhey48: posts big blind $0.10
*** HOLE CARDS ***
Dealt to tapouttazz9 [6s 5d]
Schug: folds
dogboy1088: folds
tapouttazz9: folds
Uncalled bet ($0.05) returned to sayhey48
sayhey48 collected $0.10 from pot
sayhey48: doesn't show hand
*** SUMMARY ***
Total pot $0.10 | Rake $0
Seat 1: sayhey48 (big blind) collected ($0.10)
Seat 2: Schug folded before Flop (didn't bet)
Seat 3: dogboy1088 (button) folded before Flop (didn't bet)
Seat 5: tapouttazz9 (small blind) folded before Flop


PokerStars Hand #157027518380:  Hold'em No Limit ($0.05/$0.10 USD) - 2016/08/16 16:28:54 ET
Table 'Apus' 6-max Seat #5 is the button
Seat 1: sayhey48 ($13.29 in chips)
Seat 2: Schug ($6.06 in chips)
Seat 3: dogboy1088 ($3.79 in chips)
Seat 5: tapouttazz9 ($10.61 in chips)
sayhey48: posts small blind $0.05
Schug: posts big blind $0.10
*** HOLE CARDS ***
Dealt to tapouttazz9 [4d 3c]
dogboy1088: folds
tapouttazz9: folds
sayhey48: raises $0.10 to $0.20
Schug: calls $0.10
*** FLOP *** [2d Th 7d]
sally boy 10 joins the table at seat #4
sayhey48: bets $0.30
Schug: calls $0.30
*** TURN *** [2d Th 7d] [2s]
sayhey48: bets $0.30
Schug: calls $0.30
*** RIVER *** [2d Th 7d 2s] [7c]
sayhey48: bets $0.30
Schug: calls $0.30
*** SHOW DOWN ***
sayhey48: shows [Kd Kh] (two pair, Kings and Sevens)
Schug: mucks hand
sayhey48 collected $2.09 from pot
*** SUMMARY ***
Total pot $2.20 | Rake $0.11
Board [2d Th 7d 2s 7c]
Seat 1: sayhey48 (small blind) showed [Kd Kh] and won ($2.09) with two pair, Kings and Sevens
Seat 2: Schug (big blind) mucked [9d Qd]
Seat 3: dogboy1088 folded before Flop (didn't bet)
Seat 5: tapouttazz9 (button) folded before Flop (didn't bet)


PokerStars Hand #157027518518:  Hold'em No Limit ($0.05/$0.10 USD) - 2016/08/16 16:29:26 ET
Table 'Apus' 6-max Seat #1 is the button
Seat 1: sayhey48 ($14.28 in chips)
Seat 2: Schug ($4.96 in chips)
Seat 3: dogboy1088 ($3.79 in chips)
Seat 5: tapouttazz9 ($10.61 in chips)
Schug: posts small blind $0.05
dogboy1088: posts big blind $0.10
sally boy 10: sits out
*** HOLE CARDS ***
Dealt to tapouttazz9 [6s 5c]
tapouttazz9: folds
sayhey48: folds
Schug: calls $0.05
dogboy1088: checks
*** FLOP *** [Kc Ks 2h]
Schug: checks
sally boy 10 leaves the table
dogboy1088: checks
*** TURN *** [Kc Ks 2h] [9h]
Schug: checks
dogboy1088: checks
*** RIVER *** [Kc Ks 2h 9h] [Ac]
Schug: bets $0.50
dogboy1088: folds
Uncalled bet ($0.50) returned to Schug
Schug collected $0.19 from pot
Schug: doesn't show hand
*** SUMMARY ***
Total pot $0.20 | Rake $0.01
Board [Kc Ks 2h 9h Ac]
Seat 1: sayhey48 (button) folded before Flop (didn't bet)
Seat 2: Schug (small blind) collected ($0.19)
Seat 3: dogboy1088 (big blind) folded on the River
Seat 5: tapouttazz9 folded before Flop (didn't bet)


PokerStars Hand #157027518622:  Hold'em No Limit ($0.05/$0.10 USD) - 2016/08/16 16:29:50 ET
Table 'Apus' 6-max Seat #2 is the button
Seat 1: sayhey48 ($14.28 in chips)
Seat 2: Schug ($5.05 in chips)
Seat 3: dogboy1088 ($3.69 in chips)
Seat 5: tapouttazz9 ($10.61 in chips)
dogboy1088: posts small blind $0.05
tapouttazz9: posts big blind $0.10
*** HOLE CARDS ***
Dealt to tapouttazz9 [Qc 9c]
sayhey48: raises $0.20 to $0.30
Schug: folds
dogboy1088: calls $0.25
tapouttazz9: folds
*** FLOP *** [Jc Th 5c]
dogboy1088: checks
sayhey48: checks
*** TURN *** [Jc Th 5c] [9d]
dogboy1088: bets $1
sayhey48: folds
Uncalled bet ($1) returned to dogboy1088
dogboy1088 collected $0.66 from pot
dogboy1088: doesn't show hand
*** SUMMARY ***
Total pot $0.70 | Rake $0.04
Board [Jc Th 5c 9d]
Seat 1: sayhey48 folded on the Turn
Seat 2: Schug (button) folded before Flop (didn't bet)
Seat 3: dogboy1088 (small blind) collected ($0.66)
Seat 5: tapouttazz9 (big blind) folded before Flop


PokerStars Hand #157027518696:  Hold'em No Limit ($0.05/$0.10 USD) - 2016/08/16 16:30:09 ET
Table 'Apus' 6-max Seat #3 is the button
Seat 1: sayhey48 ($13.98 in chips)
Seat 2: Schug ($5.05 in chips)
Seat 3: dogboy1088 ($4.05 in chips)
Seat 5: tapouttazz9 ($10.51 in chips)
tapouttazz9: posts small blind $0.05
sayhey48: posts big blind $0.10
*** HOLE CARDS ***
Dealt to tapouttazz9 [8d 6c]
Schug: calls $0.10
dogboy1088: folds
tapouttazz9: folds
sayhey48: checks
*** FLOP *** [Jc 7c Kd]
sayhey48: checks
Schug: checks
*** TURN *** [Jc 7c Kd] [3h]
sayhey48: checks
Schug: checks
*** RIVER *** [Jc 7c Kd 3h] [9c]
sayhey48: checks
Schug: bets $0.12
sayhey48: folds
Uncalled bet ($0.12) returned to Schug
Schug collected $0.24 from pot
Schug: doesn't show hand
*** SUMMARY ***
Total pot $0.25 | Rake $0.01
Board [Jc 7c Kd 3h 9c]
Seat 1: sayhey48 (big blind) folded on the River
Seat 2: Schug collected ($0.24)
Seat 3: dogboy1088 (button) folded before Flop (didn't bet)
Seat 5: tapouttazz9 (small blind) folded before Flop


PokerStars Hand #157027518812:  Hold'em No Limit ($0.05/$0.10 USD) - 2016/08/16 16:30:35 ET
Table 'Apus' 6-max Seat #5 is the button
Seat 1: sayhey48 ($13.88 in chips)
Seat 2: Schug ($5.19 in chips)
Seat 3: dogboy1088 ($4.05 in chips)
Seat 5: tapouttazz9 ($10.46 in chips)
sayhey48: posts small blind $0.05
Schug: posts big blind $0.10
*** HOLE CARDS ***
Dealt to tapouttazz9 [5h Jd]
dogboy1088: calls $0.10
tapouttazz9: folds
sayhey48: calls $0.05
Schug: checks
*** FLOP *** [Ts 3d 7c]
sayhey48: checks
Schug: checks
dogboy1088: checks
*** TURN *** [Ts 3d 7c] [Ah]
sayhey48: bets $0.20
Schug: folds
dogboy1088: calls $0.20
*** RIVER *** [Ts 3d 7c Ah] [9d]
sayhey48: checks
dogboy1088: bets $0.66
sayhey48: folds
Uncalled bet ($0.66) returned to dogboy1088
dogboy1088 collected $0.66 from pot
dogboy1088: doesn't show hand
*** SUMMARY ***
Total pot $0.70 | Rake $0.04
Board [Ts 3d 7c Ah 9d]
Seat 1: sayhey48 (small blind) folded on the River
Seat 2: Schug (big blind) folded on the Turn
Seat 3: dogboy1088 collected ($0.66)
Seat 5: tapouttazz9 (button) folded before Flop (didn't bet)


PokerStars Hand #157027518940:  Hold'em No Limit ($0.05/$0.10 USD) - 2016/08/16 16:31:07 ET
Table 'Apus' 6-max Seat #1 is the button
Seat 1: sayhey48 ($13.58 in chips)
Seat 2: Schug ($5.09 in chips)
Seat 3: dogboy1088 ($4.41 in chips)
Seat 5: tapouttazz9 ($10.46 in chips)
Schug: posts small blind $0.05
dogboy1088: posts big blind $0.10
*** HOLE CARDS ***
Dealt to tapouttazz9 [Js 9d]
tapouttazz9: folds
sayhey48: calls $0.10
Schug: calls $0.05
dogboy1088: checks
*** FLOP *** [4h Ad 4c]
Schug: checks
dogboy1088: checks
sayhey48: checks
*** TURN *** [4h Ad 4c] [2h]
Schug: bets $0.50
dogboy1088: folds
sayhey48: raises $0.50 to $1
Schug: calls $0.50
*** RIVER *** [4h Ad 4c 2h] [5d]
Schug: checks
sayhey48: bets $1
Schug: calls $1
*** SHOW DOWN ***
sayhey48: shows [4d As] (a full house, Fours full of Aces)
Schug: mucks hand
sayhey48 collected $4.08 from pot
*** SUMMARY ***
Total pot $4.30 | Rake $0.22
Board [4h Ad 4c 2h 5d]
Seat 1: sayhey48 (button) showed [4d As] and won ($4.08) with a full house, Fours full of Aces
Seat 2: Schug (small blind) mucked [3c 5s]
Seat 3: dogboy1088 (big blind) folded on the Turn
Seat 5: tapouttazz9 folded before Flop (didn't bet)


PokerStars Hand #157027519169:  Hold'em No Limit ($0.05/$0.10 USD) - 2016/08/16 16:32:01 ET
Table 'Apus' 6-max Seat #2 is the button
Seat 1: sayhey48 ($15.56 in chips)
Seat 2: Schug ($2.99 in chips)
Seat 3: dogboy1088 ($4.31 in chips)
Seat 5: tapouttazz9 ($10.46 in chips)
dogboy1088: posts small blind $0.05
tapouttazz9: posts big blind $0.10
*** HOLE CARDS ***
Dealt to tapouttazz9 [8c 6c]
sayhey48: calls $0.10
Schug: folds
dogboy1088: calls $0.05
tapouttazz9: checks
*** FLOP *** [5h As 3d]
dogboy1088: checks
tapouttazz9: checks
sayhey48: bets $0.40
dogboy1088: folds
tapouttazz9: folds
Uncalled bet ($0.40) returned to sayhey48
sayhey48 collected $0.28 from pot
sayhey48: doesn't show hand
*** SUMMARY ***
Total pot $0.30 | Rake $0.02
Board [5h As 3d]
Seat 1: sayhey48 collected ($0.28)
Seat 2: Schug (button) folded before Flop (didn't bet)
Seat 3: dogboy1088 (small blind) folded on the Flop
Seat 5: tapouttazz9 (big blind) folded on the Flop


PokerStars Hand #157027519297:  Hold'em No Limit ($0.05/$0.10 USD) - 2016/08/16 16:32:31 ET
Table 'Apus' 6-max Seat #3 is the button
Seat 1: sayhey48 ($15.74 in chips)
Seat 2: Schug ($2.99 in chips)
Seat 3: dogboy1088 ($4.21 in chips)
Seat 5: tapouttazz9 ($10.36 in chips)
tapouttazz9: posts small blind $0.05
Apt1a was removed from the table for failing to post
sayhey48: posts big blind $0.10
*** HOLE CARDS ***
Dealt to tapouttazz9 [5d 8d]
Schug: folds
dogboy1088: raises $0.90 to $1
tapouttazz9: folds
sayhey48: folds
Uncalled bet ($0.90) returned to dogboy1088
dogboy1088 collected $0.25 from pot
dogboy1088: doesn't show hand
*** SUMMARY ***
Total pot $0.25 | Rake $0
Seat 1: sayhey48 (big blind) folded before Flop
Seat 2: Schug folded before Flop (didn't bet)
Seat 3: dogboy1088 (button) collected ($0.25)
Seat 5: tapouttazz9 (small blind) folded before Flop


PokerStars Hand #157027519402:  Hold'em No Limit ($0.05/$0.10 USD) - 2016/08/16 16:32:56 ET
Table 'Apus' 6-max Seat #5 is the button
Seat 1: sayhey48 ($15.64 in chips)
Seat 2: Schug ($10 in chips)
Seat 3: dogboy1088 ($4.36 in chips)
Seat 5: tapouttazz9 ($10.31 in chips)
sayhey48: posts small blind $0.05
Schug: posts big blind $0.10
*** HOLE CARDS ***
Dealt to tapouttazz9 [As 2h]
dogboy1088: folds
tapouttazz9: folds
sayhey48: calls $0.05
Schug: checks
*** FLOP *** [Qh 5d 6s]
sayhey48: checks
Schug: bets $0.19
sayhey48: folds
Uncalled bet ($0.19) returned to Schug
Schug collected $0.19 from pot
Schug: doesn't show hand
*** SUMMARY ***
Total pot $0.20 | Rake $0.01
Board [Qh 5d 6s]
Seat 1: sayhey48 (small blind) folded on the Flop
Seat 2: Schug (big blind) collected ($0.19)
Seat 3: dogboy1088 folded before Flop (didn't bet)
Seat 5: tapouttazz9 (button) folded before Flop (didn't bet)


PokerStars Hand #157027519495:  Hold'em No Limit ($0.05/$0.10 USD) - 2016/08/16 16:33:17 ET
Table 'Apus' 6-max Seat #1 is the button
Seat 1: sayhey48 ($15.54 in chips)
Seat 2: Schug ($10.09 in chips)
Seat 3: dogboy1088 ($4.36 in chips)
Seat 5: tapouttazz9 ($10.31 in chips)
Schug: posts small blind $0.05
dogboy1088: posts big blind $0.10
*** HOLE CARDS ***
Dealt to tapouttazz9 [2c 3c]
tapouttazz9: folds
sayhey48: raises $0.30 to $0.40
Schug: folds
dogboy1088: folds
Uncalled bet ($0.30) returned to sayhey48
sayhey48 collected $0.25 from pot
sayhey48: doesn't show hand
*** SUMMARY ***
Total pot $0.25 | Rake $0
Seat 1: sayhey48 (button) collected ($0.25)
Seat 2: Schug (small blind) folded before Flop
Seat 3: dogboy1088 (big blind) folded before Flop
Seat 5: tapouttazz9 folded before Flop (didn't bet)


PokerStars Hand #157027519551:  Hold'em No Limit ($0.05/$0.10 USD) - 2016/08/16 16:33:31 ET
Table 'Apus' 6-max Seat #2 is the button
Seat 1: sayhey48 ($15.69 in chips)
Seat 2: Schug ($10.04 in chips)
Seat 3: dogboy1088 ($4.26 in chips)
Seat 5: tapouttazz9 ($10.31 in chips)
dogboy1088: posts small blind $0.05
tapouttazz9: posts big blind $0.10
*** HOLE CARDS ***
Dealt to tapouttazz9 [8s 4h]
sayhey48: folds
Schug: folds
dogboy1088: calls $0.05
tapouttazz9: checks
*** FLOP *** [8h Ad Ts]
dogboy1088: checks
tapouttazz9: checks
*** TURN *** [8h Ad Ts] [4c]
AJDKKK joins the table at seat #4
dogboy1088: checks
tapouttazz9: checks
*** RIVER *** [8h Ad Ts 4c] [2c]
dogboy1088: checks
tapouttazz9: checks
*** SHOW DOWN ***
dogboy1088: shows [Kc 6h] (high card Ace)
tapouttazz9: shows [8s 4h] (two pair, Eights and Fours)
tapouttazz9 collected $0.19 from pot
*** SUMMARY ***
Total pot $0.20 | Rake $0.01
Board [8h Ad Ts 4c 2c]
Seat 1: sayhey48 folded before Flop (didn't bet)
Seat 2: Schug (button) folded before Flop (didn't bet)
Seat 3: dogboy1088 (small blind) showed [Kc 6h] and lost with high card Ace
Seat 5: tapouttazz9 (big blind) showed [8s 4h] and won ($0.19) with two pair, Eights and Fours


PokerStars Hand #157027519639:  Hold'em No Limit ($0.05/$0.10 USD) - 2016/08/16 16:33:54 ET
Table 'Apus' 6-max Seat #3 is the button
Seat 1: sayhey48 ($15.69 in chips)
Seat 2: Schug ($10.04 in chips)
Seat 3: dogboy1088 ($4.16 in chips)
Seat 5: tapouttazz9 ($10.40 in chips)
AJDKKK will be allowed to play after the button
tapouttazz9: posts small blind $0.05
sayhey48: posts big blind $0.10
*** HOLE CARDS ***
Dealt to tapouttazz9 [9h Ks]
Schug: calls $0.10
dogboy1088: folds
tapouttazz9: folds
Apt1a joins the table at seat #6
sayhey48: raises $0.30 to $0.40
Schug: folds
Uncalled bet ($0.30) returned to sayhey48
sayhey48 collected $0.25 from pot
sayhey48: doesn't show hand
*** SUMMARY ***
Total pot $0.25 | Rake $0
Seat 1: sayhey48 (big blind) collected ($0.25)
Seat 2: Schug folded before Flop
Seat 3: dogboy1088 (button) folded before Flop (didn't bet)
Seat 5: tapouttazz9 (small blind) folded before Flop


PokerStars Hand #157027519760:  Hold'em No Limit ($0.05/$0.10 USD) - 2016/08/16 16:34:18 ET
Table 'Apus' 6-max Seat #5 is the button
Seat 1: sayhey48 ($15.84 in chips)
Seat 2: Schug ($9.94 in chips)
Seat 3: dogboy1088 ($4.16 in chips)
Seat 4: AJDKKK ($10 in chips)
Seat 5: tapouttazz9 ($10.35 in chips)
sayhey48: posts small blind $0.05
Schug: posts big blind $0.10
AJDKKK: posts big blind $0.10
*** HOLE CARDS ***
Dealt to tapouttazz9 [5h 7d]
dogboy1088: folds
AJDKKK: checks
tapouttazz9: folds
sayhey48: folds
Schug: checks
*** FLOP *** [5s Ah Ks]
Schug: checks
AJDKKK: bets $0.10
Schug: calls $0.10
*** TURN *** [5s Ah Ks] [Qd]
Schug: checks
AJDKKK: checks
*** RIVER *** [5s Ah Ks Qd] [Th]
Schug: checks
AJDKKK: bets $0.30
Schug: folds
Uncalled bet ($0.30) returned to AJDKKK
AJDKKK collected $0.43 from pot
AJDKKK: doesn't show hand
*** SUMMARY ***
Total pot $0.45 | Rake $0.02
Board [5s Ah Ks Qd Th]
Seat 1: sayhey48 (small blind) folded before Flop
Seat 2: Schug (big blind) folded on the River
Seat 3: dogboy1088 folded before Flop (didn't bet)
Seat 4: AJDKKK collected ($0.43)
Seat 5: tapouttazz9 (button) folded before Flop (didn't bet)


PokerStars Hand #157027519909:  Hold'em No Limit ($0.05/$0.10 USD) - 2016/08/16 16:34:51 ET
Table 'Apus' 6-max Seat #1 is the button
Seat 1: sayhey48 ($15.79 in chips)
Seat 2: Schug ($9.74 in chips)
Seat 3: dogboy1088 ($4.16 in chips)
Seat 4: AJDKKK ($10.23 in chips)
Seat 5: tapouttazz9 ($10.35 in chips)
Schug: posts small blind $0.05
dogboy1088: posts big blind $0.10
*** HOLE CARDS ***
Dealt to tapouttazz9 [Th Qd]
AJDKKK: folds
tapouttazz9: raises $0.20 to $0.30
sayhey48: folds
Schug: calls $0.25
dogboy1088: folds
*** FLOP *** [Qs Tc 3s]
Schug: checks
tapouttazz9: bets $0.33
Schug: calls $0.33
*** TURN *** [Qs Tc 3s] [6d]
Schug: checks
tapouttazz9: bets $0.64
Schug: folds
Uncalled bet ($0.64) returned to tapouttazz9
tapouttazz9 collected $1.29 from pot
*** SUMMARY ***
Total pot $1.36 | Rake $0.07
Board [Qs Tc 3s 6d]
Seat 1: sayhey48 (button) folded before Flop (didn't bet)
Seat 2: Schug (small blind) folded on the Turn
Seat 3: dogboy1088 (big blind) folded before Flop
Seat 4: AJDKKK folded before Flop (didn't bet)
Seat 5: tapouttazz9 collected ($1.29)


PokerStars Hand #157028772576:  Hold'em No Limit ($0.05/$0.10 USD) - 2016/08/16 16:35:28 ET
Table 'Apus' 6-max Seat #2 is the button
Seat 2: Schug ($9.11 in chips)
Seat 3: dogboy1088 ($4.06 in chips)
Seat 4: AJDKKK ($10.23 in chips)
Seat 5: tapouttazz9 ($11.01 in chips)
dogboy1088: posts small blind $0.05
AJDKKK: posts big blind $0.10
*** HOLE CARDS ***
Dealt to tapouttazz9 [8d Kc]
tapouttazz9: folds
Schug: calls $0.10
sayhey48 leaves the table
dogboy1088: folds
AJDKKK: checks
*** FLOP *** [7c 6d Ts]
lefty0130 joins the table at seat #1
AJDKKK: bets $0.10
Schug: calls $0.10
*** TURN *** [7c 6d Ts] [4s]
AJDKKK: checks
Schug: checks
*** RIVER *** [7c 6d Ts 4s] [Kh]
AJDKKK: bets $0.10
Schug: raises $0.63 to $0.73
AJDKKK: folds
Uncalled bet ($0.63) returned to Schug
Schug collected $0.62 from pot
Schug: doesn't show hand
*** SUMMARY ***
Total pot $0.65 | Rake $0.03
Board [7c 6d Ts 4s Kh]
Seat 2: Schug (button) collected ($0.62)
Seat 3: dogboy1088 (small blind) folded before Flop
Seat 4: AJDKKK (big blind) folded on the River
Seat 5: tapouttazz9 folded before Flop (didn't bet)


PokerStars Hand #157028772714:  Hold'em No Limit ($0.05/$0.10 USD) - 2016/08/16 16:35:56 ET
Table 'Apus' 6-max Seat #3 is the button
Seat 2: Schug ($9.43 in chips)
Seat 3: dogboy1088 ($4.01 in chips)
Seat 4: AJDKKK ($9.93 in chips)
Seat 5: tapouttazz9 ($11.01 in chips)
AJDKKK: posts small blind $0.05
tapouttazz9: posts big blind $0.10
lefty0130: sits out
*** HOLE CARDS ***
Dealt to tapouttazz9 [9c 7d]
Schug: folds
dogboy1088: folds
AJDKKK: calls $0.05
tapouttazz9: checks
*** FLOP *** [7h 3s 6h]
AJDKKK: checks
tapouttazz9: checks
*** TURN *** [7h 3s 6h] [9h]
AJDKKK: bets $0.10
tapouttazz9: calls $0.10
*** RIVER *** [7h 3s 6h 9h] [Kh]
AJDKKK: checks
tapouttazz9: checks
*** SHOW DOWN ***
AJDKKK: shows [4h 8c] (a flush, King high)
tapouttazz9: mucks hand
AJDKKK collected $0.38 from pot
*** SUMMARY ***
Total pot $0.40 | Rake $0.02
Board [7h 3s 6h 9h Kh]
Seat 2: Schug folded before Flop (didn't bet)
Seat 3: dogboy1088 (button) folded before Flop (didn't bet)
Seat 4: AJDKKK (small blind) showed [4h 8c] and won ($0.38) with a flush, King high
Seat 5: tapouttazz9 (big blind) mucked [9c 7d]


PokerStars Hand #157028772831:  Hold'em No Limit ($0.05/$0.10 USD) - 2016/08/16 16:36:22 ET
Table 'Apus' 6-max Seat #4 is the button
Seat 1: lefty0130 ($10.50 in chips)
Seat 2: Schug ($9.43 in chips)
Seat 3: dogboy1088 ($4.01 in chips)
Seat 4: AJDKKK ($10.11 in chips)
Seat 5: tapouttazz9 ($10.81 in chips)
tapouttazz9: posts small blind $0.05
lefty0130: posts big blind $0.10
*** HOLE CARDS ***
Dealt to tapouttazz9 [3h Ah]
Schug: calls $0.10
dogboy1088 has timed out
dogboy1088: folds
AJDKKK: folds
tapouttazz9: raises $0.20 to $0.30
lefty0130: folds
Schug: calls $0.20
*** FLOP *** [6s 7d As]
tapouttazz9: checks
Schug: checks
*** TURN *** [6s 7d As] [4h]
tapouttazz9: checks
Schug: checks
*** RIVER *** [6s 7d As 4h] [8s]
tapouttazz9: checks
Schug: bets $1
tapouttazz9: folds
Uncalled bet ($1) returned to Schug
Schug collected $0.66 from pot
Schug: doesn't show hand
*** SUMMARY ***
Total pot $0.70 | Rake $0.04
Board [6s 7d As 4h 8s]
Seat 1: lefty0130 (big blind) folded before Flop
Seat 2: Schug collected ($0.66)
Seat 3: dogboy1088 folded before Flop (didn't bet)
Seat 4: AJDKKK (button) folded before Flop (didn't bet)
Seat 5: tapouttazz9 (small blind) folded on the River


PokerStars Hand #157028773176:  Hold'em No Limit ($0.05/$0.10 USD) - 2016/08/16 16:37:44 ET
Table 'Apus' 6-max Seat #5 is the button
Seat 1: lefty0130 ($10.40 in chips)
Seat 2: Schug ($9.79 in chips)
Seat 3: dogboy1088 ($4.01 in chips)
Seat 4: AJDKKK ($10.11 in chips)
Seat 5: tapouttazz9 ($10.51 in chips)
lefty0130: posts small blind $0.05
Schug: posts big blind $0.10
*** HOLE CARDS ***
Dealt to tapouttazz9 [8c 7s]
dogboy1088: folds
AJDKKK: folds
tapouttazz9: folds
lefty0130: calls $0.05
Schug: checks
*** FLOP *** [Jh 8h Ac]
lefty0130: checks
Schug: bets $0.20
lefty0130 said, "hey schug"
lefty0130: folds
Uncalled bet ($0.20) returned to Schug
Schug collected $0.19 from pot
Schug: doesn't show hand
*** SUMMARY ***
Total pot $0.20 | Rake $0.01
Board [Jh 8h Ac]
Seat 1: lefty0130 (small blind) folded on the Flop
Seat 2: Schug (big blind) collected ($0.19)
Seat 3: dogboy1088 folded before Flop (didn't bet)
Seat 4: AJDKKK folded before Flop (didn't bet)
Seat 5: tapouttazz9 (button) folded before Flop (didn't bet)


PokerStars Hand #157028773305:  Hold'em No Limit ($0.05/$0.10 USD) - 2016/08/16 16:38:14 ET
Table 'Apus' 6-max Seat #1 is the button
Seat 1: lefty0130 ($10.30 in chips)
Seat 2: Schug ($9.88 in chips)
Seat 3: dogboy1088 ($4.01 in chips)
Seat 4: AJDKKK ($10.11 in chips)
Seat 5: tapouttazz9 ($10.51 in chips)
Schug: posts small blind $0.05
dogboy1088: posts big blind $0.10
*** HOLE CARDS ***
Dealt to tapouttazz9 [4h Ts]
Schug said, "hey lefty"
AJDKKK: folds
tapouttazz9: folds
lefty0130: folds
Schug: calls $0.05
dogboy1088: checks
*** FLOP *** [6h 9s 2d]
Schug: checks
dogboy1088: checks
*** TURN *** [6h 9s 2d] [Th]
Schug: checks
dogboy1088: checks
*** RIVER *** [6h 9s 2d Th] [5h]
Schug: checks
dogboy1088: checks
*** SHOW DOWN ***
Schug: shows [Qc Jd] (high card Queen)
dogboy1088: shows [7d Kc] (high card King)
dogboy1088 collected $0.19 from pot
*** SUMMARY ***
Total pot $0.20 | Rake $0.01
Board [6h 9s 2d Th 5h]
Seat 1: lefty0130 (button) folded before Flop (didn't bet)
Seat 2: Schug (small blind) showed [Qc Jd] and lost with high card Queen
Seat 3: dogboy1088 (big blind) showed [7d Kc] and won ($0.19) with high card King
Seat 4: AJDKKK folded before Flop (didn't bet)
Seat 5: tapouttazz9 folded before Flop (didn't bet)


PokerStars Hand #157028773416:  Hold'em No Limit ($0.05/$0.10 USD) - 2016/08/16 16:38:39 ET
Table 'Apus' 6-max Seat #2 is the button
Seat 1: lefty0130 ($10.30 in chips)
Seat 2: Schug ($9.78 in chips)
Seat 3: dogboy1088 ($4.10 in chips)
Seat 4: AJDKKK ($10.11 in chips)
Seat 5: tapouttazz9 ($10.51 in chips)
dogboy1088: posts small blind $0.05
AJDKKK: posts big blind $0.10
Apt1a: sits out
*** HOLE CARDS ***
Dealt to tapouttazz9 [Qd 2d]
tapouttazz9: folds
lefty0130: calls $0.10
Schug: folds
dogboy1088: calls $0.05
AJDKKK: checks
*** FLOP *** [5h Qh 7s]
dogboy1088: checks
AJDKKK: checks
lefty0130: checks
*** TURN *** [5h Qh 7s] [Qs]
dogboy1088: checks
AJDKKK: bets $0.10
lefty0130: folds
dogboy1088: calls $0.10
*** RIVER *** [5h Qh 7s Qs] [9h]
dogboy1088: checks
AJDKKK: checks
*** SHOW DOWN ***
dogboy1088: shows [As Tc] (a pair of Queens)
AJDKKK: mucks hand
dogboy1088 collected $0.48 from pot
*** SUMMARY ***
Total pot $0.50 | Rake $0.02
Board [5h Qh 7s Qs 9h]
Seat 1: lefty0130 folded on the Turn
Seat 2: Schug (button) folded before Flop (didn't bet)
Seat 3: dogboy1088 (small blind) showed [As Tc] and won ($0.48) with a pair of Queens
Seat 4: AJDKKK (big blind) mucked [4s Td]
Seat 5: tapouttazz9 folded before Flop (didn't bet)


PokerStars Hand #157028773550:  Hold'em No Limit ($0.05/$0.10 USD) - 2016/08/16 16:39:08 ET
Table 'Apus' 6-max Seat #3 is the button
Seat 1: lefty0130 ($10.20 in chips)
Seat 2: Schug ($9.78 in chips)
Seat 3: dogboy1088 ($4.38 in chips)
Seat 4: AJDKKK ($9.91 in chips)
Seat 5: tapouttazz9 ($10.51 in chips)
AJDKKK: posts small blind $0.05
tapouttazz9: posts big blind $0.10
Apt1a: sits out
*** HOLE CARDS ***
Dealt to tapouttazz9 [7s 6c]
lefty0130: folds
Schug: calls $0.10
dogboy1088: folds
AJDKKK: calls $0.05
tapouttazz9: checks
*** FLOP *** [6d Jh 9s]
AJDKKK: checks
tapouttazz9: checks
Schug: bets $0.14
AJDKKK: calls $0.14
tapouttazz9: folds
*** TURN *** [6d Jh 9s] [Kd]
AJDKKK: checks
Schug: bets $0.27
AJDKKK: folds
Uncalled bet ($0.27) returned to Schug
Schug collected $0.55 from pot
Schug: doesn't show hand
*** SUMMARY ***
Total pot $0.58 | Rake $0.03
Board [6d Jh 9s Kd]
Seat 1: lefty0130 folded before Flop (didn't bet)
Seat 2: Schug collected ($0.55)
Seat 3: dogboy1088 (button) folded before Flop (didn't bet)
Seat 4: AJDKKK (small blind) folded on the Turn
Seat 5: tapouttazz9 (big blind) folded on the Flop


PokerStars Hand #157028773713:  Hold'em No Limit ($0.05/$0.10 USD) - 2016/08/16 16:39:46 ET
Table 'Apus' 6-max Seat #4 is the button
Seat 1: lefty0130 ($10.20 in chips)
Seat 2: Schug ($10.09 in chips)
Seat 3: dogboy1088 ($4.38 in chips)
Seat 4: AJDKKK ($9.67 in chips)
Seat 5: tapouttazz9 ($10.41 in chips)
Seat 6: Apt1a ($13.62 in chips)
tapouttazz9: posts small blind $0.05
Apt1a: posts big blind $0.10
*** HOLE CARDS ***
Dealt to tapouttazz9 [8c 5c]
lefty0130: folds
Schug: folds
dogboy1088: calls $0.10
AJDKKK: calls $0.10
tapouttazz9: folds
Apt1a: checks
*** FLOP *** [Qc As 3d]
Apt1a: checks
dogboy1088: checks
AJDKKK: bets $0.10
Apt1a: calls $0.10
dogboy1088: calls $0.10
*** TURN *** [Qc As 3d] [3s]
Apt1a: checks
dogboy1088: checks
AJDKKK: checks
*** RIVER *** [Qc As 3d 3s] [Jc]
Apt1a: bets $0.50
dogboy1088: folds
AJDKKK: calls $0.50
*** SHOW DOWN ***
Apt1a: shows [Ad 3c] (a full house, Threes full of Aces)
AJDKKK: mucks hand
Apt1a collected $1.57 from pot
*** SUMMARY ***
Total pot $1.65 | Rake $0.08
Board [Qc As 3d 3s Jc]
Seat 1: lefty0130 folded before Flop (didn't bet)
Seat 2: Schug folded before Flop (didn't bet)
Seat 3: dogboy1088 folded on the River
Seat 4: AJDKKK (button) mucked [6s Ac]
Seat 5: tapouttazz9 (small blind) folded before Flop
Seat 6: Apt1a (big blind) showed [Ad 3c] and won ($1.57) with a full house, Threes full of Aces


PokerStars Hand #157028774001:  Hold'em No Limit ($0.05/$0.10 USD) - 2016/08/16 16:40:56 ET
Table 'Apus' 6-max Seat #5 is the button
Seat 1: lefty0130 ($10.20 in chips)
Seat 2: Schug ($10.09 in chips)
Seat 3: dogboy1088 ($4.18 in chips)
Seat 4: AJDKKK ($8.97 in chips)
Seat 5: tapouttazz9 ($10.36 in chips)
Seat 6: Apt1a ($14.49 in chips)
Apt1a: posts small blind $0.05
lefty0130: posts big blind $0.10
*** HOLE CARDS ***
Dealt to tapouttazz9 [8h 8d]
Schug: folds
AJDKKK said, "nh"
dogboy1088: folds
AJDKKK: folds
tapouttazz9: raises $0.20 to $0.30
Apt1a: calls $0.25
lefty0130: folds
*** FLOP *** [7h Th 4c]
Apt1a said, "ty"
Apt1a: checks
tapouttazz9: checks
*** TURN *** [7h Th 4c] [6d]
Apt1a: bets $0.35
tapouttazz9: calls $0.35
*** RIVER *** [7h Th 4c 6d] [2s]
Apt1a: checks
tapouttazz9: checks
*** SHOW DOWN ***
Apt1a: shows [Jh Qh] (high card Queen)
tapouttazz9: shows [8h 8d] (a pair of Eights)
tapouttazz9 collected $1.33 from pot
*** SUMMARY ***
Total pot $1.40 | Rake $0.07
Board [7h Th 4c 6d 2s]
Seat 1: lefty0130 (big blind) folded before Flop
Seat 2: Schug folded before Flop (didn't bet)
Seat 3: dogboy1088 folded before Flop (didn't bet)
Seat 4: AJDKKK folded before Flop (didn't bet)
Seat 5: tapouttazz9 (button) showed [8h 8d] and won ($1.33) with a pair of Eights
Seat 6: Apt1a (small blind) showed [Jh Qh] and lost with high card Queen


PokerStars Hand #157028774193:  Hold'em No Limit ($0.05/$0.10 USD) - 2016/08/16 16:41:41 ET
Table 'Apus' 6-max Seat #6 is the button
Seat 1: lefty0130 ($10.10 in chips)
Seat 2: Schug ($10.09 in chips)
Seat 3: dogboy1088 ($4.18 in chips)
Seat 4: AJDKKK ($8.97 in chips)
Seat 5: tapouttazz9 ($11.04 in chips)
Seat 6: Apt1a ($13.84 in chips)
lefty0130: posts small blind $0.05
Schug: posts big blind $0.10
*** HOLE CARDS ***
Dealt to tapouttazz9 [8s 5s]
dogboy1088: calls $0.10
AJDKKK: folds
tapouttazz9: folds
Apt1a: folds
lefty0130: calls $0.05
Schug: checks
*** FLOP *** [5c Jd 7d]
lefty0130: bets $0.28
Schug: folds
dogboy1088: folds
Uncalled bet ($0.28) returned to lefty0130
lefty0130 collected $0.28 from pot
lefty0130: doesn't show hand
*** SUMMARY ***
Total pot $0.30 | Rake $0.02
Board [5c Jd 7d]
Seat 1: lefty0130 (small blind) collected ($0.28)
Seat 2: Schug (big blind) folded on the Flop
Seat 3: dogboy1088 folded on the Flop
Seat 4: AJDKKK folded before Flop (didn't bet)
Seat 5: tapouttazz9 folded before Flop (didn't bet)
Seat 6: Apt1a (button) folded before Flop (didn't bet)


PokerStars Hand #157028774303:  Hold'em No Limit ($0.05/$0.10 USD) - 2016/08/16 16:42:03 ET
Table 'Apus' 6-max Seat #1 is the button
Seat 1: lefty0130 ($10.28 in chips)
Seat 2: Schug ($9.99 in chips)
Seat 3: dogboy1088 ($4.08 in chips)
Seat 4: AJDKKK ($8.97 in chips)
Seat 5: tapouttazz9 ($11.04 in chips)
Seat 6: Apt1a ($13.84 in chips)
Schug: posts small blind $0.05
dogboy1088: posts big blind $0.10
*** HOLE CARDS ***
Dealt to tapouttazz9 [8d 9s]
AJDKKK: calls $0.10
tapouttazz9: folds
Apt1a: folds
lefty0130: folds
Schug: calls $0.05
dogboy1088: checks
*** FLOP *** [Js 7d Kh]
Schug: checks
dogboy1088: checks
AJDKKK: bets $0.14
Schug: folds
dogboy1088: calls $0.14
*** TURN *** [Js 7d Kh] [8s]
dogboy1088: checks
AJDKKK: checks
*** RIVER *** [Js 7d Kh 8s] [8c]
dogboy1088: checks
AJDKKK: checks
*** SHOW DOWN ***
dogboy1088: shows [7c 3s] (two pair, Eights and Sevens)
AJDKKK: shows [9d Jh] (two pair, Jacks and Eights)
AJDKKK collected $0.55 from pot
*** SUMMARY ***
Total pot $0.58 | Rake $0.03
Board [Js 7d Kh 8s 8c]
Seat 1: lefty0130 (button) folded before Flop (didn't bet)
Seat 2: Schug (small blind) folded on the Flop
Seat 3: dogboy1088 (big blind) showed [7c 3s] and lost with two pair, Eights and Sevens
Seat 4: AJDKKK showed [9d Jh] and won ($0.55) with two pair, Jacks and Eights
Seat 5: tapouttazz9 folded before Flop (didn't bet)
Seat 6: Apt1a folded before Flop (didn't bet)


PokerStars Hand #157028774428:  Hold'em No Limit ($0.05/$0.10 USD) - 2016/08/16 16:42:33 ET
Table 'Apus' 6-max Seat #2 is the button
Seat 1: lefty0130 ($10.28 in chips)
Seat 2: Schug ($9.89 in chips)
Seat 3: dogboy1088 ($3.84 in chips)
Seat 4: AJDKKK ($9.28 in chips)
Seat 5: tapouttazz9 ($11.04 in chips)
Seat 6: Apt1a ($13.84 in chips)
dogboy1088: posts small blind $0.05
AJDKKK: posts big blind $0.10
*** HOLE CARDS ***
Dealt to tapouttazz9 [5h 6h]
tapouttazz9: folds
Apt1a: raises $0.15 to $0.25
lefty0130: folds
Schug: folds
dogboy1088: folds
AJDKKK: calls $0.15
*** FLOP *** [6d Ts 2d]
AJDKKK: checks
Apt1a: checks
*** TURN *** [6d Ts 2d] [Tc]
AJDKKK: checks
Apt1a: bets $0.35
AJDKKK: folds
Uncalled bet ($0.35) returned to Apt1a
Apt1a collected $0.52 from pot
Apt1a: doesn't show hand
*** SUMMARY ***
Total pot $0.55 | Rake $0.03
Board [6d Ts 2d Tc]
Seat 1: lefty0130 folded before Flop (didn't bet)
Seat 2: Schug (button) folded before Flop (didn't bet)
Seat 3: dogboy1088 (small blind) folded before Flop
Seat 4: AJDKKK (big blind) folded on the Turn
Seat 5: tapouttazz9 folded before Flop (didn't bet)
Seat 6: Apt1a collected ($0.52)


PokerStars Hand #157028774577:  Hold'em No Limit ($0.05/$0.10 USD) - 2016/08/16 16:43:05 ET
Table 'Apus' 6-max Seat #3 is the button
Seat 1: lefty0130 ($10.28 in chips)
Seat 2: Schug ($9.89 in chips)
Seat 3: dogboy1088 ($3.79 in chips)
Seat 4: AJDKKK ($9.03 in chips)
Seat 5: tapouttazz9 ($11.04 in chips)
Seat 6: Apt1a ($14.11 in chips)
AJDKKK: posts small blind $0.05
tapouttazz9: posts big blind $0.10
*** HOLE CARDS ***
Dealt to tapouttazz9 [4h Kc]
Apt1a: folds
lefty0130: folds
Schug: folds
dogboy1088: calls $0.10
AJDKKK: calls $0.05
tapouttazz9: checks
*** FLOP *** [Jh 3s 9s]
AJDKKK: checks
tapouttazz9: checks
dogboy1088: bets $0.30
AJDKKK: folds
tapouttazz9: folds
Uncalled bet ($0.30) returned to dogboy1088
dogboy1088 collected $0.28 from pot
dogboy1088: doesn't show hand
*** SUMMARY ***
Total pot $0.30 | Rake $0.02
Board [Jh 3s 9s]
Seat 1: lefty0130 folded before Flop (didn't bet)
Seat 2: Schug folded before Flop (didn't bet)
Seat 3: dogboy1088 (button) collected ($0.28)
Seat 4: AJDKKK (small blind) folded on the Flop
Seat 5: tapouttazz9 (big blind) folded on the Flop
Seat 6: Apt1a folded before Flop (didn't bet)


PokerStars Hand #157028774698:  Hold'em No Limit ($0.05/$0.10 USD) - 2016/08/16 16:43:31 ET
Table 'Apus' 6-max Seat #4 is the button
Seat 1: lefty0130 ($10.28 in chips)
Seat 2: Schug ($9.89 in chips)
Seat 3: dogboy1088 ($3.97 in chips)
Seat 4: AJDKKK ($8.93 in chips)
Seat 5: tapouttazz9 ($10.94 in chips)
Seat 6: Apt1a ($14.11 in chips)
tapouttazz9: posts small blind $0.05
Apt1a: posts big blind $0.10
*** HOLE CARDS ***
Dealt to tapouttazz9 [Qc Qs]
lefty0130: folds
Schug: folds
dogboy1088: folds
AJDKKK: calls $0.10
tapouttazz9: raises $0.30 to $0.40
Apt1a: folds
AJDKKK: folds
Uncalled bet ($0.30) returned to tapouttazz9
tapouttazz9 collected $0.30 from pot
*** SUMMARY ***
Total pot $0.30 | Rake $0
Seat 1: lefty0130 folded before Flop (didn't bet)
Seat 2: Schug folded before Flop (didn't bet)
Seat 3: dogboy1088 folded before Flop (didn't bet)
Seat 4: AJDKKK (button) folded before Flop
Seat 5: tapouttazz9 (small blind) collected ($0.30)
Seat 6: Apt1a (big blind) folded before Flop


PokerStars Hand #157028774775:  Hold'em No Limit ($0.05/$0.10 USD) - 2016/08/16 16:43:50 ET
Table 'Apus' 6-max Seat #5 is the button
Seat 1: lefty0130 ($10.28 in chips)
Seat 2: Schug ($9.89 in chips)
Seat 3: dogboy1088 ($3.97 in chips)
Seat 4: AJDKKK ($8.83 in chips)
Seat 5: tapouttazz9 ($11.14 in chips)
Seat 6: Apt1a ($14.01 in chips)
Apt1a: posts small blind $0.05
lefty0130: posts big blind $0.10
*** HOLE CARDS ***
Dealt to tapouttazz9 [As 2c]
Schug: calls $0.10
dogboy1088: folds
AJDKKK: folds
tapouttazz9: folds
Apt1a: calls $0.05
lefty0130: checks
*** FLOP *** [3c Qc 8d]
Apt1a: checks
lefty0130: bets $0.28
Schug: calls $0.28
Apt1a: folds
*** TURN *** [3c Qc 8d] [6c]
lefty0130: checks
Schug: checks
*** RIVER *** [3c Qc 8d 6c] [Js]
lefty0130: bets $0.41
Schug: calls $0.41
*** SHOW DOWN ***
lefty0130: shows [Qd 7h] (a pair of Queens)
Schug: mucks hand
lefty0130 collected $1.60 from pot
*** SUMMARY ***
Total pot $1.68 | Rake $0.08
Board [3c Qc 8d 6c Js]
Seat 1: lefty0130 (big blind) showed [Qd 7h] and won ($1.60) with a pair of Queens
Seat 2: Schug mucked [Jc 4s]
Seat 3: dogboy1088 folded before Flop (didn't bet)
Seat 4: AJDKKK folded before Flop (didn't bet)
Seat 5: tapouttazz9 (button) folded before Flop (didn't bet)
Seat 6: Apt1a (small blind) folded on the Flop


PokerStars Hand #157028774998:  Hold'em No Limit ($0.05/$0.10 USD) - 2016/08/16 16:44:41 ET
Table 'Apus' 6-max Seat #6 is the button
Seat 1: lefty0130 ($11.09 in chips)
Seat 2: Schug ($9.10 in chips)
Seat 3: dogboy1088 ($3.97 in chips)
Seat 4: AJDKKK ($8.83 in chips)
Seat 5: tapouttazz9 ($11.14 in chips)
Seat 6: Apt1a ($13.91 in chips)
lefty0130: posts small blind $0.05
Schug: posts big blind $0.10
*** HOLE CARDS ***
Dealt to tapouttazz9 [8s 9c]
dogboy1088: folds
AJDKKK: calls $0.10
tapouttazz9: folds
Apt1a: raises $0.15 to $0.25
lefty0130: calls $0.20
Schug: calls $0.15
AJDKKK: calls $0.15
*** FLOP *** [Td Ts 4s]
lefty0130: checks
Schug: checks
AJDKKK: checks
Apt1a: bets $0.50
lefty0130: calls $0.50
Schug: folds
AJDKKK: folds
*** TURN *** [Td Ts 4s] [Jh]
lefty0130: bets $0.95
Apt1a: folds
Uncalled bet ($0.95) returned to lefty0130
lefty0130 collected $1.90 from pot
lefty0130: doesn't show hand
*** SUMMARY ***
Total pot $2 | Rake $0.10
Board [Td Ts 4s Jh]
Seat 1: lefty0130 (small blind) collected ($1.90)
Seat 2: Schug (big blind) folded on the Flop
Seat 3: dogboy1088 folded before Flop (didn't bet)
Seat 4: AJDKKK folded on the Flop
Seat 5: tapouttazz9 folded before Flop (didn't bet)
Seat 6: Apt1a (button) folded on the Turn


PokerStars Hand #157028775378:  Hold'em No Limit ($0.05/$0.10 USD) - 2016/08/16 16:46:06 ET
Table 'Apus' 6-max Seat #1 is the button
Seat 1: lefty0130 ($12.24 in chips)
Seat 2: Schug ($8.85 in chips)
Seat 3: dogboy1088 ($3.97 in chips)
Seat 4: AJDKKK ($8.58 in chips)
Seat 5: tapouttazz9 ($11.14 in chips)
Seat 6: Apt1a ($13.16 in chips)
Schug: posts small blind $0.05
dogboy1088: posts big blind $0.10
*** HOLE CARDS ***
Dealt to tapouttazz9 [5c Jd]
AJDKKK: folds
tapouttazz9: folds
Apt1a: folds
lefty0130: calls $0.10
Schug: folds
dogboy1088: checks
*** FLOP *** [Kh 4c Qh]
dogboy1088: checks
lefty0130: bets $0.24
dogboy1088: calls $0.24
*** TURN *** [Kh 4c Qh] [4d]
dogboy1088: checks
lefty0130: checks
*** RIVER *** [Kh 4c Qh 4d] [7h]
dogboy1088: bets $0.40
lefty0130: calls $0.40
*** SHOW DOWN ***
dogboy1088: shows [Th Kc] (two pair, Kings and Fours)
lefty0130: mucks hand
dogboy1088 collected $1.45 from pot
*** SUMMARY ***
Total pot $1.53 | Rake $0.08
Board [Kh 4c Qh 4d 7h]
Seat 1: lefty0130 (button) mucked [9c Qc]
Seat 2: Schug (small blind) folded before Flop
Seat 3: dogboy1088 (big blind) showed [Th Kc] and won ($1.45) with two pair, Kings and Fours
Seat 4: AJDKKK folded before Flop (didn't bet)
Seat 5: tapouttazz9 folded before Flop (didn't bet)
Seat 6: Apt1a folded before Flop (didn't bet)


PokerStars Hand #157028775519:  Hold'em No Limit ($0.05/$0.10 USD) - 2016/08/16 16:46:34 ET
Table 'Apus' 6-max Seat #2 is the button
Seat 1: lefty0130 ($11.50 in chips)
Seat 2: Schug ($8.80 in chips)
Seat 3: dogboy1088 ($4.68 in chips)
Seat 4: AJDKKK ($8.58 in chips)
Seat 5: tapouttazz9 ($11.14 in chips)
Seat 6: Apt1a ($13.16 in chips)
dogboy1088: posts small blind $0.05
AJDKKK: posts big blind $0.10
*** HOLE CARDS ***
Dealt to tapouttazz9 [Ks 4c]
tapouttazz9: folds
Apt1a: folds
lefty0130: folds
Schug: folds
dogboy1088: folds
Uncalled bet ($0.05) returned to AJDKKK
AJDKKK collected $0.10 from pot
AJDKKK: doesn't show hand
*** SUMMARY ***
Total pot $0.10 | Rake $0
Seat 1: lefty0130 folded before Flop (didn't bet)
Seat 2: Schug (button) folded before Flop (didn't bet)
Seat 3: dogboy1088 (small blind) folded before Flop
Seat 4: AJDKKK (big blind) collected ($0.10)
Seat 5: tapouttazz9 folded before Flop (didn't bet)
Seat 6: Apt1a folded before Flop (didn't bet)


PokerStars Hand #157028775583:  Hold'em No Limit ($0.05/$0.10 USD) - 2016/08/16 16:46:48 ET
Table 'Apus' 6-max Seat #3 is the button
Seat 1: lefty0130 ($11.50 in chips)
Seat 2: Schug ($8.80 in chips)
Seat 3: dogboy1088 ($4.63 in chips)
Seat 4: AJDKKK ($8.63 in chips)
Seat 5: tapouttazz9 ($11.14 in chips)
Seat 6: Apt1a ($13.16 in chips)
AJDKKK: posts small blind $0.05
tapouttazz9: posts big blind $0.10
*** HOLE CARDS ***
Dealt to tapouttazz9 [Qc Js]
Apt1a: folds
lefty0130: folds
Schug: calls $0.10
dogboy1088: calls $0.10
AJDKKK: calls $0.05
tapouttazz9: checks
*** FLOP *** [6h 8h 8d]
AJDKKK: bets $0.10
tapouttazz9: folds
Schug: calls $0.10
dogboy1088: calls $0.10
*** TURN *** [6h 8h 8d] [Qh]
AJDKKK: checks
Schug: checks
dogboy1088: checks
*** RIVER *** [6h 8h 8d Qh] [Ad]
AJDKKK: bets $0.10
Schug: folds
dogboy1088: calls $0.10
*** SHOW DOWN ***
AJDKKK: shows [7h 9c] (a pair of Eights)
dogboy1088: shows [Ah 7c] (two pair, Aces and Eights)
dogboy1088 collected $0.86 from pot
*** SUMMARY ***
Total pot $0.90 | Rake $0.04
Board [6h 8h 8d Qh Ad]
Seat 1: lefty0130 folded before Flop (didn't bet)
Seat 2: Schug folded on the River
Seat 3: dogboy1088 (button) showed [Ah 7c] and won ($0.86) with two pair, Aces and Eights
Seat 4: AJDKKK (small blind) showed [7h 9c] and lost with a pair of Eights
Seat 5: tapouttazz9 (big blind) folded on the Flop
Seat 6: Apt1a folded before Flop (didn't bet)


PokerStars Hand #157028775936:  Hold'em No Limit ($0.05/$0.10 USD) - 2016/08/16 16:47:55 ET
Table 'Apus' 6-max Seat #4 is the button
Seat 1: lefty0130 ($11.50 in chips)
Seat 2: Schug ($8.60 in chips)
Seat 3: dogboy1088 ($5.19 in chips)
Seat 4: AJDKKK ($8.33 in chips)
Seat 5: tapouttazz9 ($11.04 in chips)
Seat 6: Apt1a ($13.16 in chips)
tapouttazz9: posts small blind $0.05
Apt1a: posts big blind $0.10
*** HOLE CARDS ***
Dealt to tapouttazz9 [9h 5c]
lefty0130 has timed out
lefty0130: folds
Schug: calls $0.10
dogboy1088: folds
AJDKKK: folds
tapouttazz9: folds
Apt1a: checks
*** FLOP *** [2c Jh Kh]
Apt1a: checks
Schug: checks
*** TURN *** [2c Jh Kh] [Qs]
AJDKKK leaves the table
Apt1a: bets $0.15
Schug: calls $0.15
*** RIVER *** [2c Jh Kh Qs] [6d]
Apt1a: bets $0.35
Schug: raises $1.22 to $1.57
Apt1a: folds
Uncalled bet ($1.22) returned to Schug
Schug collected $1.19 from pot
Schug: doesn't show hand
*** SUMMARY ***
Total pot $1.25 | Rake $0.06
Board [2c Jh Kh Qs 6d]
Seat 1: lefty0130 folded before Flop (didn't bet)
Seat 2: Schug collected ($1.19)
Seat 3: dogboy1088 folded before Flop (didn't bet)
Seat 4: AJDKKK (button) folded before Flop (didn't bet)
Seat 5: tapouttazz9 (small blind) folded before Flop
Seat 6: Apt1a (big blind) folded on the River


PokerStars Hand #157028776304:  Hold'em No Limit ($0.05/$0.10 USD) - 2016/08/16 16:49:16 ET
Table 'Apus' 6-max Seat #5 is the button
Seat 1: lefty0130 ($11.50 in chips)
Seat 2: Schug ($9.19 in chips)
Seat 3: dogboy1088 ($5.19 in chips)
Seat 5: tapouttazz9 ($10.99 in chips)
Seat 6: Apt1a ($12.56 in chips)
Apt1a: posts small blind $0.05
lefty0130: posts big blind $0.10
*** HOLE CARDS ***
Dealt to tapouttazz9 [8h 4c]
Schug: calls $0.10
dogboy1088: folds
tapouttazz9: folds
Apt1a: calls $0.05
lefty0130: checks
*** FLOP *** [5d Kd 6s]
Apt1a: checks
lefty0130: bets $0.28
Schug: calls $0.28
Apt1a: folds
*** TURN *** [5d Kd 6s] [9c]
lefty0130: checks
Schug: bets $0.82
lefty0130: folds
Uncalled bet ($0.82) returned to Schug
Schug collected $0.82 from pot
Schug: doesn't show hand
*** SUMMARY ***
Total pot $0.86 | Rake $0.04
Board [5d Kd 6s 9c]
Seat 1: lefty0130 (big blind) folded on the Turn
Seat 2: Schug collected ($0.82)
Seat 3: dogboy1088 folded before Flop (didn't bet)
Seat 5: tapouttazz9 (button) folded before Flop (didn't bet)
Seat 6: Apt1a (small blind) folded on the Flop


PokerStars Hand #157028776509:  Hold'em No Limit ($0.05/$0.10 USD) - 2016/08/16 16:50:04 ET
Table 'Apus' 6-max Seat #6 is the button
Seat 1: lefty0130 ($11.12 in chips)
Seat 2: Schug ($9.63 in chips)
Seat 3: dogboy1088 ($5.19 in chips)
Seat 5: tapouttazz9 ($10.99 in chips)
Seat 6: Apt1a ($12.46 in chips)
lefty0130: posts small blind $0.05
Schug: posts big blind $0.10
*** HOLE CARDS ***
Dealt to tapouttazz9 [Js Qc]
dogboy1088: folds
tapouttazz9: raises $0.20 to $0.30
Apt1a: folds
lefty0130: folds
Schug: calls $0.20
*** FLOP *** [Td 2s Jd]
Schug: checks
tapouttazz9: bets $0.30
Schug: calls $0.30
*** TURN *** [Td 2s Jd] [8c]
Schug: checks
tapouttazz9: checks
*** RIVER *** [Td 2s Jd 8c] [2d]
Schug: checks
tapouttazz9: bets $0.59
Schug: folds
Uncalled bet ($0.59) returned to tapouttazz9
tapouttazz9 collected $1.19 from pot
*** SUMMARY ***
Total pot $1.25 | Rake $0.06
Board [Td 2s Jd 8c 2d]
Seat 1: lefty0130 (small blind) folded before Flop
Seat 2: Schug (big blind) folded on the River
Seat 3: dogboy1088 folded before Flop (didn't bet)
Seat 5: tapouttazz9 collected ($1.19)
Seat 6: Apt1a (button) folded before Flop (didn't bet)


PokerStars Hand #157028776709:  Hold'em No Limit ($0.05/$0.10 USD) - 2016/08/16 16:50:47 ET
Table 'Apus' 6-max Seat #1 is the button
Seat 1: lefty0130 ($11.07 in chips)
Seat 2: Schug ($9.03 in chips)
Seat 3: dogboy1088 ($5.19 in chips)
Seat 5: tapouttazz9 ($11.58 in chips)
Seat 6: Apt1a ($12.46 in chips)
Schug: posts small blind $0.05
dogboy1088: posts big blind $0.10
*** HOLE CARDS ***
Dealt to tapouttazz9 [Td 5d]
tapouttazz9: folds
Apt1a: folds
lefty0130: folds
Schug: calls $0.05
dogboy1088: checks
*** FLOP *** [Th 9h Jh]
Schug: checks
dogboy1088: bets $0.40
Schug: folds
Uncalled bet ($0.40) returned to dogboy1088
dogboy1088 collected $0.19 from pot
dogboy1088: doesn't show hand
*** SUMMARY ***
Total pot $0.20 | Rake $0.01
Board [Th 9h Jh]
Seat 1: lefty0130 (button) folded before Flop (didn't bet)
Seat 2: Schug (small blind) folded on the Flop
Seat 3: dogboy1088 (big blind) collected ($0.19)
Seat 5: tapouttazz9 folded before Flop (didn't bet)
Seat 6: Apt1a folded before Flop (didn't bet)


PokerStars Hand #157028776833:  Hold'em No Limit ($0.05/$0.10 USD) - 2016/08/16 16:51:15 ET
Table 'Apus' 6-max Seat #2 is the button
Seat 1: lefty0130 ($11.07 in chips)
Seat 2: Schug ($8.93 in chips)
Seat 3: dogboy1088 ($5.28 in chips)
Seat 5: tapouttazz9 ($11.58 in chips)
Seat 6: Apt1a ($12.46 in chips)
dogboy1088: posts small blind $0.05
tapouttazz9: posts big blind $0.10
*** HOLE CARDS ***
Dealt to tapouttazz9 [9s Kc]
dangerhard10 joins the table at seat #4
Apt1a: raises $0.15 to $0.25
lefty0130: folds
Schug: folds
dogboy1088: folds
tapouttazz9: folds
Uncalled bet ($0.15) returned to Apt1a
Apt1a collected $0.25 from pot
Apt1a: doesn't show hand
*** SUMMARY ***
Total pot $0.25 | Rake $0
Seat 1: lefty0130 folded before Flop (didn't bet)
Seat 2: Schug (button) folded before Flop (didn't bet)
Seat 3: dogboy1088 (small blind) folded before Flop
Seat 5: tapouttazz9 (big blind) folded before Flop
Seat 6: Apt1a collected ($0.25)


PokerStars Hand #157028776910:  Hold'em No Limit ($0.05/$0.10 USD) - 2016/08/16 16:51:32 ET
Table 'Apus' 6-max Seat #3 is the button
Seat 1: lefty0130 ($11.07 in chips)
Seat 2: Schug ($8.93 in chips)
Seat 3: dogboy1088 ($5.23 in chips)
Seat 5: tapouttazz9 ($11.48 in chips)
Seat 6: Apt1a ($12.61 in chips)
dangerhard10 will be allowed to play after the button
tapouttazz9: posts small blind $0.05
Apt1a: posts big blind $0.10
*** HOLE CARDS ***
Dealt to tapouttazz9 [Jc 8s]
lefty0130: raises $0.25 to $0.35
Schug: calls $0.35
dogboy1088: folds
tapouttazz9: folds
Apt1a: folds
*** FLOP *** [Kh 4s 7d]
lefty0130: bets $0.50
Schug: calls $0.50
*** TURN *** [Kh 4s 7d] [3h]
lefty0130: bets $1.20
Schug: calls $1.20
*** RIVER *** [Kh 4s 7d 3h] [3s]
lefty0130: bets $2.20
Schug: calls $2.20
*** SHOW DOWN ***
lefty0130: shows [Ac Ad] (two pair, Aces and Threes)
Schug: mucks hand
lefty0130 collected $8.22 from pot
*** SUMMARY ***
Total pot $8.65 | Rake $0.43
Board [Kh 4s 7d 3h 3s]
Seat 1: lefty0130 showed [Ac Ad] and won ($8.22) with two pair, Aces and Threes
Seat 2: Schug mucked [Ks 5c]
Seat 3: dogboy1088 (button) folded before Flop (didn't bet)
Seat 5: tapouttazz9 (small blind) folded before Flop
Seat 6: Apt1a (big blind) folded before Flop


PokerStars Hand #157028777144:  Hold'em No Limit ($0.05/$0.10 USD) - 2016/08/16 16:52:28 ET
Table 'Apus' 6-max Seat #5 is the button
Seat 1: lefty0130 ($15.04 in chips)
Seat 2: Schug ($4.68 in chips)
Seat 3: dogboy1088 ($5.23 in chips)
Seat 4: dangerhard10 ($10 in chips)
Seat 5: tapouttazz9 ($11.43 in chips)
Seat 6: Apt1a ($12.51 in chips)
Apt1a: posts small blind $0.05
lefty0130: posts big blind $0.10
dangerhard10: posts big blind $0.10
*** HOLE CARDS ***
Dealt to tapouttazz9 [Ac Ah]
Schug: calls $0.10
dogboy1088: folds
dangerhard10: checks
tapouttazz9: raises $0.30 to $0.40
Apt1a: folds
lefty0130: calls $0.30
Schug: calls $0.30
dangerhard10: folds
*** FLOP *** [Ks Kc 7h]
lefty0130: checks
Schug: checks
tapouttazz9: checks
*** TURN *** [Ks Kc 7h] [3c]
lefty0130: bets $0.60
Schug: calls $0.60
tapouttazz9: folds
*** RIVER *** [Ks Kc 7h 3c] [2d]
lefty0130: checks
Schug: bets $2.42
lefty0130: folds
Uncalled bet ($2.42) returned to Schug
Schug collected $2.42 from pot
Schug: doesn't show hand
*** SUMMARY ***
Total pot $2.55 | Rake $0.13
Board [Ks Kc 7h 3c 2d]
Seat 1: lefty0130 (big blind) folded on the River
Seat 2: Schug collected ($2.42)
Seat 3: dogboy1088 folded before Flop (didn't bet)
Seat 4: dangerhard10 folded before Flop
Seat 5: tapouttazz9 (button) folded on the Turn
Seat 6: Apt1a (small blind) folded before Flop


PokerStars Hand #157028777376:  Hold'em No Limit ($0.05/$0.10 USD) - 2016/08/16 16:53:20 ET
Table 'Apus' 6-max Seat #6 is the button
Seat 1: lefty0130 ($14.04 in chips)
Seat 2: Schug ($6.10 in chips)
Seat 3: dogboy1088 ($5.23 in chips)
Seat 4: dangerhard10 ($9.90 in chips)
Seat 5: tapouttazz9 ($11.03 in chips)
Seat 6: Apt1a ($12.46 in chips)
lefty0130: posts small blind $0.05
Schug: posts big blind $0.10
*** HOLE CARDS ***
Dealt to tapouttazz9 [Ah 3c]
dogboy1088: folds
dangerhard10: calls $0.10
tapouttazz9: folds
Apt1a: folds
lefty0130: calls $0.05
Schug: checks
*** FLOP *** [Tc 9h 5d]
lefty0130: bets $0.28
Schug: folds
dangerhard10: folds
Uncalled bet ($0.28) returned to lefty0130
lefty0130 collected $0.28 from pot
lefty0130: doesn't show hand
*** SUMMARY ***
Total pot $0.30 | Rake $0.02
Board [Tc 9h 5d]
Seat 1: lefty0130 (small blind) collected ($0.28)
Seat 2: Schug (big blind) folded on the Flop
Seat 3: dogboy1088 folded before Flop (didn't bet)
Seat 4: dangerhard10 folded on the Flop
Seat 5: tapouttazz9 folded before Flop (didn't bet)
Seat 6: Apt1a (button) folded before Flop (didn't bet)


PokerStars Hand #157028777505:  Hold'em No Limit ($0.05/$0.10 USD) - 2016/08/16 16:53:50 ET
Table 'Apus' 6-max Seat #1 is the button
Seat 1: lefty0130 ($14.22 in chips)
Seat 2: Schug ($6 in chips)
Seat 3: dogboy1088 ($5.23 in chips)
Seat 4: dangerhard10 ($9.80 in chips)
Seat 5: tapouttazz9 ($11.03 in chips)
Seat 6: Apt1a ($12.46 in chips)
Schug: posts small blind $0.05
dogboy1088: posts big blind $0.10
*** HOLE CARDS ***
Dealt to tapouttazz9 [2c Jc]
dangerhard10: folds
tapouttazz9: folds
Apt1a: folds
lefty0130: raises $0.25 to $0.35
Schug: folds
dogboy1088: folds
Uncalled bet ($0.25) returned to lefty0130
lefty0130 collected $0.25 from pot
lefty0130: doesn't show hand
*** SUMMARY ***
Total pot $0.25 | Rake $0
Seat 1: lefty0130 (button) collected ($0.25)
Seat 2: Schug (small blind) folded before Flop
Seat 3: dogboy1088 (big blind) folded before Flop
Seat 4: dangerhard10 folded before Flop (didn't bet)
Seat 5: tapouttazz9 folded before Flop (didn't bet)
Seat 6: Apt1a folded before Flop (didn't bet)


PokerStars Hand #157028777625:  Hold'em No Limit ($0.05/$0.10 USD) - 2016/08/16 16:54:12 ET
Table 'Apus' 6-max Seat #2 is the button
Seat 1: lefty0130 ($14.37 in chips)
Seat 2: Schug ($5.95 in chips)
Seat 3: dogboy1088 ($5.13 in chips)
Seat 4: dangerhard10 ($9.80 in chips)
Seat 5: tapouttazz9 ($11.03 in chips)
Seat 6: Apt1a ($12.46 in chips)
dogboy1088: posts small blind $0.05
dangerhard10: posts big blind $0.10
*** HOLE CARDS ***
Dealt to tapouttazz9 [8c 3c]
tapouttazz9: folds
Apt1a: folds
lefty0130: calls $0.10
Schug: calls $0.10
dogboy1088: calls $0.05
dangerhard10: checks
*** FLOP *** [5s As 9h]
dogboy1088: checks
dangerhard10: checks
lefty0130: checks
Schug: bets $0.38
dogboy1088: folds
dangerhard10: folds
lefty0130: folds
Uncalled bet ($0.38) returned to Schug
Schug collected $0.38 from pot
Schug: doesn't show hand
*** SUMMARY ***
Total pot $0.40 | Rake $0.02
Board [5s As 9h]
Seat 1: lefty0130 folded on the Flop
Seat 2: Schug (button) collected ($0.38)
Seat 3: dogboy1088 (small blind) folded on the Flop
Seat 4: dangerhard10 (big blind) folded on the Flop
Seat 5: tapouttazz9 folded before Flop (didn't bet)
Seat 6: Apt1a folded before Flop (didn't bet)


PokerStars Hand #157028777880:  Hold'em No Limit ($0.05/$0.10 USD) - 2016/08/16 16:55:04 ET
Table 'Apus' 6-max Seat #3 is the button
Seat 1: lefty0130 ($14.27 in chips)
Seat 2: Schug ($6.23 in chips)
Seat 3: dogboy1088 ($5.03 in chips)
Seat 4: dangerhard10 ($9.70 in chips)
Seat 5: tapouttazz9 ($11.03 in chips)
Seat 6: Apt1a ($12.46 in chips)
dangerhard10: posts small blind $0.05
tapouttazz9: posts big blind $0.10
*** HOLE CARDS ***
Dealt to tapouttazz9 [7c 2h]
Apt1a: folds
lefty0130: calls $0.10
Schug: calls $0.10
dogboy1088: folds
dangerhard10: folds
tapouttazz9: checks
*** FLOP *** [Kd 6h 6c]
tapouttazz9: checks
lefty0130: bets $0.33
Schug: folds
tapouttazz9: folds
Uncalled bet ($0.33) returned to lefty0130
lefty0130 collected $0.33 from pot
lefty0130: doesn't show hand
*** SUMMARY ***
Total pot $0.35 | Rake $0.02
Board [Kd 6h 6c]
Seat 1: lefty0130 collected ($0.33)
Seat 2: Schug folded on the Flop
Seat 3: dogboy1088 (button) folded before Flop (didn't bet)
Seat 4: dangerhard10 (small blind) folded before Flop
Seat 5: tapouttazz9 (big blind) folded on the Flop
Seat 6: Apt1a folded before Flop (didn't bet)


PokerStars Hand #157028778020:  Hold'em No Limit ($0.05/$0.10 USD) - 2016/08/16 16:55:33 ET
Table 'Apus' 6-max Seat #4 is the button
Seat 1: lefty0130 ($14.50 in chips)
Seat 2: Schug ($6.13 in chips)
Seat 3: dogboy1088 ($5.03 in chips)
Seat 4: dangerhard10 ($9.65 in chips)
Seat 5: tapouttazz9 ($10.93 in chips)
Seat 6: Apt1a ($12.46 in chips)
tapouttazz9: posts small blind $0.05
Apt1a: posts big blind $0.10
*** HOLE CARDS ***
Dealt to tapouttazz9 [6d Kd]
lefty0130: calls $0.10
Schug: folds
dogboy1088: calls $0.10
dangerhard10: calls $0.10
tapouttazz9: raises $0.10 to $0.20
Apt1a: calls $0.10
lefty0130: calls $0.10
dogboy1088: calls $0.10
dangerhard10: calls $0.10
*** FLOP *** [Ks 2d 2h]
tapouttazz9: bets $0.40
Apt1a: folds
lefty0130: folds
dogboy1088: folds
dangerhard10: calls $0.40
*** TURN *** [Ks 2d 2h] [2s]
tapouttazz9: bets $0.85
dangerhard10: calls $0.85
*** RIVER *** [Ks 2d 2h 2s] [5s]
tapouttazz9: checks
dangerhard10: bets $3.32
tapouttazz9: calls $3.32
*** SHOW DOWN ***
dangerhard10: shows [3h Kh] (a full house, Deuces full of Kings)
tapouttazz9: shows [6d Kd] (a full house, Deuces full of Kings)
tapouttazz9 collected $4.82 from pot
dangerhard10 collected $4.81 from pot
*** SUMMARY ***
Total pot $10.14 | Rake $0.51
Board [Ks 2d 2h 2s 5s]
Seat 1: lefty0130 folded on the Flop
Seat 2: Schug folded before Flop (didn't bet)
Seat 3: dogboy1088 folded on the Flop
Seat 4: dangerhard10 (button) showed [3h Kh] and won ($4.81) with a full house, Deuces full of Kings
Seat 5: tapouttazz9 (small blind) showed [6d Kd] and won ($4.82) with a full house, Deuces full of Kings
Seat 6: Apt1a (big blind) folded on the Flop


PokerStars Hand #157028778241:  Hold'em No Limit ($0.05/$0.10 USD) - 2016/08/16 16:56:28 ET
Table 'Apus' 6-max Seat #5 is the button
Seat 1: lefty0130 ($14.30 in chips)
Seat 2: Schug ($6.13 in chips)
Seat 3: dogboy1088 ($4.83 in chips)
Seat 4: dangerhard10 ($9.69 in chips)
Seat 5: tapouttazz9 ($10.98 in chips)
Seat 6: Apt1a ($12.26 in chips)
Apt1a: posts small blind $0.05
lefty0130: posts big blind $0.10
*** HOLE CARDS ***
Dealt to tapouttazz9 [Th 7c]
Schug: calls $0.10
dogboy1088: folds
dangerhard10: folds
tapouttazz9: folds
Apt1a: calls $0.05
lefty0130: checks
*** FLOP *** [6d Ks Qh]
Apt1a: checks
lefty0130: checks
Schug: checks
*** TURN *** [6d Ks Qh] [6c]
Apt1a: bets $0.15
lefty0130: folds
Schug: folds
Uncalled bet ($0.15) returned to Apt1a
Apt1a collected $0.28 from pot
Apt1a: doesn't show hand
*** SUMMARY ***
Total pot $0.30 | Rake $0.02
Board [6d Ks Qh 6c]
Seat 1: lefty0130 (big blind) folded on the Turn
Seat 2: Schug folded on the Turn
Seat 3: dogboy1088 folded before Flop (didn't bet)
Seat 4: dangerhard10 folded before Flop (didn't bet)
Seat 5: tapouttazz9 (button) folded before Flop (didn't bet)
Seat 6: Apt1a (small blind) collected ($0.28)


PokerStars Hand #157028778587:  Hold'em No Limit ($0.05/$0.10 USD) - 2016/08/16 16:57:48 ET
Table 'Apus' 6-max Seat #6 is the button
Seat 1: lefty0130 ($14.20 in chips)
Seat 2: Schug ($6.03 in chips)
Seat 3: dogboy1088 ($4.83 in chips)
Seat 4: dangerhard10 ($9.69 in chips)
Seat 5: tapouttazz9 ($10.98 in chips)
Seat 6: Apt1a ($12.44 in chips)
lefty0130: posts small blind $0.05
Schug: posts big blind $0.10
*** HOLE CARDS ***
Dealt to tapouttazz9 [Qh 4d]
dogboy1088: folds
dangerhard10: folds
tapouttazz9: folds
Apt1a: folds
lefty0130: raises $0.20 to $0.30
Schug: folds
Uncalled bet ($0.20) returned to lefty0130
lefty0130 collected $0.20 from pot
lefty0130: doesn't show hand
*** SUMMARY ***
Total pot $0.20 | Rake $0
Seat 1: lefty0130 (small blind) collected ($0.20)
Seat 2: Schug (big blind) folded before Flop
Seat 3: dogboy1088 folded before Flop (didn't bet)
Seat 4: dangerhard10 folded before Flop (didn't bet)
Seat 5: tapouttazz9 folded before Flop (didn't bet)
Seat 6: Apt1a (button) folded before Flop (didn't bet)


PokerStars Hand #157028778727:  Hold'em No Limit ($0.05/$0.10 USD) - 2016/08/16 16:58:18 ET
Table 'Apus' 6-max Seat #1 is the button
Seat 1: lefty0130 ($14.30 in chips)
Seat 2: Schug ($5.93 in chips)
Seat 3: dogboy1088 ($4.83 in chips)
Seat 4: dangerhard10 ($9.69 in chips)
Seat 5: tapouttazz9 ($10.98 in chips)
Seat 6: Apt1a ($12.44 in chips)
Schug: posts small blind $0.05
dogboy1088: posts big blind $0.10
*** HOLE CARDS ***
Dealt to tapouttazz9 [5c Kh]
dangerhard10: folds
tapouttazz9: folds
Apt1a: folds
lefty0130: calls $0.10
Schug: calls $0.05
dogboy1088: checks
*** FLOP *** [Td 2s 5h]
Schug: checks
dogboy1088: checks
lefty0130: bets $0.28
Schug: folds
dogboy1088: folds
Uncalled bet ($0.28) returned to lefty0130
lefty0130 collected $0.28 from pot
lefty0130: doesn't show hand
*** SUMMARY ***
Total pot $0.30 | Rake $0.02
Board [Td 2s 5h]
Seat 1: lefty0130 (button) collected ($0.28)
Seat 2: Schug (small blind) folded on the Flop
Seat 3: dogboy1088 (big blind) folded on the Flop
Seat 4: dangerhard10 folded before Flop (didn't bet)
Seat 5: tapouttazz9 folded before Flop (didn't bet)
Seat 6: Apt1a folded before Flop (didn't bet)


PokerStars Hand #157028778885:  Hold'em No Limit ($0.05/$0.10 USD) - 2016/08/16 16:58:53 ET
Table 'Apus' 6-max Seat #2 is the button
Seat 1: lefty0130 ($14.48 in chips)
Seat 2: Schug ($5.83 in chips)
Seat 3: dogboy1088 ($4.73 in chips)
Seat 4: dangerhard10 ($9.69 in chips)
Seat 5: tapouttazz9 ($10.98 in chips)
Seat 6: Apt1a ($12.44 in chips)
dogboy1088: posts small blind $0.05
dangerhard10: posts big blind $0.10
*** HOLE CARDS ***
Dealt to tapouttazz9 [Js Jh]
tapouttazz9: raises $0.20 to $0.30
Apt1a: folds
lefty0130: calls $0.30
Schug: folds
dogboy1088: folds
dangerhard10: calls $0.20
*** FLOP *** [6d 4d Kh]
dangerhard10: checks
tapouttazz9: bets $0.40
lefty0130: folds
dangerhard10: folds
Uncalled bet ($0.40) returned to tapouttazz9
tapouttazz9 collected $0.90 from pot
*** SUMMARY ***
Total pot $0.95 | Rake $0.05
Board [6d 4d Kh]
Seat 1: lefty0130 folded on the Flop
Seat 2: Schug (button) folded before Flop (didn't bet)
Seat 3: dogboy1088 (small blind) folded before Flop
Seat 4: dangerhard10 (big blind) folded on the Flop
Seat 5: tapouttazz9 collected ($0.90)
Seat 6: Apt1a folded before Flop (didn't bet)


PokerStars Hand #157028779036:  Hold'em No Limit ($0.05/$0.10 USD) - 2016/08/16 16:59:27 ET
Table 'Apus' 6-max Seat #3 is the button
Seat 1: lefty0130 ($14.18 in chips)
Seat 2: Schug ($5.83 in chips)
Seat 3: dogboy1088 ($4.68 in chips)
Seat 4: dangerhard10 ($9.39 in chips)
Seat 5: tapouttazz9 ($11.58 in chips)
Seat 6: Apt1a ($12.44 in chips)
dangerhard10: posts small blind $0.05
tapouttazz9: posts big blind $0.10
*** HOLE CARDS ***
Dealt to tapouttazz9 [9h 4h]
Apt1a: folds
lefty0130: folds
Schug: raises $0.10 to $0.20
dogboy1088: folds
dangerhard10: calls $0.15
tapouttazz9: folds
*** FLOP *** [6d 3d 9s]
dangerhard10: checks
Schug: bets $0.48
dangerhard10: folds
Uncalled bet ($0.48) returned to Schug
Schug collected $0.48 from pot
Schug: doesn't show hand
*** SUMMARY ***
Total pot $0.50 | Rake $0.02
Board [6d 3d 9s]
Seat 1: lefty0130 folded before Flop (didn't bet)
Seat 2: Schug collected ($0.48)
Seat 3: dogboy1088 (button) folded before Flop (didn't bet)
Seat 4: dangerhard10 (small blind) folded on the Flop
Seat 5: tapouttazz9 (big blind) folded before Flop
Seat 6: Apt1a folded before Flop (didn't bet)


PokerStars Hand #157028779154:  Hold'em No Limit ($0.05/$0.10 USD) - 2016/08/16 16:59:48 ET
Table 'Apus' 6-max Seat #4 is the button
Seat 1: lefty0130 ($14.18 in chips)
Seat 2: Schug ($6.11 in chips)
Seat 3: dogboy1088 ($4.68 in chips)
Seat 4: dangerhard10 ($9.19 in chips)
Seat 5: tapouttazz9 ($11.48 in chips)
Seat 6: Apt1a ($12.44 in chips)
tapouttazz9: posts small blind $0.05
Apt1a: posts big blind $0.10
*** HOLE CARDS ***
Dealt to tapouttazz9 [4s Kc]
lefty0130: calls $0.10
Schug: calls $0.10
dogboy1088: folds
dangerhard10: calls $0.10
tapouttazz9: folds
Apt1a: checks
*** FLOP *** [7c 2c 2d]
Apt1a: checks
lefty0130: checks
Schug: checks
dangerhard10: checks
*** TURN *** [7c 2c 2d] [Qd]
Apt1a: bets $0.25
lefty0130: folds
Schug: folds
dangerhard10: calls $0.25
*** RIVER *** [7c 2c 2d Qd] [4h]
Apt1a: checks
dangerhard10: bets $0.45
Apt1a: folds
Uncalled bet ($0.45) returned to dangerhard10
dangerhard10 collected $0.90 from pot
*** SUMMARY ***
Total pot $0.95 | Rake $0.05
Board [7c 2c 2d Qd 4h]
Seat 1: lefty0130 folded on the Turn
Seat 2: Schug folded on the Turn
Seat 3: dogboy1088 folded before Flop (didn't bet)
Seat 4: dangerhard10 (button) collected ($0.90)
Seat 5: tapouttazz9 (small blind) folded before Flop
Seat 6: Apt1a (big blind) folded on the River


PokerStars Hand #157028779559:  Hold'em No Limit ($0.05/$0.10 USD) - 2016/08/16 17:01:21 ET
Table 'Apus' 6-max Seat #5 is the button
Seat 1: lefty0130 ($14.08 in chips)
Seat 2: Schug ($6.01 in chips)
Seat 3: dogboy1088 ($4.68 in chips)
Seat 4: dangerhard10 ($9.74 in chips)
Seat 5: tapouttazz9 ($11.43 in chips)
Seat 6: Apt1a ($12.09 in chips)
Apt1a: posts small blind $0.05
lefty0130: posts big blind $0.10
*** HOLE CARDS ***
Dealt to tapouttazz9 [4c Js]
Schug: folds
dogboy1088: folds
dangerhard10: folds
tapouttazz9: folds
Apt1a: raises $0.15 to $0.25
lefty0130: calls $0.15
*** FLOP *** [4h 4d Th]
Apt1a: bets $0.35
lefty0130: folds
Uncalled bet ($0.35) returned to Apt1a
Apt1a collected $0.48 from pot
Apt1a: doesn't show hand
*** SUMMARY ***
Total pot $0.50 | Rake $0.02
Board [4h 4d Th]
Seat 1: lefty0130 (big blind) folded on the Flop
Seat 2: Schug folded before Flop (didn't bet)
Seat 3: dogboy1088 folded before Flop (didn't bet)
Seat 4: dangerhard10 folded before Flop (didn't bet)
Seat 5: tapouttazz9 (button) folded before Flop (didn't bet)
Seat 6: Apt1a (small blind) collected ($0.48)


PokerStars Hand #157028779729:  Hold'em No Limit ($0.05/$0.10 USD) - 2016/08/16 17:02:00 ET
Table 'Apus' 6-max Seat #6 is the button
Seat 1: lefty0130 ($13.83 in chips)
Seat 2: Schug ($6.01 in chips)
Seat 3: dogboy1088 ($4.68 in chips)
Seat 4: dangerhard10 ($9.74 in chips)
Seat 5: tapouttazz9 ($11.43 in chips)
Seat 6: Apt1a ($12.32 in chips)
lefty0130: posts small blind $0.05
Schug: posts big blind $0.10
*** HOLE CARDS ***
Dealt to tapouttazz9 [Qh 7c]
dogboy1088: calls $0.10
dangerhard10: calls $0.10
tapouttazz9: folds
Apt1a: calls $0.10
lefty0130: calls $0.05
Schug: checks
*** FLOP *** [9s 3d Ad]
lefty0130: checks
Schug: checks
dogboy1088: checks
dangerhard10: bets $0.24
Apt1a: folds
lefty0130: calls $0.24
Schug: folds
dogboy1088: folds
*** TURN *** [9s 3d Ad] [8d]
lefty0130: checks
dangerhard10: bets $0.60
lefty0130: folds
Uncalled bet ($0.60) returned to dangerhard10
dangerhard10 collected $0.93 from pot
*** SUMMARY ***
Total pot $0.98 | Rake $0.05
Board [9s 3d Ad 8d]
Seat 1: lefty0130 (small blind) folded on the Turn
Seat 2: Schug (big blind) folded on the Flop
Seat 3: dogboy1088 folded on the Flop
Seat 4: dangerhard10 collected ($0.93)
Seat 5: tapouttazz9 folded before Flop (didn't bet)
Seat 6: Apt1a (button) folded on the Flop


PokerStars Hand #157030237009:  Hold'em No Limit ($0.05/$0.10 USD) - 2016/08/16 17:03:01 ET
Table 'Apus' 6-max Seat #1 is the button
Seat 1: lefty0130 ($13.49 in chips)
Seat 2: Schug ($5.91 in chips)
Seat 4: dangerhard10 ($10.33 in chips)
Seat 5: tapouttazz9 ($11.43 in chips)
Seat 6: Apt1a ($12.22 in chips)
Schug: posts small blind $0.05
dangerhard10: posts big blind $0.10
*** HOLE CARDS ***
Dealt to tapouttazz9 [Ks Js]
tapouttazz9: raises $0.10 to $0.20
Apt1a: calls $0.20
lefty0130: folds
Schug: folds
dangerhard10: folds
*** FLOP *** [6s Qh 2d]
tapouttazz9: checks
Apt1a: bets $0.35
tapouttazz9: calls $0.35
*** TURN *** [6s Qh 2d] [Td]
tapouttazz9: checks
Apt1a: checks
*** RIVER *** [6s Qh 2d Td] [Kd]
tapouttazz9: bets $0.59
Apt1a: folds
Uncalled bet ($0.59) returned to tapouttazz9
tapouttazz9 collected $1.19 from pot
*** SUMMARY ***
Total pot $1.25 | Rake $0.06
Board [6s Qh 2d Td Kd]
Seat 1: lefty0130 (button) folded before Flop (didn't bet)
Seat 2: Schug (small blind) folded before Flop
Seat 4: dangerhard10 (big blind) folded before Flop
Seat 5: tapouttazz9 collected ($1.19)
Seat 6: Apt1a folded on the River


PokerStars Hand #157030237371:  Hold'em No Limit ($0.05/$0.10 USD) - 2016/08/16 17:04:22 ET
Table 'Apus' 6-max Seat #2 is the button
Seat 1: lefty0130 ($13.49 in chips)
Seat 2: Schug ($5.86 in chips)
Seat 4: dangerhard10 ($10.23 in chips)
Seat 5: tapouttazz9 ($12.07 in chips)
Seat 6: Apt1a ($11.67 in chips)
dangerhard10: posts small blind $0.05
tapouttazz9: posts big blind $0.10
*** HOLE CARDS ***
Dealt to tapouttazz9 [9c As]
Apt1a: folds
lefty0130 has timed out
lefty0130: folds
Schug: folds
dangerhard10: folds
Uncalled bet ($0.05) returned to tapouttazz9
tapouttazz9 collected $0.10 from pot
*** SUMMARY ***
Total pot $0.10 | Rake $0
Seat 1: lefty0130 folded before Flop (didn't bet)
Seat 2: Schug (button) folded before Flop (didn't bet)
Seat 4: dangerhard10 (small blind) folded before Flop
Seat 5: tapouttazz9 (big blind) collected ($0.10)
Seat 6: Apt1a folded before Flop (didn't bet)


PokerStars Hand #157030237488:  Hold'em No Limit ($0.05/$0.10 USD) - 2016/08/16 17:04:47 ET
Table 'Apus' 6-max Seat #4 is the button
Seat 2: Schug ($5.86 in chips)
Seat 4: dangerhard10 ($10.18 in chips)
Seat 5: tapouttazz9 ($12.12 in chips)
Seat 6: Apt1a ($11.67 in chips)
tapouttazz9: posts small blind $0.05
Apt1a: posts big blind $0.10
*** HOLE CARDS ***
Dealt to tapouttazz9 [5d 8s]
Schug: raises $0.10 to $0.20
dangerhard10: calls $0.20
tapouttazz9: folds
lefty0130 leaves the table
Apt1a: calls $0.10
*** FLOP *** [6d 6h 7c]
Apt1a: checks
Schug: bets $0.10
dangerhard10: calls $0.10
Apt1a: folds
*** TURN *** [6d 6h 7c] [Jc]
Schug: bets $0.10
dangerhard10: folds
Uncalled bet ($0.10) returned to Schug
Schug collected $0.81 from pot
Schug: doesn't show hand
*** SUMMARY ***
Total pot $0.85 | Rake $0.04
Board [6d 6h 7c Jc]
Seat 2: Schug collected ($0.81)
Seat 4: dangerhard10 (button) folded on the Turn
Seat 5: tapouttazz9 (small blind) folded before Flop
Seat 6: Apt1a (big blind) folded on the Flop


PokerStars Hand #157030237637:  Hold'em No Limit ($0.05/$0.10 USD) - 2016/08/16 17:05:23 ET
Table 'Apus' 6-max Seat #5 is the button
Seat 2: Schug ($6.37 in chips)
Seat 4: dangerhard10 ($9.88 in chips)
Seat 5: tapouttazz9 ($12.07 in chips)
Seat 6: Apt1a ($11.47 in chips)
Apt1a: posts small blind $0.05
Schug: posts big blind $0.10
*** HOLE CARDS ***
Dealt to tapouttazz9 [9s Jd]
dangerhard10: calls $0.10
tapouttazz9: folds
Apt1a: calls $0.05
Schug: checks
*** FLOP *** [8s 7d Qs]
CSilva3 joins the table at seat #1
Apt1a: checks
Schug: checks
dangerhard10: checks
*** TURN *** [8s 7d Qs] [3h]
Apt1a: bets $0.15
Schug: folds
dangerhard10: folds
Uncalled bet ($0.15) returned to Apt1a
Apt1a collected $0.28 from pot
Apt1a: doesn't show hand
*** SUMMARY ***
Total pot $0.30 | Rake $0.02
Board [8s 7d Qs 3h]
Seat 2: Schug (big blind) folded on the Turn
Seat 4: dangerhard10 folded on the Turn
Seat 5: tapouttazz9 (button) folded before Flop (didn't bet)
Seat 6: Apt1a (small blind) collected ($0.28)


PokerStars Hand #157030237819:  Hold'em No Limit ($0.05/$0.10 USD) - 2016/08/16 17:06:08 ET
Table 'Apus' 6-max Seat #6 is the button
Seat 2: Schug ($6.27 in chips)
Seat 4: dangerhard10 ($9.78 in chips)
Seat 5: tapouttazz9 ($12.07 in chips)
Seat 6: Apt1a ($11.65 in chips)
CSilva3 will be allowed to play after the button
Schug: posts small blind $0.05
dangerhard10: posts big blind $0.10
*** HOLE CARDS ***
Dealt to tapouttazz9 [4h 9c]
tapouttazz9: folds
Apt1a: folds
Schug: calls $0.05
dangerhard10: checks
*** FLOP *** [3s 8h 5c]
Schug: bets $0.10
dangerhard10: calls $0.10
*** TURN *** [3s 8h 5c] [2s]
Schug: bets $0.10
dangerhard10: calls $0.10
*** RIVER *** [3s 8h 5c 2s] [8d]
Schug: bets $0.10
dangerhard10: folds
Uncalled bet ($0.10) returned to Schug
Schug collected $0.57 from pot
Schug: doesn't show hand
*** SUMMARY ***
Total pot $0.60 | Rake $0.03
Board [3s 8h 5c 2s 8d]
Seat 2: Schug (small blind) collected ($0.57)
Seat 4: dangerhard10 (big blind) folded on the River
Seat 5: tapouttazz9 folded before Flop (didn't bet)
Seat 6: Apt1a (button) folded before Flop (didn't bet)


PokerStars Hand #157030237940:  Hold'em No Limit ($0.05/$0.10 USD) - 2016/08/16 17:06:34 ET
Table 'Apus' 6-max Seat #2 is the button
Seat 2: Schug ($6.54 in chips)
Seat 4: dangerhard10 ($9.48 in chips)
Seat 5: tapouttazz9 ($12.07 in chips)
Seat 6: Apt1a ($11.65 in chips)
dangerhard10: posts small blind $0.05
tapouttazz9: posts big blind $0.10
CSilva3: sits out
*** HOLE CARDS ***
Dealt to tapouttazz9 [8d 6h]
Apt1a: raises $0.15 to $0.25
Schug: folds
dangerhard10: calls $0.20
tapouttazz9: folds
*** FLOP *** [5c Kc Jh]
dangerhard10: checks
Apt1a: bets $0.35
dangerhard10: folds
Uncalled bet ($0.35) returned to Apt1a
Apt1a collected $0.57 from pot
Apt1a: doesn't show hand
*** SUMMARY ***
Total pot $0.60 | Rake $0.03
Board [5c Kc Jh]
Seat 2: Schug (button) folded before Flop (didn't bet)
Seat 4: dangerhard10 (small blind) folded on the Flop
Seat 5: tapouttazz9 (big blind) folded before Flop
Seat 6: Apt1a collected ($0.57)


PokerStars Hand #157030238064:  Hold'em No Limit ($0.05/$0.10 USD) - 2016/08/16 17:07:04 ET
Table 'Apus' 6-max Seat #4 is the button
Seat 2: Schug ($6.54 in chips)
Seat 4: dangerhard10 ($9.23 in chips)
Seat 5: tapouttazz9 ($11.97 in chips)
Seat 6: Apt1a ($11.97 in chips)
tapouttazz9: posts small blind $0.05
Apt1a: posts big blind $0.10
CSilva3: sits out
*** HOLE CARDS ***
Dealt to tapouttazz9 [Jh 7h]
Schug: calls $0.10
dangerhard10: folds
tapouttazz9: folds
Apt1a: raises $0.35 to $0.45
Schug: folds
Uncalled bet ($0.35) returned to Apt1a
Apt1a collected $0.25 from pot
Apt1a: doesn't show hand
*** SUMMARY ***
Total pot $0.25 | Rake $0
Seat 2: Schug folded before Flop
Seat 4: dangerhard10 (button) folded before Flop (didn't bet)
Seat 5: tapouttazz9 (small blind) folded before Flop
Seat 6: Apt1a (big blind) collected ($0.25)


PokerStars Hand #157030238165:  Hold'em No Limit ($0.05/$0.10 USD) - 2016/08/16 17:07:28 ET
Table 'Apus' 6-max Seat #5 is the button
Seat 1: CSilva3 ($4 in chips)
Seat 2: Schug ($6.44 in chips)
Seat 4: dangerhard10 ($9.23 in chips)
Seat 5: tapouttazz9 ($11.92 in chips)
Seat 6: Apt1a ($12.12 in chips)
Apt1a: posts small blind $0.05
CSilva3: posts big blind $0.10
*** HOLE CARDS ***
Dealt to tapouttazz9 [Ah 4s]
Schug: folds
dangerhard10: folds
tapouttazz9: folds
Apt1a: raises $0.15 to $0.25
CSilva3: calls $0.15
*** FLOP *** [9d 4h 3h]
Apt1a: bets $0.25
CSilva3: calls $0.25
*** TURN *** [9d 4h 3h] [2d]
Apt1a: checks
CSilva3: bets $0.47
Apt1a: calls $0.47
*** RIVER *** [9d 4h 3h 2d] [8s]
Apt1a: checks
CSilva3: bets $3.03 and is all-in
Apt1a: folds
Uncalled bet ($3.03) returned to CSilva3
CSilva3 collected $1.84 from pot
CSilva3: doesn't show hand
*** SUMMARY ***
Total pot $1.94 | Rake $0.10
Board [9d 4h 3h 2d 8s]
Seat 1: CSilva3 (big blind) collected ($1.84)
Seat 2: Schug folded before Flop (didn't bet)
Seat 4: dangerhard10 folded before Flop (didn't bet)
Seat 5: tapouttazz9 (button) folded before Flop (didn't bet)
Seat 6: Apt1a (small blind) folded on the River


PokerStars Hand #157030238669:  Hold'em No Limit ($0.05/$0.10 USD) - 2016/08/16 17:09:24 ET
Table 'Apus' 6-max Seat #6 is the button
Seat 1: CSilva3 ($4.87 in chips)
Seat 2: Schug ($6.44 in chips)
Seat 4: dangerhard10 ($9.23 in chips)
Seat 5: tapouttazz9 ($11.92 in chips)
Seat 6: Apt1a ($11.15 in chips)
CSilva3: posts small blind $0.05
Schug: posts big blind $0.10
*** HOLE CARDS ***
Dealt to tapouttazz9 [Jh Ac]
dangerhard10: folds
tapouttazz9: raises $0.20 to $0.30
Apt1a: calls $0.30
CSilva3: calls $0.25
Schug: calls $0.20
*** FLOP *** [9h 6h 4d]
CSilva3: checks
Schug: checks
tapouttazz9: checks
Apt1a: checks
*** TURN *** [9h 6h 4d] [As]
CSilva3: checks
Schug: checks
tapouttazz9: checks
Apt1a: checks
*** RIVER *** [9h 6h 4d As] [7d]
CSilva3: bets $0.57
Schug: calls $0.57
tapouttazz9: calls $0.57
Apt1a: raises $1.93 to $2.50
CSilva3: raises $2.07 to $4.57 and is all-in
Schug: folds
tapouttazz9: folds
Apt1a: calls $2.07
*** SHOW DOWN ***
CSilva3: shows [8c Tc] (a straight, Six to Ten)
Apt1a: shows [3c 5c] (a straight, Three to Seven)
CSilva3 collected $10.91 from pot
*** SUMMARY ***
Total pot $11.48 | Rake $0.57
Board [9h 6h 4d As 7d]
Seat 1: CSilva3 (small blind) showed [8c Tc] and won ($10.91) with a straight, Six to Ten
Seat 2: Schug (big blind) folded on the River
Seat 4: dangerhard10 folded before Flop (didn't bet)
Seat 5: tapouttazz9 folded on the River
Seat 6: Apt1a (button) showed [3c 5c] and lost with a straight, Three to Seven


PokerStars Hand #157030239120:  Hold'em No Limit ($0.05/$0.10 USD) - 2016/08/16 17:11:10 ET
Table 'Apus' 6-max Seat #1 is the button
Seat 1: CSilva3 ($10.91 in chips)
Seat 2: Schug ($5.57 in chips)
Seat 4: dangerhard10 ($9.23 in chips)
Seat 5: tapouttazz9 ($11.05 in chips)
Seat 6: Apt1a ($6.28 in chips)
Schug: posts small blind $0.05
dangerhard10: posts big blind $0.10
*** HOLE CARDS ***
Dealt to tapouttazz9 [5s 6d]
tapouttazz9: folds
Apt1a: folds
CSilva3: folds
Schug: calls $0.05
dangerhard10: raises $0.10 to $0.20
Schug: calls $0.10
*** FLOP *** [7d Td As]
Schug: checks
Apt1a said, "nh"
dangerhard10: bets $0.10
Schug: calls $0.10
*** TURN *** [7d Td As] [Js]
Schug: bets $0.57
dangerhard10: calls $0.57
*** RIVER *** [7d Td As Js] [4d]
Schug: bets $0.82
dangerhard10: calls $0.82
*** SHOW DOWN ***
Schug: shows [Ad 6s] (a pair of Aces)
dangerhard10: shows [Jd Ac] (two pair, Aces and Jacks)
dangerhard10 collected $3.21 from pot
*** SUMMARY ***
Total pot $3.38 | Rake $0.17
Board [7d Td As Js 4d]
Seat 1: CSilva3 (button) folded before Flop (didn't bet)
Seat 2: Schug (small blind) showed [Ad 6s] and lost with a pair of Aces
Seat 4: dangerhard10 (big blind) showed [Jd Ac] and won ($3.21) with two pair, Aces and Jacks
Seat 5: tapouttazz9 folded before Flop (didn't bet)
Seat 6: Apt1a folded before Flop (didn't bet)


PokerStars Hand #157030239345:  Hold'em No Limit ($0.05/$0.10 USD) - 2016/08/16 17:12:01 ET
Table 'Apus' 6-max Seat #2 is the button
Seat 1: CSilva3 ($10.91 in chips)
Seat 2: Schug ($3.88 in chips)
Seat 4: dangerhard10 ($10.75 in chips)
Seat 5: tapouttazz9 ($11.05 in chips)
Seat 6: Apt1a ($6.28 in chips)
dangerhard10: posts small blind $0.05
tapouttazz9: posts big blind $0.10
*** HOLE CARDS ***
Dealt to tapouttazz9 [6c Ad]
Apt1a: folds
CSilva3: calls $0.10
Schug: folds
dangerhard10: calls $0.05
tapouttazz9: checks
*** FLOP *** [5s Ks 8d]
dangerhard10: checks
tapouttazz9: checks
CSilva3: bets $0.14
dangerhard10: folds
tapouttazz9: folds
Uncalled bet ($0.14) returned to CSilva3
CSilva3 collected $0.28 from pot
CSilva3: doesn't show hand
*** SUMMARY ***
Total pot $0.30 | Rake $0.02
Board [5s Ks 8d]
Seat 1: CSilva3 collected ($0.28)
Seat 2: Schug (button) folded before Flop (didn't bet)
Seat 4: dangerhard10 (small blind) folded on the Flop
Seat 5: tapouttazz9 (big blind) folded on the Flop
Seat 6: Apt1a folded before Flop (didn't bet)


PokerStars Hand #157030239538:  Hold'em No Limit ($0.05/$0.10 USD) - 2016/08/16 17:12:43 ET
Table 'Apus' 6-max Seat #4 is the button
Seat 1: CSilva3 ($11.09 in chips)
Seat 2: Schug ($3.88 in chips)
Seat 4: dangerhard10 ($10.65 in chips)
Seat 5: tapouttazz9 ($10.95 in chips)
Seat 6: Apt1a ($6.28 in chips)
tapouttazz9: posts small blind $0.05
Apt1a: posts big blind $0.10
*** HOLE CARDS ***
Dealt to tapouttazz9 [6s Td]
CSilva3: calls $0.10
Schug: folds
dangerhard10: folds
tapouttazz9: folds
Apt1a: raises $0.15 to $0.25
CSilva3: calls $0.15
*** FLOP *** [Jd 3h 5d]
Apt1a: bets $0.35
CSilva3: calls $0.35
*** TURN *** [Jd 3h 5d] [4h]
Apt1a: checks
CSilva3: bets $1.19
Apt1a: folds
Uncalled bet ($1.19) returned to CSilva3
CSilva3 collected $1.19 from pot
CSilva3: doesn't show hand
*** SUMMARY ***
Total pot $1.25 | Rake $0.06
Board [Jd 3h 5d 4h]
Seat 1: CSilva3 collected ($1.19)
Seat 2: Schug folded before Flop (didn't bet)
Seat 4: dangerhard10 (button) folded before Flop (didn't bet)
Seat 5: tapouttazz9 (small blind) folded before Flop
Seat 6: Apt1a (big blind) folded on the Turn


PokerStars Hand #157030239770:  Hold'em No Limit ($0.05/$0.10 USD) - 2016/08/16 17:13:36 ET
Table 'Apus' 6-max Seat #5 is the button
Seat 1: CSilva3 ($11.68 in chips)
Seat 2: Schug ($3.88 in chips)
Seat 4: dangerhard10 ($10.65 in chips)
Seat 5: tapouttazz9 ($10.90 in chips)
Seat 6: Apt1a ($5.68 in chips)
Apt1a: posts small blind $0.05
CSilva3: posts big blind $0.10
*** HOLE CARDS ***
Dealt to tapouttazz9 [Jc Ac]
Schug: calls $0.10
dangerhard10: folds
tapouttazz9: raises $0.20 to $0.30
Apt1a: calls $0.25
CSilva3: folds
Schug: calls $0.20
*** FLOP *** [3d Jd 9d]
Apt1a: checks
Schug: bets $0.10
tapouttazz9: calls $0.10
Apt1a: calls $0.10
*** TURN *** [3d Jd 9d] [3c]
Apt1a: checks
Schug: checks
tapouttazz9: checks
*** RIVER *** [3d Jd 9d 3c] [8c]
Apt1a: checks
Schug: checks
tapouttazz9: checks
*** SHOW DOWN ***
Apt1a: shows [Kh Qh] (a pair of Threes)
Schug: shows [Ah 5h] (a pair of Threes - Ace kicker)
tapouttazz9: shows [Jc Ac] (two pair, Jacks and Threes)
tapouttazz9 collected $1.24 from pot
*** SUMMARY ***
Total pot $1.30 | Rake $0.06
Board [3d Jd 9d 3c 8c]
Seat 1: CSilva3 (big blind) folded before Flop
Seat 2: Schug showed [Ah 5h] and lost with a pair of Threes
Seat 4: dangerhard10 folded before Flop (didn't bet)
Seat 5: tapouttazz9 (button) showed [Jc Ac] and won ($1.24) with two pair, Jacks and Threes
Seat 6: Apt1a (small blind) showed [Kh Qh] and lost with a pair of Threes


PokerStars Hand #157030860361:  Hold'em No Limit ($0.05/$0.10 USD) - 2016/08/16 17:14:38 ET
Table 'Apus' 6-max Seat #6 is the button
Seat 1: CSilva3 ($11.58 in chips)
Seat 2: Schug ($3.48 in chips)
Seat 4: dangerhard10 ($10.65 in chips)
Seat 5: tapouttazz9 ($11.74 in chips)
Seat 6: Apt1a ($5.28 in chips)
CSilva3: posts small blind $0.05
Schug: posts big blind $0.10
*** HOLE CARDS ***
Dealt to tapouttazz9 [2s Jh]
dangerhard10: folds
tapouttazz9: folds
Apt1a: folds
CSilva3: folds
Uncalled bet ($0.05) returned to Schug
Schug collected $0.10 from pot
Schug: doesn't show hand
*** SUMMARY ***
Total pot $0.10 | Rake $0
Seat 1: CSilva3 (small blind) folded before Flop
Seat 2: Schug (big blind) collected ($0.10)
Seat 4: dangerhard10 folded before Flop (didn't bet)
Seat 5: tapouttazz9 folded before Flop (didn't bet)
Seat 6: Apt1a (button) folded before Flop (didn't bet)


PokerStars Hand #157030860419:  Hold'em No Limit ($0.05/$0.10 USD) - 2016/08/16 17:14:52 ET
Table 'Apus' 6-max Seat #1 is the button
Seat 1: CSilva3 ($11.53 in chips)
Seat 2: Schug ($3.53 in chips)
Seat 4: dangerhard10 ($10.65 in chips)
Seat 5: tapouttazz9 ($11.74 in chips)
Seat 6: Apt1a ($5.28 in chips)
Schug: posts small blind $0.05
dangerhard10: posts big blind $0.10
*** HOLE CARDS ***
Dealt to tapouttazz9 [6d 7s]
tapouttazz9: folds
Apt1a: raises $0.15 to $0.25
CSilva3: folds
Schug: folds
dangerhard10: raises $0.15 to $0.40
Apt1a: calls $0.15
*** FLOP *** [As 5c Qc]
dangerhard10: bets $0.40
Apt1a: folds
Uncalled bet ($0.40) returned to dangerhard10
dangerhard10 collected $0.81 from pot
*** SUMMARY ***
Total pot $0.85 | Rake $0.04
Board [As 5c Qc]
Seat 1: CSilva3 (button) folded before Flop (didn't bet)
Seat 2: Schug (small blind) folded before Flop
Seat 4: dangerhard10 (big blind) collected ($0.81)
Seat 5: tapouttazz9 folded before Flop (didn't bet)
Seat 6: Apt1a folded on the Flop


PokerStars Hand #157030860558:  Hold'em No Limit ($0.05/$0.10 USD) - 2016/08/16 17:15:21 ET
Table 'Apus' 6-max Seat #2 is the button
Seat 1: CSilva3 ($11.53 in chips)
Seat 2: Schug ($3.48 in chips)
Seat 4: dangerhard10 ($11.06 in chips)
Seat 5: tapouttazz9 ($11.74 in chips)
Seat 6: Apt1a ($9.60 in chips)
dangerhard10: posts small blind $0.05
tapouttazz9: posts big blind $0.10
*** HOLE CARDS ***
Dealt to tapouttazz9 [4c 5c]
Apt1a: folds
CSilva3: calls $0.10
Schug: folds
dangerhard10: calls $0.05
tapouttazz9: checks
*** FLOP *** [Tc Js 3s]
dangerhard10: bets $0.10
tapouttazz9: calls $0.10
CSilva3: calls $0.10
*** TURN *** [Tc Js 3s] [6s]
dangerhard10: bets $0.10
tapouttazz9: calls $0.10
CSilva3: calls $0.10
*** RIVER *** [Tc Js 3s 6s] [Ac]
dangerhard10: bets $0.10
tapouttazz9: folds
CSilva3: raises $0.53 to $0.63
dangerhard10: folds
Uncalled bet ($0.53) returned to CSilva3
CSilva3 collected $1.04 from pot
CSilva3: doesn't show hand
*** SUMMARY ***
Total pot $1.10 | Rake $0.06
Board [Tc Js 3s 6s Ac]
Seat 1: CSilva3 collected ($1.04)
Seat 2: Schug (button) folded before Flop (didn't bet)
Seat 4: dangerhard10 (small blind) folded on the River
Seat 5: tapouttazz9 (big blind) folded on the River
Seat 6: Apt1a folded before Flop (didn't bet)


PokerStars Hand #157030860788:  Hold'em No Limit ($0.05/$0.10 USD) - 2016/08/16 17:16:13 ET
Table 'Apus' 6-max Seat #4 is the button
Seat 1: CSilva3 ($12.17 in chips)
Seat 2: Schug ($3.48 in chips)
Seat 4: dangerhard10 ($10.66 in chips)
Seat 5: tapouttazz9 ($11.44 in chips)
Seat 6: Apt1a ($10 in chips)
tapouttazz9: posts small blind $0.05
Apt1a: posts big blind $0.10
*** HOLE CARDS ***
Dealt to tapouttazz9 [7d 6d]
CSilva3: folds
Schug: folds
dangerhard10: calls $0.10
tapouttazz9: folds
Apt1a: checks
*** FLOP *** [8d Tc 2h]
Apt1a: checks
dangerhard10: checks
*** TURN *** [8d Tc 2h] [Jc]
Apt1a: bets $0.20
dangerhard10: folds
Uncalled bet ($0.20) returned to Apt1a
Apt1a collected $0.24 from pot
Apt1a: doesn't show hand
*** SUMMARY ***
Total pot $0.25 | Rake $0.01
Board [8d Tc 2h Jc]
Seat 1: CSilva3 folded before Flop (didn't bet)
Seat 2: Schug folded before Flop (didn't bet)
Seat 4: dangerhard10 (button) folded on the Turn
Seat 5: tapouttazz9 (small blind) folded before Flop
Seat 6: Apt1a (big blind) collected ($0.24)


PokerStars Hand #157030860878:  Hold'em No Limit ($0.05/$0.10 USD) - 2016/08/16 17:16:36 ET
Table 'Apus' 6-max Seat #5 is the button
Seat 2: Schug ($3.48 in chips)
Seat 4: dangerhard10 ($10.56 in chips)
Seat 5: tapouttazz9 ($11.39 in chips)
Seat 6: Apt1a ($10.14 in chips)
Apt1a: posts small blind $0.05
CSilva3: is sitting out
Schug: posts big blind $0.10
*** HOLE CARDS ***
Dealt to tapouttazz9 [Qh 3s]
dangerhard10: folds
tapouttazz9: folds
Apt1a: calls $0.05
Schug: checks
*** FLOP *** [8d Jh Kh]
Apt1a: checks
Schug: checks
*** TURN *** [8d Jh Kh] [Ad]
Apt1a: bets $0.15
Schug: calls $0.15
*** RIVER *** [8d Jh Kh Ad] [Th]
CSilva3 leaves the table
Apt1a: bets $0.50
Schug: calls $0.50
*** SHOW DOWN ***
Apt1a: shows [6h Qs] (a straight, Ten to Ace)
Schug: mucks hand
Apt1a collected $1.42 from pot
*** SUMMARY ***
Total pot $1.50 | Rake $0.08
Board [8d Jh Kh Ad Th]
Seat 2: Schug (big blind) mucked [9h As]
Seat 4: dangerhard10 folded before Flop (didn't bet)
Seat 5: tapouttazz9 (button) folded before Flop (didn't bet)
Seat 6: Apt1a (small blind) showed [6h Qs] and won ($1.42) with a straight, Ten to Ace


PokerStars Hand #157030861018:  Hold'em No Limit ($0.05/$0.10 USD) - 2016/08/16 17:17:10 ET
Table 'Apus' 6-max Seat #6 is the button
Seat 2: Schug ($2.73 in chips)
Seat 4: dangerhard10 ($10.56 in chips)
Seat 5: tapouttazz9 ($11.39 in chips)
Seat 6: Apt1a ($10.81 in chips)
Schug: posts small blind $0.05
dangerhard10: posts big blind $0.10
*** HOLE CARDS ***
Dealt to tapouttazz9 [Ac 9s]
@japhypoker joins the table at seat #1
tapouttazz9: raises $0.10 to $0.20
Apt1a: folds
Schug: folds
dangerhard10: folds
Uncalled bet ($0.10) returned to tapouttazz9
tapouttazz9 collected $0.25 from pot
*** SUMMARY ***
Total pot $0.25 | Rake $0
Seat 2: Schug (small blind) folded before Flop
Seat 4: dangerhard10 (big blind) folded before Flop
Seat 5: tapouttazz9 collected ($0.25)
Seat 6: Apt1a (button) folded before Flop (didn't bet)


PokerStars Hand #157030861058:  Hold'em No Limit ($0.05/$0.10 USD) - 2016/08/16 17:17:20 ET
Table 'Apus' 6-max Seat #2 is the button
Seat 2: Schug ($2.68 in chips)
Seat 4: dangerhard10 ($10.46 in chips)
Seat 5: tapouttazz9 ($11.54 in chips)
Seat 6: Apt1a ($10.81 in chips)
dangerhard10: posts small blind $0.05
tapouttazz9: posts big blind $0.10
@japhypoker: sits out
*** HOLE CARDS ***
Dealt to tapouttazz9 [Kh 7s]
Apt1a: raises $0.15 to $0.25
Schug: calls $0.25
dangerhard10: folds
tapouttazz9: folds
*** FLOP *** [3d Th 4h]
Apt1a: checks
Schug: checks
*** TURN *** [3d Th 4h] [Qs]
Apt1a: bets $0.40
Schug: calls $0.40
*** RIVER *** [3d Th 4h Qs] [2c]
Apt1a: checks
Schug: checks
*** SHOW DOWN ***
Apt1a: shows [Tc Jd] (a pair of Tens)
Schug: shows [6c Qc] (a pair of Queens)
Schug collected $1.38 from pot
*** SUMMARY ***
Total pot $1.45 | Rake $0.07
Board [3d Th 4h Qs 2c]
Seat 2: Schug (button) showed [6c Qc] and won ($1.38) with a pair of Queens
Seat 4: dangerhard10 (small blind) folded before Flop
Seat 5: tapouttazz9 (big blind) folded before Flop
Seat 6: Apt1a showed [Tc Jd] and lost with a pair of Tens


PokerStars Hand #157030861208:  Hold'em No Limit ($0.05/$0.10 USD) - 2016/08/16 17:17:57 ET
Table 'Apus' 6-max Seat #4 is the button
Seat 2: Schug ($3.41 in chips)
Seat 4: dangerhard10 ($10.41 in chips)
Seat 5: tapouttazz9 ($11.44 in chips)
Seat 6: Apt1a ($10.16 in chips)
tapouttazz9: posts small blind $0.05
Apt1a: posts big blind $0.10
@japhypoker: sits out
*** HOLE CARDS ***
Dealt to tapouttazz9 [Ks 6d]
Schug: calls $0.10
dangerhard10: folds
tapouttazz9: folds
Apt1a: raises $0.30 to $0.40
Schug: calls $0.30
*** FLOP *** [8c 5h 2d]
Apt1a: bets $0.45
Schug: folds
Uncalled bet ($0.45) returned to Apt1a
Apt1a collected $0.81 from pot
Apt1a: doesn't show hand
*** SUMMARY ***
Total pot $0.85 | Rake $0.04
Board [8c 5h 2d]
Seat 2: Schug folded on the Flop
Seat 4: dangerhard10 (button) folded before Flop (didn't bet)
Seat 5: tapouttazz9 (small blind) folded before Flop
Seat 6: Apt1a (big blind) collected ($0.81)


PokerStars Hand #157030861392:  Hold'em No Limit ($0.05/$0.10 USD) - 2016/08/16 17:18:41 ET
Table 'Apus' 6-max Seat #5 is the button
Seat 1: @japhypoker ($10 in chips)
Seat 2: Schug ($3.01 in chips)
Seat 4: dangerhard10 ($10.41 in chips)
Seat 5: tapouttazz9 ($11.39 in chips)
Seat 6: Apt1a ($10.57 in chips)
Apt1a: posts small blind $0.05
@japhypoker: posts big blind $0.10
*** HOLE CARDS ***
Dealt to tapouttazz9 [5d Qc]
Schug: calls $0.10
dangerhard10: raises $0.10 to $0.20
tapouttazz9: folds
Apt1a: folds
@japhypoker: folds
Schug: calls $0.10
*** FLOP *** [Th 3c Td]
Schug: checks
dangerhard10: checks
*** TURN *** [Th 3c Td] [2s]
Schug: checks
dangerhard10: checks
*** RIVER *** [Th 3c Td 2s] [8d]
Schug: checks
dangerhard10: checks
*** SHOW DOWN ***
Schug: shows [Ad 4h] (a pair of Tens)
dangerhard10: shows [As 5s] (a pair of Tens - Ace+Eight+Five kicker)
dangerhard10 collected $0.52 from pot
*** SUMMARY ***
Total pot $0.55 | Rake $0.03
Board [Th 3c Td 2s 8d]
Seat 1: @japhypoker (big blind) folded before Flop
Seat 2: Schug showed [Ad 4h] and lost with a pair of Tens
Seat 4: dangerhard10 showed [As 5s] and won ($0.52) with a pair of Tens
Seat 5: tapouttazz9 (button) folded before Flop (didn't bet)
Seat 6: Apt1a (small blind) folded before Flop


PokerStars Hand #157030861474:  Hold'em No Limit ($0.05/$0.10 USD) - 2016/08/16 17:19:01 ET
Table 'Apus' 6-max Seat #6 is the button
Seat 1: @japhypoker ($10 in chips)
Seat 2: Schug ($2.81 in chips)
Seat 4: dangerhard10 ($10.73 in chips)
Seat 5: tapouttazz9 ($11.39 in chips)
Seat 6: Apt1a ($10.52 in chips)
@japhypoker: posts small blind $0.05
Schug: posts big blind $0.10
*** HOLE CARDS ***
Dealt to tapouttazz9 [Kd Td]
dangerhard10: folds
tapouttazz9: raises $0.20 to $0.30
Apt1a: calls $0.30
@japhypoker: folds
Schug: calls $0.20
*** FLOP *** [4c Ts Ad]
Schug: checks
tapouttazz9: checks
Apt1a: checks
*** TURN *** [4c Ts Ad] [Ac]
Schug: checks
tapouttazz9: checks
Apt1a: bets $0.65
Schug: folds
tapouttazz9: calls $0.65
*** RIVER *** [4c Ts Ad Ac] [6c]
tapouttazz9: checks
Apt1a: checks
*** SHOW DOWN ***
tapouttazz9: shows [Kd Td] (two pair, Aces and Tens)
Apt1a: mucks hand
tapouttazz9 collected $2.14 from pot
*** SUMMARY ***
Total pot $2.25 | Rake $0.11
Board [4c Ts Ad Ac 6c]
Seat 1: @japhypoker (small blind) folded before Flop
Seat 2: Schug (big blind) folded on the Turn
Seat 4: dangerhard10 folded before Flop (didn't bet)
Seat 5: tapouttazz9 showed [Kd Td] and won ($2.14) with two pair, Aces and Tens
Seat 6: Apt1a (button) mucked [9d 9s]


PokerStars Hand #157030861710:  Hold'em No Limit ($0.05/$0.10 USD) - 2016/08/16 17:19:58 ET
Table 'Apus' 6-max Seat #1 is the button
Seat 1: @japhypoker ($10 in chips)
Seat 2: Schug ($10 in chips)
Seat 4: dangerhard10 ($10.73 in chips)
Seat 5: tapouttazz9 ($12.58 in chips)
Seat 6: Apt1a ($9.57 in chips)
Schug: posts small blind $0.05
dogboy1088 was removed from the table for failing to post
dangerhard10: posts big blind $0.10
*** HOLE CARDS ***
Dealt to tapouttazz9 [Qs 6s]
tapouttazz9: folds
tclick joins the table at seat #3
Apt1a: folds
tapouttazz9 said, "sup japhy"
@japhypoker: folds
Schug: calls $0.05
dangerhard10: checks
*** FLOP *** [8d 9s Qc]
Schug: checks
dangerhard10: checks
*** TURN *** [8d 9s Qc] [8s]
Schug: bets $0.10
dangerhard10: calls $0.10
*** RIVER *** [8d 9s Qc 8s] [Qh]
Schug: bets $0.10
dangerhard10: folds
Uncalled bet ($0.10) returned to Schug
Schug collected $0.38 from pot
Schug: doesn't show hand
*** SUMMARY ***
Total pot $0.40 | Rake $0.02
Board [8d 9s Qc 8s Qh]
Seat 1: @japhypoker (button) folded before Flop (didn't bet)
Seat 2: Schug (small blind) collected ($0.38)
Seat 4: dangerhard10 (big blind) folded on the River
Seat 5: tapouttazz9 folded before Flop (didn't bet)
Seat 6: Apt1a folded before Flop (didn't bet)


PokerStars Hand #157030861935:  Hold'em No Limit ($0.05/$0.10 USD) - 2016/08/16 17:20:51 ET
Table 'Apus' 6-max Seat #2 is the button
Seat 1: @japhypoker ($10 in chips)
Seat 2: Schug ($10.18 in chips)
Seat 4: dangerhard10 ($10.53 in chips)
Seat 5: tapouttazz9 ($12.58 in chips)
Seat 6: Apt1a ($9.57 in chips)
tclick will be allowed to play after the button
dangerhard10: posts small blind $0.05
tapouttazz9: posts big blind $0.10
*** HOLE CARDS ***
Dealt to tapouttazz9 [Qh 6h]
Apt1a: folds
@japhypoker: folds
@japhypoker said, "hey tazz"
Schug: calls $0.10
dangerhard10: folds
tapouttazz9 said, "what up"
tapouttazz9: checks
*** FLOP *** [9d 7s Th]
tapouttazz9: checks
Schug: checks
*** TURN *** [9d 7s Th] [2c]
@japhypoker said, "filling out my stars card"
tapouttazz9: checks
Schug: checks
*** RIVER *** [9d 7s Th 2c] [4c]
tapouttazz9: checks
Schug: checks
*** SHOW DOWN ***
tapouttazz9: shows [Qh 6h] (high card Queen)
Schug: shows [Qd 2h] (a pair of Deuces)
Schug collected $0.24 from pot
*** SUMMARY ***
Total pot $0.25 | Rake $0.01
Board [9d 7s Th 2c 4c]
Seat 1: @japhypoker folded before Flop (didn't bet)
Seat 2: Schug (button) showed [Qd 2h] and won ($0.24) with a pair of Deuces
Seat 4: dangerhard10 (small blind) folded before Flop
Seat 5: tapouttazz9 (big blind) showed [Qh 6h] and lost with high card Queen
Seat 6: Apt1a folded before Flop (didn't bet)


PokerStars Hand #157030862073:  Hold'em No Limit ($0.05/$0.10 USD) - 2016/08/16 17:21:26 ET
Table 'Apus' 6-max Seat #4 is the button
Seat 1: @japhypoker ($10 in chips)
Seat 2: Schug ($10.32 in chips)
Seat 3: tclick ($8 in chips)
Seat 4: dangerhard10 ($10.48 in chips)
Seat 5: tapouttazz9 ($12.48 in chips)
Seat 6: Apt1a ($9.57 in chips)
tapouttazz9: posts small blind $0.05
Apt1a: posts big blind $0.10
tclick: posts big blind $0.10
*** HOLE CARDS ***
Dealt to tapouttazz9 [7c 3h]
@japhypoker: folds
Schug: calls $0.10
tclick: checks
dangerhard10: folds
tapouttazz9: folds
Apt1a: checks
*** FLOP *** [As 4s 8d]
tapouttazz9 said, "stars card"
Apt1a: checks
tapouttazz9 said, "??"
Schug: checks
tclick: checks
*** TURN *** [As 4s 8d] [5d]
Apt1a: bets $0.20
@japhypoker said, "the promo"
Schug: calls $0.20
tclick: folds
*** RIVER *** [As 4s 8d 5d] [7s]
Apt1a: checks
@japhypoker said, "winning hands w/ broadway cards in the hole"
Schug: checks
*** SHOW DOWN ***
Apt1a: shows [8s 7d] (two pair, Eights and Sevens)
Schug: mucks hand
Apt1a collected $0.71 from pot
*** SUMMARY ***
Total pot $0.75 | Rake $0.04
Board [As 4s 8d 5d 7s]
Seat 1: @japhypoker folded before Flop (didn't bet)
Seat 2: Schug mucked [3d Js]
Seat 3: tclick folded on the Turn
Seat 4: dangerhard10 (button) folded before Flop (didn't bet)
Seat 5: tapouttazz9 (small blind) folded before Flop
Seat 6: Apt1a (big blind) showed [8s 7d] and won ($0.71) with two pair, Eights and Sevens


PokerStars Hand #157030862314:  Hold'em No Limit ($0.05/$0.10 USD) - 2016/08/16 17:22:24 ET
Table 'Apus' 6-max Seat #6 is the button
Seat 1: @japhypoker ($10 in chips)
Seat 2: Schug ($10.02 in chips)
Seat 3: tclick ($7.90 in chips)
Seat 4: dangerhard10 ($10.48 in chips)
Seat 6: Apt1a ($9.98 in chips)
@japhypoker: posts small blind $0.05
Schug: posts big blind $0.10
*** HOLE CARDS ***
tclick: calls $0.10
dangerhard10: folds
Apt1a: folds
@japhypoker: folds
Schug: checks
*** FLOP *** [2c 8c Ac]
Schug: checks
tclick: checks
*** TURN *** [2c 8c Ac] [4d]
Schug: bets $0.50
tclick: folds
Uncalled bet ($0.50) returned to Schug
Schug collected $0.24 from pot
*** SUMMARY ***
Total pot $0.25 | Rake $0.01
Board [2c 8c Ac 4d]
Seat 1: @japhypoker (small blind) folded before Flop
Seat 2: Schug (big blind) collected ($0.24)
Seat 3: tclick folded on the Turn
Seat 4: dangerhard10 folded before Flop (didn't bet)
Seat 6: Apt1a (button) folded before Flop (didn't bet)


PokerStars Hand #157030862462:  Hold'em No Limit ($0.05/$0.10 USD) - 2016/08/16 17:22:58 ET
Table 'Apus' 6-max Seat #1 is the button
Seat 1: @japhypoker ($10 in chips)
Seat 2: Schug ($10.16 in chips)
Seat 3: tclick ($7.80 in chips)
Seat 4: dangerhard10 ($10.48 in chips)
Seat 6: Apt1a ($9.98 in chips)
Schug: posts small blind $0.05
tclick: posts big blind $0.10
*** HOLE CARDS ***
dangerhard10: folds
Apt1a: raises $0.15 to $0.25
@japhypoker: raises $0.55 to $0.80
tapouttazz9 said, "ohh"
Schug: folds
tclick: folds
Apt1a: calls $0.55
*** FLOP *** [6c 3c Tc]
Apt1a: checks
@japhypoker: bets $0.40
Apt1a: calls $0.40
*** TURN *** [6c 3c Tc] [9h]
Apt1a: checks
@japhypoker: bets $0.50
Apt1a: raises $1 to $1.50
@japhypoker: calls $1
*** RIVER *** [6c 3c Tc 9h] [9d]
Apt1a: bets $2.60
@japhypoker: calls $2.60
*** SHOW DOWN ***
Apt1a: shows [Ks Js] (a pair of Nines)
@japhypoker: shows [Kc Ac] (a flush, Ace high)
@japhypoker collected $10.21 from pot
*** SUMMARY ***
Total pot $10.75 | Rake $0.54
Board [6c 3c Tc 9h 9d]
Seat 1: @japhypoker (button) showed [Kc Ac] and won ($10.21) with a flush, Ace high
Seat 2: Schug (small blind) folded before Flop
Seat 3: tclick (big blind) folded before Flop
Seat 4: dangerhard10 folded before Flop (didn't bet)
Seat 6: Apt1a showed [Ks Js] and lost with a pair of Nines


PokerStars Hand #157030863027:  Hold'em No Limit ($0.05/$0.10 USD) - 2016/08/16 17:25:12 ET
Table 'Apus' 6-max Seat #2 is the button
Seat 1: @japhypoker ($14.91 in chips)
Seat 2: Schug ($10.11 in chips)
Seat 3: tclick ($7.70 in chips)
Seat 4: dangerhard10 ($10.48 in chips)
Seat 5: tapouttazz9 ($12.43 in chips)
Seat 6: Apt1a ($4.68 in chips)
tclick: posts small blind $0.05
dangerhard10: posts big blind $0.10
*** HOLE CARDS ***
Dealt to tapouttazz9 [4h Td]
tapouttazz9: folds
Apt1a: folds
@japhypoker: folds
Schug: folds
tclick: folds
Uncalled bet ($0.05) returned to dangerhard10
dangerhard10 collected $0.10 from pot
*** SUMMARY ***
Total pot $0.10 | Rake $0
Seat 1: @japhypoker folded before Flop (didn't bet)
Seat 2: Schug (button) folded before Flop (didn't bet)
Seat 3: tclick (small blind) folded before Flop
Seat 4: dangerhard10 (big blind) collected ($0.10)
Seat 5: tapouttazz9 folded before Flop (didn't bet)
Seat 6: Apt1a folded before Flop (didn't bet)


PokerStars Hand #157030863077:  Hold'em No Limit ($0.05/$0.10 USD) - 2016/08/16 17:25:24 ET
Table 'Apus' 6-max Seat #3 is the button
Seat 1: @japhypoker ($14.91 in chips)
Seat 2: Schug ($10.11 in chips)
Seat 3: tclick ($7.65 in chips)
Seat 4: dangerhard10 ($10.53 in chips)
Seat 5: tapouttazz9 ($12.43 in chips)
Seat 6: Apt1a ($4.68 in chips)
dangerhard10: posts small blind $0.05
tapouttazz9: posts big blind $0.10
*** HOLE CARDS ***
Dealt to tapouttazz9 [Ks 5h]
Apt1a: folds
@japhypoker: raises $0.15 to $0.25
Schug: folds
tclick: folds
dangerhard10: folds
tapouttazz9: folds
Uncalled bet ($0.15) returned to @japhypoker
@japhypoker collected $0.25 from pot
@japhypoker: doesn't show hand
*** SUMMARY ***
Total pot $0.25 | Rake $0
Seat 1: @japhypoker collected ($0.25)
Seat 2: Schug folded before Flop (didn't bet)
Seat 3: tclick (button) folded before Flop (didn't bet)
Seat 4: dangerhard10 (small blind) folded before Flop
Seat 5: tapouttazz9 (big blind) folded before Flop
Seat 6: Apt1a folded before Flop (didn't bet)


PokerStars Hand #157030863217:  Hold'em No Limit ($0.05/$0.10 USD) - 2016/08/16 17:25:55 ET
Table 'Apus' 6-max Seat #4 is the button
Seat 1: @japhypoker ($15.06 in chips)
Seat 2: Schug ($10.11 in chips)
Seat 3: tclick ($7.65 in chips)
Seat 4: dangerhard10 ($10.48 in chips)
Seat 5: tapouttazz9 ($12.33 in chips)
Seat 6: Apt1a ($10 in chips)
tapouttazz9: posts small blind $0.05
Apt1a: posts big blind $0.10
*** HOLE CARDS ***
Dealt to tapouttazz9 [Js Ad]
@japhypoker: folds
Schug: calls $0.10
tclick: folds
dangerhard10: folds
tapouttazz9: raises $0.20 to $0.30
Apt1a: folds
Schug: calls $0.20
*** FLOP *** [5s 9s Ac]
tapouttazz9: checks
Schug: checks
*** TURN *** [5s 9s Ac] [3h]
tapouttazz9: bets $0.33
Schug: calls $0.33
*** RIVER *** [5s 9s Ac 3h] [8c]
tapouttazz9: bets $0.64
Schug: folds
Uncalled bet ($0.64) returned to tapouttazz9
tapouttazz9 collected $1.29 from pot
*** SUMMARY ***
Total pot $1.36 | Rake $0.07
Board [5s 9s Ac 3h 8c]
Seat 1: @japhypoker folded before Flop (didn't bet)
Seat 2: Schug folded on the River
Seat 3: tclick folded before Flop (didn't bet)
Seat 4: dangerhard10 (button) folded before Flop (didn't bet)
Seat 5: tapouttazz9 (small blind) collected ($1.29)
Seat 6: Apt1a (big blind) folded before Flop


PokerStars Hand #157030863429:  Hold'em No Limit ($0.05/$0.10 USD) - 2016/08/16 17:26:42 ET
Table 'Apus' 6-max Seat #5 is the button
Seat 1: @japhypoker ($15.06 in chips)
Seat 2: Schug ($9.48 in chips)
Seat 3: tclick ($7.65 in chips)
Seat 4: dangerhard10 ($10.48 in chips)
Seat 5: tapouttazz9 ($12.99 in chips)
Seat 6: Apt1a ($9.90 in chips)
Apt1a: posts small blind $0.05
@japhypoker: posts big blind $0.10
*** HOLE CARDS ***
Dealt to tapouttazz9 [Qd 4d]
Schug: folds
tclick: folds
dangerhard10: folds
tapouttazz9: folds
Apt1a: raises $0.15 to $0.25
@japhypoker: folds
Uncalled bet ($0.15) returned to Apt1a
Apt1a collected $0.20 from pot
Apt1a: doesn't show hand
*** SUMMARY ***
Total pot $0.20 | Rake $0
Seat 1: @japhypoker (big blind) folded before Flop
Seat 2: Schug folded before Flop (didn't bet)
Seat 3: tclick folded before Flop (didn't bet)
Seat 4: dangerhard10 folded before Flop (didn't bet)
Seat 5: tapouttazz9 (button) folded before Flop (didn't bet)
Seat 6: Apt1a (small blind) collected ($0.20)


PokerStars Hand #157030863520:  Hold'em No Limit ($0.05/$0.10 USD) - 2016/08/16 17:27:02 ET
Table 'Apus' 6-max Seat #6 is the button
Seat 1: @japhypoker ($14.96 in chips)
Seat 2: Schug ($9.48 in chips)
Seat 3: tclick ($7.65 in chips)
Seat 4: dangerhard10 ($10.48 in chips)
Seat 5: tapouttazz9 ($12.99 in chips)
Seat 6: Apt1a ($10 in chips)
@japhypoker: posts small blind $0.05
Schug: posts big blind $0.10
*** HOLE CARDS ***
Dealt to tapouttazz9 [4c 7c]
tclick: folds
dangerhard10: calls $0.10
tapouttazz9: folds
Apt1a: raises $0.15 to $0.25
@japhypoker: folds
Schug: folds
dangerhard10: calls $0.15
*** FLOP *** [6c 9c As]
dangerhard10: checks
Apt1a: bets $0.45
dangerhard10: calls $0.45
*** TURN *** [6c 9c As] [Kd]
dangerhard10: checks
Apt1a: checks
*** RIVER *** [6c 9c As Kd] [5h]
dangerhard10: bets $0.73
Apt1a: calls $0.73
*** SHOW DOWN ***
dangerhard10: shows [8d Ad] (a pair of Aces)
Apt1a: shows [Ah Qd] (a pair of Aces - King+Queen kicker)
Apt1a collected $2.86 from pot
*** SUMMARY ***
Total pot $3.01 | Rake $0.15
Board [6c 9c As Kd 5h]
Seat 1: @japhypoker (small blind) folded before Flop
Seat 2: Schug (big blind) folded before Flop
Seat 3: tclick folded before Flop (didn't bet)
Seat 4: dangerhard10 showed [8d Ad] and lost with a pair of Aces
Seat 5: tapouttazz9 folded before Flop (didn't bet)
Seat 6: Apt1a (button) showed [Ah Qd] and won ($2.86) with a pair of Aces


PokerStars Hand #157030863759:  Hold'em No Limit ($0.05/$0.10 USD) - 2016/08/16 17:27:56 ET
Table 'Apus' 6-max Seat #1 is the button
Seat 1: @japhypoker ($14.91 in chips)
Seat 2: Schug ($9.38 in chips)
Seat 3: tclick ($7.65 in chips)
Seat 4: dangerhard10 ($9.05 in chips)
Seat 5: tapouttazz9 ($12.99 in chips)
Seat 6: Apt1a ($11.43 in chips)
Schug: posts small blind $0.05
tclick: posts big blind $0.10
*** HOLE CARDS ***
Dealt to tapouttazz9 [8h 6c]
dangerhard10: folds
tapouttazz9: folds
Apt1a: raises $0.15 to $0.25
@japhypoker: folds
Schug: calls $0.20
tclick: folds
*** FLOP *** [2s Jc Qh]
Schug: checks
Apt1a: checks
*** TURN *** [2s Jc Qh] [Kc]
Schug: checks
Apt1a: bets $0.35
Schug: folds
Uncalled bet ($0.35) returned to Apt1a
Apt1a collected $0.57 from pot
Apt1a: doesn't show hand
*** SUMMARY ***
Total pot $0.60 | Rake $0.03
Board [2s Jc Qh Kc]
Seat 1: @japhypoker (button) folded before Flop (didn't bet)
Seat 2: Schug (small blind) folded on the Turn
Seat 3: tclick (big blind) folded before Flop
Seat 4: dangerhard10 folded before Flop (didn't bet)
Seat 5: tapouttazz9 folded before Flop (didn't bet)
Seat 6: Apt1a collected ($0.57)


PokerStars Hand #157030863990:  Hold'em No Limit ($0.05/$0.10 USD) - 2016/08/16 17:28:49 ET
Table 'Apus' 6-max Seat #2 is the button
Seat 1: @japhypoker ($14.91 in chips)
Seat 2: Schug ($9.13 in chips)
Seat 3: tclick ($7.55 in chips)
Seat 4: dangerhard10 ($9.05 in chips)
Seat 5: tapouttazz9 ($12.99 in chips)
Seat 6: Apt1a ($11.75 in chips)
tclick: posts small blind $0.05
dangerhard10: posts big blind $0.10
*** HOLE CARDS ***
Dealt to tapouttazz9 [Js 7c]
tapouttazz9: folds
Apt1a: folds
@japhypoker: raises $0.20 to $0.30
Schug: folds
tclick: folds
dangerhard10: folds
Uncalled bet ($0.20) returned to @japhypoker
@japhypoker collected $0.25 from pot
@japhypoker: doesn't show hand
*** SUMMARY ***
Total pot $0.25 | Rake $0
Seat 1: @japhypoker collected ($0.25)
Seat 2: Schug (button) folded before Flop (didn't bet)
Seat 3: tclick (small blind) folded before Flop
Seat 4: dangerhard10 (big blind) folded before Flop
Seat 5: tapouttazz9 folded before Flop (didn't bet)
Seat 6: Apt1a folded before Flop (didn't bet)


PokerStars Hand #157030864046:  Hold'em No Limit ($0.05/$0.10 USD) - 2016/08/16 17:29:04 ET
Table 'Apus' 6-max Seat #3 is the button
Seat 1: @japhypoker ($15.06 in chips)
Seat 2: Schug ($9.13 in chips)
Seat 3: tclick ($7.50 in chips)
Seat 4: dangerhard10 ($8.95 in chips)
Seat 5: tapouttazz9 ($12.99 in chips)
Seat 6: Apt1a ($11.75 in chips)
dangerhard10: posts small blind $0.05
tapouttazz9: posts big blind $0.10
*** HOLE CARDS ***
Dealt to tapouttazz9 [7c 7h]
Apt1a: raises $0.15 to $0.25
@japhypoker: folds
Schug: calls $0.25
tclick: folds
dangerhard10: calls $0.20
tapouttazz9: calls $0.15
*** FLOP *** [6c Ks 3d]
dangerhard10: checks
tapouttazz9: bets $0.20
Apt1a: folds
Schug: calls $0.20
dangerhard10: folds
*** TURN *** [6c Ks 3d] [8h]
tapouttazz9: checks
Schug: checks
*** RIVER *** [6c Ks 3d 8h] [Kh]
tapouttazz9: bets $0.20
Schug: folds
Uncalled bet ($0.20) returned to tapouttazz9
tapouttazz9 collected $1.33 from pot
*** SUMMARY ***
Total pot $1.40 | Rake $0.07
Board [6c Ks 3d 8h Kh]
Seat 1: @japhypoker folded before Flop (didn't bet)
Seat 2: Schug folded on the River
Seat 3: tclick (button) folded before Flop (didn't bet)
Seat 4: dangerhard10 (small blind) folded on the Flop
Seat 5: tapouttazz9 (big blind) collected ($1.33)
Seat 6: Apt1a folded on the Flop


PokerStars Hand #157030864230:  Hold'em No Limit ($0.05/$0.10 USD) - 2016/08/16 17:29:49 ET
Table 'Apus' 6-max Seat #4 is the button
Seat 1: @japhypoker ($15.06 in chips)
Seat 2: Schug ($8.68 in chips)
Seat 3: tclick ($7.50 in chips)
Seat 4: dangerhard10 ($8.70 in chips)
Seat 5: tapouttazz9 ($13.87 in chips)
Seat 6: Apt1a ($11.50 in chips)
tapouttazz9: posts small blind $0.05
Apt1a: posts big blind $0.10
*** HOLE CARDS ***
Dealt to tapouttazz9 [Tc 8h]
@japhypoker: folds
Schug: calls $0.10
tclick: folds
dangerhard10: raises $0.10 to $0.20
tapouttazz9: folds
Apt1a: calls $0.10
Schug: calls $0.10
*** FLOP *** [4d 4s 6c]
Apt1a: checks
Schug: checks
dangerhard10: checks
*** TURN *** [4d 4s 6c] [9s]
Apt1a: bets $0.40
Schug: calls $0.40
dangerhard10: calls $0.40
*** RIVER *** [4d 4s 6c 9s] [Kh]
Apt1a: checks
Schug: checks
dangerhard10: bets $0.88
Apt1a: folds
Schug: calls $0.88
*** SHOW DOWN ***
dangerhard10: shows [Js Kd] (two pair, Kings and Fours)
Schug: mucks hand
dangerhard10 collected $3.43 from pot
*** SUMMARY ***
Total pot $3.61 | Rake $0.18
Board [4d 4s 6c 9s Kh]
Seat 1: @japhypoker folded before Flop (didn't bet)
Seat 2: Schug mucked [Ad 9c]
Seat 3: tclick folded before Flop (didn't bet)
Seat 4: dangerhard10 (button) showed [Js Kd] and won ($3.43) with two pair, Kings and Fours
Seat 5: tapouttazz9 (small blind) folded before Flop
Seat 6: Apt1a (big blind) folded on the River


PokerStars Hand #157030864484:  Hold'em No Limit ($0.05/$0.10 USD) - 2016/08/16 17:30:51 ET
Table 'Apus' 6-max Seat #5 is the button
Seat 1: @japhypoker ($15.06 in chips)
Seat 2: Schug ($7.20 in chips)
Seat 3: tclick ($7.50 in chips)
Seat 4: dangerhard10 ($10.65 in chips)
Seat 5: tapouttazz9 ($13.82 in chips)
Seat 6: Apt1a ($10.90 in chips)
Apt1a: posts small blind $0.05
@japhypoker: posts big blind $0.10
*** HOLE CARDS ***
Dealt to tapouttazz9 [8c 6d]
Schug: calls $0.10
tclick: folds
dangerhard10: folds
tapouttazz9: folds
Apt1a: calls $0.05
@japhypoker: checks
*** FLOP *** [9s Ac 6c]
Apt1a: checks
@japhypoker: checks
Schug: checks
*** TURN *** [9s Ac 6c] [8s]
Apt1a: bets $0.15
@japhypoker: folds
Schug: calls $0.15
*** RIVER *** [9s Ac 6c 8s] [Ad]
Apt1a: bets $0.45
Schug: folds
Uncalled bet ($0.45) returned to Apt1a
Apt1a collected $0.57 from pot
Apt1a: doesn't show hand
*** SUMMARY ***
Total pot $0.60 | Rake $0.03
Board [9s Ac 6c 8s Ad]
Seat 1: @japhypoker (big blind) folded on the Turn
Seat 2: Schug folded on the River
Seat 3: tclick folded before Flop (didn't bet)
Seat 4: dangerhard10 folded before Flop (didn't bet)
Seat 5: tapouttazz9 (button) folded before Flop (didn't bet)
Seat 6: Apt1a (small blind) collected ($0.57)


PokerStars Hand #157030864759:  Hold'em No Limit ($0.05/$0.10 USD) - 2016/08/16 17:31:55 ET
Table 'Apus' 6-max Seat #6 is the button
Seat 1: @japhypoker ($14.96 in chips)
Seat 2: Schug ($6.95 in chips)
Seat 3: tclick ($7.50 in chips)
Seat 4: dangerhard10 ($10.65 in chips)
Seat 5: tapouttazz9 ($13.82 in chips)
Seat 6: Apt1a ($11.22 in chips)
@japhypoker: posts small blind $0.05
Schug: posts big blind $0.10
*** HOLE CARDS ***
Dealt to tapouttazz9 [Jc As]
tclick: calls $0.10
dangerhard10: folds
tapouttazz9: raises $0.20 to $0.30
Apt1a: folds
@japhypoker: folds
Schug: folds
tclick: calls $0.20
*** FLOP *** [Kd 5d Th]
tclick: checks
tapouttazz9: checks
*** TURN *** [Kd 5d Th] [Tc]
tclick: checks
tapouttazz9: checks
*** RIVER *** [Kd 5d Th Tc] [8h]
tclick: bets $0.10
tapouttazz9: folds
Uncalled bet ($0.10) returned to tclick
tclick collected $0.71 from pot
*** SUMMARY ***
Total pot $0.75 | Rake $0.04
Board [Kd 5d Th Tc 8h]
Seat 1: @japhypoker (small blind) folded before Flop
Seat 2: Schug (big blind) folded before Flop
Seat 3: tclick collected ($0.71)
Seat 4: dangerhard10 folded before Flop (didn't bet)
Seat 5: tapouttazz9 folded on the River
Seat 6: Apt1a (button) folded before Flop (didn't bet)


PokerStars Hand #157030864936:  Hold'em No Limit ($0.05/$0.10 USD) - 2016/08/16 17:32:37 ET
Table 'Apus' 6-max Seat #1 is the button
Seat 1: @japhypoker ($14.91 in chips)
Seat 2: Schug ($6.85 in chips)
Seat 3: tclick ($7.91 in chips)
Seat 4: dangerhard10 ($10.65 in chips)
Seat 5: tapouttazz9 ($13.52 in chips)
Seat 6: Apt1a ($11.22 in chips)
Schug: posts small blind $0.05
tclick: posts big blind $0.10
*** HOLE CARDS ***
Dealt to tapouttazz9 [Qs Td]
dangerhard10: folds
tapouttazz9: folds
Apt1a: raises $0.15 to $0.25
@japhypoker: calls $0.25
Schug: folds
tclick: calls $0.15
*** FLOP *** [6c 2h 4d]
tclick: checks
Apt1a: bets $0.45
@japhypoker: folds
tclick: folds
Uncalled bet ($0.45) returned to Apt1a
Apt1a collected $0.76 from pot
Apt1a: doesn't show hand
*** SUMMARY ***
Total pot $0.80 | Rake $0.04
Board [6c 2h 4d]
Seat 1: @japhypoker (button) folded on the Flop
Seat 2: Schug (small blind) folded before Flop
Seat 3: tclick (big blind) folded on the Flop
Seat 4: dangerhard10 folded before Flop (didn't bet)
Seat 5: tapouttazz9 folded before Flop (didn't bet)
Seat 6: Apt1a collected ($0.76)


PokerStars Hand #157030865114:  Hold'em No Limit ($0.05/$0.10 USD) - 2016/08/16 17:33:19 ET
Table 'Apus' 6-max Seat #2 is the button
Seat 1: @japhypoker ($14.66 in chips)
Seat 2: Schug ($6.80 in chips)
Seat 3: tclick ($7.66 in chips)
Seat 4: dangerhard10 ($10.65 in chips)
Seat 5: tapouttazz9 ($13.52 in chips)
Seat 6: Apt1a ($11.73 in chips)
tclick: posts small blind $0.05
dangerhard10: posts big blind $0.10
*** HOLE CARDS ***
Dealt to tapouttazz9 [4c Qh]
tapouttazz9: folds
Apt1a: folds
@japhypoker: raises $0.20 to $0.30
Schug: folds
tclick: folds
dangerhard10: raises $0.20 to $0.50
@japhypoker: calls $0.20
*** FLOP *** [Qd 5s 2d]
dangerhard10: bets $0.50
@japhypoker: calls $0.50
*** TURN *** [Qd 5s 2d] [4d]
dangerhard10: bets $0.97
@japhypoker: calls $0.97
*** RIVER *** [Qd 5s 2d 4d] [2c]
dangerhard10: bets $8.68 and is all-in
@japhypoker: folds
Uncalled bet ($8.68) returned to dangerhard10
dangerhard10 collected $3.79 from pot
*** SUMMARY ***
Total pot $3.99 | Rake $0.20
Board [Qd 5s 2d 4d 2c]
Seat 1: @japhypoker folded on the River
Seat 2: Schug (button) folded before Flop (didn't bet)
Seat 3: tclick (small blind) folded before Flop
Seat 4: dangerhard10 (big blind) collected ($3.79)
Seat 5: tapouttazz9 folded before Flop (didn't bet)
Seat 6: Apt1a folded before Flop (didn't bet)


PokerStars Hand #157030865348:  Hold'em No Limit ($0.05/$0.10 USD) - 2016/08/16 17:34:13 ET
Table 'Apus' 6-max Seat #3 is the button
Seat 1: @japhypoker ($12.69 in chips)
Seat 2: Schug ($6.80 in chips)
Seat 3: tclick ($7.61 in chips)
Seat 4: dangerhard10 ($12.47 in chips)
Seat 5: tapouttazz9 ($13.52 in chips)
Seat 6: Apt1a ($11.73 in chips)
dangerhard10: posts small blind $0.05
tapouttazz9: posts big blind $0.10
*** HOLE CARDS ***
Dealt to tapouttazz9 [2c Jh]
Apt1a: raises $0.15 to $0.25
@japhypoker: folds
Schug: folds
tclick: folds
dangerhard10: folds
tapouttazz9: folds
Uncalled bet ($0.15) returned to Apt1a
Apt1a collected $0.25 from pot
Apt1a: doesn't show hand
*** SUMMARY ***
Total pot $0.25 | Rake $0
Seat 1: @japhypoker folded before Flop (didn't bet)
Seat 2: Schug folded before Flop (didn't bet)
Seat 3: tclick (button) folded before Flop (didn't bet)
Seat 4: dangerhard10 (small blind) folded before Flop
Seat 5: tapouttazz9 (big blind) folded before Flop
Seat 6: Apt1a collected ($0.25)


PokerStars Hand #157030865428:  Hold'em No Limit ($0.05/$0.10 USD) - 2016/08/16 17:34:31 ET
Table 'Apus' 6-max Seat #4 is the button
Seat 1: @japhypoker ($12.69 in chips)
Seat 2: Schug ($6.80 in chips)
Seat 3: tclick ($7.61 in chips)
Seat 4: dangerhard10 ($12.42 in chips)
Seat 6: Apt1a ($11.88 in chips)
Apt1a: posts small blind $0.05
@japhypoker: posts big blind $0.10
*** HOLE CARDS ***
Schug: calls $0.10
tclick: folds
dangerhard10: folds
Apt1a: calls $0.05
@japhypoker: checks
*** FLOP *** [Ts Js 8s]
Apt1a: checks
@japhypoker: checks
Schug: checks
*** TURN *** [Ts Js 8s] [Kd]
Apt1a: bets $0.15
@japhypoker: folds
Schug: calls $0.15
*** RIVER *** [Ts Js 8s Kd] [6h]
Apt1a: checks
Schug: checks
*** SHOW DOWN ***
Apt1a: shows [Qc 5d] (high card King)
Schug: shows [Kc 3d] (a pair of Kings)
Schug collected $0.57 from pot
*** SUMMARY ***
Total pot $0.60 | Rake $0.03
Board [Ts Js 8s Kd 6h]
Seat 1: @japhypoker (big blind) folded on the Turn
Seat 2: Schug showed [Kc 3d] and won ($0.57) with a pair of Kings
Seat 3: tclick folded before Flop (didn't bet)
Seat 4: dangerhard10 (button) folded before Flop (didn't bet)
Seat 6: Apt1a (small blind) showed [Qc 5d] and lost with high card King


PokerStars Hand #157030865687:  Hold'em No Limit ($0.05/$0.10 USD) - 2016/08/16 17:35:23 ET
Table 'Apus' 6-max Seat #6 is the button
Seat 1: @japhypoker ($12.59 in chips)
Seat 2: Schug ($7.12 in chips)
Seat 3: tclick ($7.61 in chips)
Seat 4: dangerhard10 ($12.42 in chips)
Seat 6: Apt1a ($11.63 in chips)
@japhypoker: posts small blind $0.05
Schug: posts big blind $0.10
*** HOLE CARDS ***
tclick: folds
dangerhard10: folds
Apt1a: folds
@japhypoker: folds
Uncalled bet ($0.05) returned to Schug
Schug collected $0.10 from pot
Schug: doesn't show hand
*** SUMMARY ***
Total pot $0.10 | Rake $0
Seat 1: @japhypoker (small blind) folded before Flop
Seat 2: Schug (big blind) collected ($0.10)
Seat 3: tclick folded before Flop (didn't bet)
Seat 4: dangerhard10 folded before Flop (didn't bet)
Seat 6: Apt1a (button) folded before Flop (didn't bet)


PokerStars Hand #157030865730:  Hold'em No Limit ($0.05/$0.10 USD) - 2016/08/16 17:35:33 ET
Table 'Apus' 6-max Seat #1 is the button
Seat 1: @japhypoker ($12.54 in chips)
Seat 2: Schug ($7.17 in chips)
Seat 4: dangerhard10 ($12.42 in chips)
Seat 6: Apt1a ($11.63 in chips)
Schug: posts small blind $0.05
tclick: is sitting out
dangerhard10: posts big blind $0.10
*** HOLE CARDS ***
Apt1a: raises $0.15 to $0.25
tclick leaves the table
@japhypoker: folds
Schug: raises $0.15 to $0.40
dangerhard10: folds
RiverbendAA joins the table at seat #3
Apt1a: raises $0.80 to $1.20
Schug: calls $0.80
*** FLOP *** [Jh Ad Qd]
Schug: bets $2.38
Apt1a: folds
Uncalled bet ($2.38) returned to Schug
Schug collected $2.38 from pot
Schug: doesn't show hand
*** SUMMARY ***
Total pot $2.50 | Rake $0.12
Board [Jh Ad Qd]
Seat 1: @japhypoker (button) folded before Flop (didn't bet)
Seat 2: Schug (small blind) collected ($2.38)
Seat 4: dangerhard10 (big blind) folded before Flop
Seat 6: Apt1a folded on the Flop


PokerStars Hand #157030865929:  Hold'em No Limit ($0.05/$0.10 USD) - 2016/08/16 17:36:15 ET
Table 'Apus' 6-max Seat #2 is the button
Seat 1: @japhypoker ($12.54 in chips)
Seat 2: Schug ($8.35 in chips)
Seat 4: dangerhard10 ($12.32 in chips)
Seat 6: Apt1a ($10.43 in chips)
RiverbendAA will be allowed to play after the button
dangerhard10: posts small blind $0.05
Apt1a: posts big blind $0.10
*** HOLE CARDS ***
@japhypoker: folds
Schug: calls $0.10
dangerhard10: folds
Apt1a: checks
*** FLOP *** [8d 6d 2c]
Apt1a: bets $0.20
Schug: calls $0.20
*** TURN *** [8d 6d 2c] [Jc]
Apt1a: bets $0.60
Schug: folds
Uncalled bet ($0.60) returned to Apt1a
Apt1a collected $0.62 from pot
*** SUMMARY ***
Total pot $0.65 | Rake $0.03
Board [8d 6d 2c Jc]
Seat 1: @japhypoker folded before Flop (didn't bet)
Seat 2: Schug (button) folded on the Turn
Seat 4: dangerhard10 (small blind) folded before Flop
Seat 6: Apt1a (big blind) collected ($0.62)


PokerStars Hand #157030866636:  Hold'em No Limit ($0.05/$0.10 USD) - 2016/08/16 17:38:36 ET
Table 'Apus' 6-max Seat #3 is the button
Seat 1: @japhypoker ($12.19 in chips)
Seat 3: RiverbendAA ($10 in chips)
Seat 4: dangerhard10 ($12.86 in chips)
Seat 5: tapouttazz9 ($13.42 in chips)
Seat 6: Apt1a ($11.17 in chips)
dangerhard10: posts small blind $0.05
tapouttazz9: posts big blind $0.10
*** HOLE CARDS ***
Dealt to tapouttazz9 [Qh 9d]
Apt1a: folds
@japhypoker: folds
RiverbendAA: folds
dangerhard10: folds
Uncalled bet ($0.05) returned to tapouttazz9
tapouttazz9 collected $0.10 from pot
*** SUMMARY ***
Total pot $0.10 | Rake $0
Seat 1: @japhypoker folded before Flop (didn't bet)
Seat 3: RiverbendAA (button) folded before Flop (didn't bet)
Seat 4: dangerhard10 (small blind) folded before Flop
Seat 5: tapouttazz9 (big blind) collected ($0.10)
Seat 6: Apt1a folded before Flop (didn't bet)


PokerStars Hand #157030866728:  Hold'em No Limit ($0.05/$0.10 USD) - 2016/08/16 17:38:52 ET
Table 'Apus' 6-max Seat #4 is the button
Seat 1: @japhypoker ($12.19 in chips)
Seat 3: RiverbendAA ($10 in chips)
Seat 4: dangerhard10 ($12.81 in chips)
Seat 5: tapouttazz9 ($13.47 in chips)
Seat 6: Apt1a ($11.17 in chips)
tapouttazz9: posts small blind $0.05
Apt1a: posts big blind $0.10
*** HOLE CARDS ***
Dealt to tapouttazz9 [7s 4d]
@japhypoker: folds
RiverbendAA: folds
dangerhard10: folds
tapouttazz9: folds
Uncalled bet ($0.05) returned to Apt1a
Apt1a collected $0.10 from pot
Apt1a: doesn't show hand
*** SUMMARY ***
Total pot $0.10 | Rake $0
Seat 1: @japhypoker folded before Flop (didn't bet)
Seat 3: RiverbendAA folded before Flop (didn't bet)
Seat 4: dangerhard10 (button) folded before Flop (didn't bet)
Seat 5: tapouttazz9 (small blind) folded before Flop
Seat 6: Apt1a (big blind) collected ($0.10)


PokerStars Hand #157030866786:  Hold'em No Limit ($0.05/$0.10 USD) - 2016/08/16 17:39:04 ET
Table 'Apus' 6-max Seat #5 is the button
Seat 1: @japhypoker ($12.19 in chips)
Seat 3: RiverbendAA ($10 in chips)
Seat 4: dangerhard10 ($12.81 in chips)
Seat 5: tapouttazz9 ($13.42 in chips)
Seat 6: Apt1a ($11.22 in chips)
Apt1a: posts small blind $0.05
@japhypoker: posts big blind $0.10
*** HOLE CARDS ***
Dealt to tapouttazz9 [Qh 5s]
RiverbendAA: folds
dangerhard10: calls $0.10
tapouttazz9: folds
tclick joins the table at seat #2
Apt1a: calls $0.05
@japhypoker: checks
*** FLOP *** [Ac 9h Kc]
Apt1a: checks
@japhypoker: checks
dangerhard10: checks
*** TURN *** [Ac 9h Kc] [2h]
Apt1a: bets $0.25
@japhypoker: folds
dangerhard10: folds
Uncalled bet ($0.25) returned to Apt1a
Apt1a collected $0.28 from pot
Apt1a: doesn't show hand
*** SUMMARY ***
Total pot $0.30 | Rake $0.02
Board [Ac 9h Kc 2h]
Seat 1: @japhypoker (big blind) folded on the Turn
Seat 3: RiverbendAA folded before Flop (didn't bet)
Seat 4: dangerhard10 folded on the Turn
Seat 5: tapouttazz9 (button) folded before Flop (didn't bet)
Seat 6: Apt1a (small blind) collected ($0.28)


PokerStars Hand #157030867041:  Hold'em No Limit ($0.05/$0.10 USD) - 2016/08/16 17:39:58 ET
Table 'Apus' 6-max Seat #6 is the button
Seat 1: @japhypoker ($12.09 in chips)
Seat 2: tclick ($8 in chips)
Seat 3: RiverbendAA ($10 in chips)
Seat 4: dangerhard10 ($12.71 in chips)
Seat 5: tapouttazz9 ($13.42 in chips)
Seat 6: Apt1a ($11.40 in chips)
@japhypoker: posts small blind $0.05
tclick: posts big blind $0.10
*** HOLE CARDS ***
Dealt to tapouttazz9 [6s As]
RiverbendAA: folds
dangerhard10: folds
tapouttazz9: raises $0.10 to $0.20
Apt1a: folds
@japhypoker: calls $0.15
tclick: folds
*** FLOP *** [2h 5h Kh]
@japhypoker: checks
tapouttazz9: checks
*** TURN *** [2h 5h Kh] [Jh]
@japhypoker: bets $0.29
tapouttazz9: calls $0.29
*** RIVER *** [2h 5h Kh Jh] [Qh]
@japhypoker: bets $0.74
tapouttazz9: folds
Uncalled bet ($0.74) returned to @japhypoker
@japhypoker collected $1.03 from pot
@japhypoker: doesn't show hand
*** SUMMARY ***
Total pot $1.08 | Rake $0.05
Board [2h 5h Kh Jh Qh]
Seat 1: @japhypoker (small blind) collected ($1.03)
Seat 2: tclick (big blind) folded before Flop
Seat 3: RiverbendAA folded before Flop (didn't bet)
Seat 4: dangerhard10 folded before Flop (didn't bet)
Seat 5: tapouttazz9 folded on the River
Seat 6: Apt1a (button) folded before Flop (didn't bet)


PokerStars Hand #157030867307:  Hold'em No Limit ($0.05/$0.10 USD) - 2016/08/16 17:40:53 ET
Table 'Apus' 6-max Seat #1 is the button
Seat 1: @japhypoker ($12.63 in chips)
Seat 2: tclick ($7.90 in chips)
Seat 3: RiverbendAA ($10 in chips)
Seat 4: dangerhard10 ($12.71 in chips)
Seat 5: tapouttazz9 ($12.93 in chips)
Seat 6: Apt1a ($11.40 in chips)
tclick: posts small blind $0.05
RiverbendAA: posts big blind $0.10
*** HOLE CARDS ***
Dealt to tapouttazz9 [Qc 7d]
dangerhard10: folds
tapouttazz9: folds
Apt1a: folds
@japhypoker: folds
tclick: calls $0.05
RiverbendAA: checks
*** FLOP *** [5h Js 2s]
tclick: bets $0.19
RiverbendAA: calls $0.19
*** TURN *** [5h Js 2s] [Ad]
tclick: bets $0.60
RiverbendAA: folds
Uncalled bet ($0.60) returned to tclick
tclick collected $0.55 from pot
*** SUMMARY ***
Total pot $0.58 | Rake $0.03
Board [5h Js 2s Ad]
Seat 1: @japhypoker (button) folded before Flop (didn't bet)
Seat 2: tclick (small blind) collected ($0.55)
Seat 3: RiverbendAA (big blind) folded on the Turn
Seat 4: dangerhard10 folded before Flop (didn't bet)
Seat 5: tapouttazz9 folded before Flop (didn't bet)
Seat 6: Apt1a folded before Flop (didn't bet)


PokerStars Hand #157030867496:  Hold'em No Limit ($0.05/$0.10 USD) - 2016/08/16 17:41:32 ET
Table 'Apus' 6-max Seat #2 is the button
Seat 1: @japhypoker ($12.63 in chips)
Seat 2: tclick ($8.16 in chips)
Seat 3: RiverbendAA ($10 in chips)
Seat 4: dangerhard10 ($12.71 in chips)
Seat 5: tapouttazz9 ($12.93 in chips)
Seat 6: Apt1a ($11.40 in chips)
RiverbendAA: posts small blind $0.05
dangerhard10: posts big blind $0.10
*** HOLE CARDS ***
Dealt to tapouttazz9 [8d 3d]
tapouttazz9: folds
Apt1a: folds
@japhypoker: raises $0.15 to $0.25
tclick: folds
RiverbendAA: folds
dangerhard10: calls $0.15
*** FLOP *** [8s 2s 5h]
dangerhard10: checks
@japhypoker: bets $0.25
dangerhard10: folds
Uncalled bet ($0.25) returned to @japhypoker
@japhypoker collected $0.52 from pot
@japhypoker: doesn't show hand
*** SUMMARY ***
Total pot $0.55 | Rake $0.03
Board [8s 2s 5h]
Seat 1: @japhypoker collected ($0.52)
Seat 2: tclick (button) folded before Flop (didn't bet)
Seat 3: RiverbendAA (small blind) folded before Flop
Seat 4: dangerhard10 (big blind) folded on the Flop
Seat 5: tapouttazz9 folded before Flop (didn't bet)
Seat 6: Apt1a folded before Flop (didn't bet)


PokerStars Hand #157030867685:  Hold'em No Limit ($0.05/$0.10 USD) - 2016/08/16 17:42:13 ET
Table 'Apus' 6-max Seat #3 is the button
Seat 1: @japhypoker ($12.90 in chips)
Seat 2: tclick ($8.16 in chips)
Seat 3: RiverbendAA ($10 in chips)
Seat 4: dangerhard10 ($12.46 in chips)
Seat 5: tapouttazz9 ($12.93 in chips)
Seat 6: Apt1a ($11.40 in chips)
dangerhard10: posts small blind $0.05
tapouttazz9: posts big blind $0.10
*** HOLE CARDS ***
Dealt to tapouttazz9 [Qc Th]
Apt1a: folds
@japhypoker: folds
tclick: folds
RiverbendAA: folds
dangerhard10: calls $0.05
tapouttazz9: checks
*** FLOP *** [9h Kh 5c]
dangerhard10: checks
tapouttazz9: bets $0.19
dangerhard10: raises $0.19 to $0.38
tapouttazz9: calls $0.19
*** TURN *** [9h Kh 5c] [9s]
dangerhard10: bets $0.45
tapouttazz9: raises $0.75 to $1.20
dangerhard10: calls $0.75
*** RIVER *** [9h Kh 5c 9s] [4c]
dangerhard10: checks
tapouttazz9: bets $1.59
dangerhard10: calls $1.59
*** SHOW DOWN ***
tapouttazz9: shows [Qc Th] (a pair of Nines)
dangerhard10: shows [Jc Kc] (two pair, Kings and Nines)
dangerhard10 collected $6.21 from pot
*** SUMMARY ***
Total pot $6.54 | Rake $0.33
Board [9h Kh 5c 9s 4c]
Seat 1: @japhypoker folded before Flop (didn't bet)
Seat 2: tclick folded before Flop (didn't bet)
Seat 3: RiverbendAA (button) folded before Flop (didn't bet)
Seat 4: dangerhard10 (small blind) showed [Jc Kc] and won ($6.21) with two pair, Kings and Nines
Seat 5: tapouttazz9 (big blind) showed [Qc Th] and lost with a pair of Nines
Seat 6: Apt1a folded before Flop (didn't bet)


PokerStars Hand #157030867874:  Hold'em No Limit ($0.05/$0.10 USD) - 2016/08/16 17:42:55 ET
Table 'Apus' 6-max Seat #4 is the button
Seat 1: @japhypoker ($12.90 in chips)
Seat 2: tclick ($8.16 in chips)
Seat 3: RiverbendAA ($10 in chips)
Seat 4: dangerhard10 ($15.40 in chips)
Seat 5: tapouttazz9 ($9.66 in chips)
Seat 6: Apt1a ($11.40 in chips)
tapouttazz9: posts small blind $0.05
Apt1a: posts big blind $0.10
*** HOLE CARDS ***
Dealt to tapouttazz9 [As 4h]
@japhypoker: folds
tclick: calls $0.10
RiverbendAA: raises $0.40 to $0.50
dangerhard10: folds
tapouttazz9: folds
Apt1a: folds
tclick: folds
Uncalled bet ($0.40) returned to RiverbendAA
RiverbendAA collected $0.35 from pot
RiverbendAA: doesn't show hand
*** SUMMARY ***
Total pot $0.35 | Rake $0
Seat 1: @japhypoker folded before Flop (didn't bet)
Seat 2: tclick folded before Flop
Seat 3: RiverbendAA collected ($0.35)
Seat 4: dangerhard10 (button) folded before Flop (didn't bet)
Seat 5: tapouttazz9 (small blind) folded before Flop
Seat 6: Apt1a (big blind) folded before Flop


PokerStars Hand #157030867996:  Hold'em No Limit ($0.05/$0.10 USD) - 2016/08/16 17:43:21 ET
Table 'Apus' 6-max Seat #5 is the button
Seat 1: @japhypoker ($12.90 in chips)
Seat 2: tclick ($8.06 in chips)
Seat 3: RiverbendAA ($10.25 in chips)
Seat 4: dangerhard10 ($15.40 in chips)
Seat 5: tapouttazz9 ($10 in chips)
Seat 6: Apt1a ($11.30 in chips)
Apt1a: posts small blind $0.05
@japhypoker: posts big blind $0.10
*** HOLE CARDS ***
Dealt to tapouttazz9 [8c Kd]
tclick: calls $0.10
RiverbendAA: raises $0.40 to $0.50
dangerhard10: folds
tapouttazz9: folds
Apt1a: folds
@japhypoker: folds
tclick: folds
Uncalled bet ($0.40) returned to RiverbendAA
RiverbendAA collected $0.35 from pot
RiverbendAA: doesn't show hand
*** SUMMARY ***
Total pot $0.35 | Rake $0
Seat 1: @japhypoker (big blind) folded before Flop
Seat 2: tclick folded before Flop
Seat 3: RiverbendAA collected ($0.35)
Seat 4: dangerhard10 folded before Flop (didn't bet)
Seat 5: tapouttazz9 (button) folded before Flop (didn't bet)
Seat 6: Apt1a (small blind) folded before Flop


PokerStars Hand #157030868082:  Hold'em No Limit ($0.05/$0.10 USD) - 2016/08/16 17:43:44 ET
Table 'Apus' 6-max Seat #6 is the button
Seat 1: @japhypoker ($12.80 in chips)
Seat 2: tclick ($7.96 in chips)
Seat 3: RiverbendAA ($10.50 in chips)
Seat 4: dangerhard10 ($15.40 in chips)
Seat 5: tapouttazz9 ($10 in chips)
Seat 6: Apt1a ($11.25 in chips)
@japhypoker: posts small blind $0.05
tclick: posts big blind $0.10
*** HOLE CARDS ***
Dealt to tapouttazz9 [5d Qd]
RiverbendAA: folds
dangerhard10: folds
tapouttazz9: folds
Apt1a: calls $0.10
@japhypoker: folds
tclick: checks
*** FLOP *** [9c Tc Qs]
tclick: checks
Apt1a: bets $0.15
tclick: calls $0.15
*** TURN *** [9c Tc Qs] [7s]
tclick: checks
Apt1a: checks
*** RIVER *** [9c Tc Qs 7s] [Td]
tclick: checks
Apt1a: bets $0.50
tclick: folds
Uncalled bet ($0.50) returned to Apt1a
Apt1a collected $0.52 from pot
Apt1a: doesn't show hand
*** SUMMARY ***
Total pot $0.55 | Rake $0.03
Board [9c Tc Qs 7s Td]
Seat 1: @japhypoker (small blind) folded before Flop
Seat 2: tclick (big blind) folded on the River
Seat 3: RiverbendAA folded before Flop (didn't bet)
Seat 4: dangerhard10 folded before Flop (didn't bet)
Seat 5: tapouttazz9 folded before Flop (didn't bet)
Seat 6: Apt1a (button) collected ($0.52)


PokerStars Hand #157030868313:  Hold'em No Limit ($0.05/$0.10 USD) - 2016/08/16 17:44:35 ET
Table 'Apus' 6-max Seat #1 is the button
Seat 1: @japhypoker ($12.75 in chips)
Seat 2: tclick ($7.71 in chips)
Seat 3: RiverbendAA ($10.50 in chips)
Seat 4: dangerhard10 ($15.40 in chips)
Seat 5: tapouttazz9 ($10 in chips)
Seat 6: Apt1a ($11.52 in chips)
tclick: posts small blind $0.05
RiverbendAA: posts big blind $0.10
*** HOLE CARDS ***
Dealt to tapouttazz9 [7c 4s]
dangerhard10: calls $0.10
tapouttazz9: folds
Apt1a: folds
@japhypoker: raises $0.40 to $0.50
tclick: folds
RiverbendAA: folds
dangerhard10: calls $0.40
*** FLOP *** [2h 4h Jd]
dangerhard10: checks
@japhypoker: bets $0.50
dangerhard10: calls $0.50
*** TURN *** [2h 4h Jd] [5h]
dangerhard10: checks
@japhypoker: bets $0.90
dangerhard10: calls $0.90
*** RIVER *** [2h 4h Jd 5h] [Qc]
dangerhard10: checks
@japhypoker: checks
*** SHOW DOWN ***
dangerhard10: shows [Tc Th] (a pair of Tens)
@japhypoker: shows [Qd Ad] (a pair of Queens)
@japhypoker collected $3.75 from pot
*** SUMMARY ***
Total pot $3.95 | Rake $0.20
Board [2h 4h Jd 5h Qc]
Seat 1: @japhypoker (button) showed [Qd Ad] and won ($3.75) with a pair of Queens
Seat 2: tclick (small blind) folded before Flop
Seat 3: RiverbendAA (big blind) folded before Flop
Seat 4: dangerhard10 showed [Tc Th] and lost with a pair of Tens
Seat 5: tapouttazz9 folded before Flop (didn't bet)
Seat 6: Apt1a folded before Flop (didn't bet)


PokerStars Hand #157030868592:  Hold'em No Limit ($0.05/$0.10 USD) - 2016/08/16 17:45:41 ET
Table 'Apus' 6-max Seat #2 is the button
Seat 1: @japhypoker ($14.60 in chips)
Seat 2: tclick ($7.66 in chips)
Seat 3: RiverbendAA ($10.40 in chips)
Seat 4: dangerhard10 ($13.50 in chips)
Seat 5: tapouttazz9 ($10 in chips)
Seat 6: Apt1a ($11.52 in chips)
RiverbendAA: posts small blind $0.05
dangerhard10: posts big blind $0.10
*** HOLE CARDS ***
Dealt to tapouttazz9 [7h 6d]
tapouttazz9: folds
Apt1a: folds
@japhypoker: folds
tclick: folds
RiverbendAA: raises $0.20 to $0.30
dangerhard10: folds
Uncalled bet ($0.20) returned to RiverbendAA
RiverbendAA collected $0.20 from pot
RiverbendAA: doesn't show hand
*** SUMMARY ***
Total pot $0.20 | Rake $0
Seat 1: @japhypoker folded before Flop (didn't bet)
Seat 2: tclick (button) folded before Flop (didn't bet)
Seat 3: RiverbendAA (small blind) collected ($0.20)
Seat 4: dangerhard10 (big blind) folded before Flop
Seat 5: tapouttazz9 folded before Flop (didn't bet)
Seat 6: Apt1a folded before Flop (didn't bet)


PokerStars Hand #157030868650:  Hold'em No Limit ($0.05/$0.10 USD) - 2016/08/16 17:45:56 ET
Table 'Apus' 6-max Seat #3 is the button
Seat 1: @japhypoker ($14.60 in chips)
Seat 2: tclick ($7.66 in chips)
Seat 3: RiverbendAA ($10.50 in chips)
Seat 4: dangerhard10 ($13.40 in chips)
Seat 5: tapouttazz9 ($10 in chips)
Seat 6: Apt1a ($11.52 in chips)
dangerhard10: posts small blind $0.05
tapouttazz9: posts big blind $0.10
*** HOLE CARDS ***
Dealt to tapouttazz9 [Qh Js]
Apt1a: folds
@japhypoker: folds
tclick: folds
RiverbendAA: folds
dangerhard10: folds
Uncalled bet ($0.05) returned to tapouttazz9
tapouttazz9 collected $0.10 from pot
*** SUMMARY ***
Total pot $0.10 | Rake $0
Seat 1: @japhypoker folded before Flop (didn't bet)
Seat 2: tclick folded before Flop (didn't bet)
Seat 3: RiverbendAA (button) folded before Flop (didn't bet)
Seat 4: dangerhard10 (small blind) folded before Flop
Seat 5: tapouttazz9 (big blind) collected ($0.10)
Seat 6: Apt1a folded before Flop (didn't bet)


PokerStars Hand #157030868718:  Hold'em No Limit ($0.05/$0.10 USD) - 2016/08/16 17:46:13 ET
Table 'Apus' 6-max Seat #4 is the button
Seat 1: @japhypoker ($14.60 in chips)
Seat 2: tclick ($7.66 in chips)
Seat 3: RiverbendAA ($10.50 in chips)
Seat 4: dangerhard10 ($13.35 in chips)
Seat 5: tapouttazz9 ($10.05 in chips)
Seat 6: Apt1a ($11.52 in chips)
tapouttazz9: posts small blind $0.05
Apt1a: posts big blind $0.10
*** HOLE CARDS ***
Dealt to tapouttazz9 [8h Jc]
@japhypoker: folds
tclick: folds
RiverbendAA: folds
dangerhard10: calls $0.10
tapouttazz9: folds
Apt1a: raises $0.15 to $0.25
dangerhard10: calls $0.15
*** FLOP *** [Kh 5d Kc]
Apt1a: bets $0.35
dangerhard10: folds
Uncalled bet ($0.35) returned to Apt1a
Apt1a collected $0.52 from pot
Apt1a: doesn't show hand
*** SUMMARY ***
Total pot $0.55 | Rake $0.03
Board [Kh 5d Kc]
Seat 1: @japhypoker folded before Flop (didn't bet)
Seat 2: tclick folded before Flop (didn't bet)
Seat 3: RiverbendAA folded before Flop (didn't bet)
Seat 4: dangerhard10 (button) folded on the Flop
Seat 5: tapouttazz9 (small blind) folded before Flop
Seat 6: Apt1a (big blind) collected ($0.52)


PokerStars Hand #157030868880:  Hold'em No Limit ($0.05/$0.10 USD) - 2016/08/16 17:46:53 ET
Table 'Apus' 6-max Seat #5 is the button
Seat 1: @japhypoker ($14.60 in chips)
Seat 2: tclick ($7.66 in chips)
Seat 3: RiverbendAA ($10.50 in chips)
Seat 4: dangerhard10 ($13.10 in chips)
Seat 5: tapouttazz9 ($10 in chips)
Seat 6: Apt1a ($11.79 in chips)
Apt1a: posts small blind $0.05
@japhypoker: posts big blind $0.10
*** HOLE CARDS ***
Dealt to tapouttazz9 [Jd 8c]
tclick: folds
RiverbendAA: folds
dangerhard10: folds
tapouttazz9: raises $0.20 to $0.30
Apt1a: folds
@japhypoker: folds
Uncalled bet ($0.20) returned to tapouttazz9
tapouttazz9 collected $0.25 from pot
*** SUMMARY ***
Total pot $0.25 | Rake $0
Seat 1: @japhypoker (big blind) folded before Flop
Seat 2: tclick folded before Flop (didn't bet)
Seat 3: RiverbendAA folded before Flop (didn't bet)
Seat 4: dangerhard10 folded before Flop (didn't bet)
Seat 5: tapouttazz9 (button) collected ($0.25)
Seat 6: Apt1a (small blind) folded before Flop


PokerStars Hand #157030868967:  Hold'em No Limit ($0.05/$0.10 USD) - 2016/08/16 17:47:08 ET
Table 'Apus' 6-max Seat #6 is the button
Seat 1: @japhypoker ($14.50 in chips)
Seat 3: RiverbendAA ($10.50 in chips)
Seat 4: dangerhard10 ($13.10 in chips)
Seat 5: tapouttazz9 ($10.15 in chips)
Seat 6: Apt1a ($11.74 in chips)
@japhypoker: posts small blind $0.05
tclick: is sitting out
RiverbendAA: posts big blind $0.10
*** HOLE CARDS ***
Dealt to tapouttazz9 [Ks Jc]
tclick leaves the table
dangerhard10: raises $0.20 to $0.30
tapouttazz9: folds
Apt1a: folds
@japhypoker: folds
RiverbendAA: folds
Uncalled bet ($0.20) returned to dangerhard10
dangerhard10 collected $0.25 from pot
*** SUMMARY ***
Total pot $0.25 | Rake $0
Seat 1: @japhypoker (small blind) folded before Flop
Seat 3: RiverbendAA (big blind) folded before Flop
Seat 4: dangerhard10 collected ($0.25)
Seat 5: tapouttazz9 folded before Flop (didn't bet)
Seat 6: Apt1a (button) folded before Flop (didn't bet)


PokerStars Hand #157030869090:  Hold'em No Limit ($0.05/$0.10 USD) - 2016/08/16 17:47:30 ET
Table 'Apus' 6-max Seat #1 is the button
Seat 1: @japhypoker ($14.45 in chips)
Seat 3: RiverbendAA ($10.40 in chips)
Seat 4: dangerhard10 ($13.25 in chips)
Seat 5: tapouttazz9 ($10.15 in chips)
Seat 6: Apt1a ($11.74 in chips)
RiverbendAA: posts small blind $0.05
dangerhard10: posts big blind $0.10
*** HOLE CARDS ***
Dealt to tapouttazz9 [9s Jc]
tapouttazz9: folds
Apt1a: raises $0.15 to $0.25
@japhypoker: folds
RiverbendAA: folds
dangerhard10: calls $0.15
*** FLOP *** [8c Td 4c]
dangerhard10: checks
Apt1a: checks
*** TURN *** [8c Td 4c] [3h]
dangerhard10: bets $0.10
Apt1a: calls $0.10
*** RIVER *** [8c Td 4c 3h] [4s]
dangerhard10: bets $0.35
Apt1a: folds
Uncalled bet ($0.35) returned to dangerhard10
dangerhard10 collected $0.71 from pot
*** SUMMARY ***
Total pot $0.75 | Rake $0.04
Board [8c Td 4c 3h 4s]
Seat 1: @japhypoker (button) folded before Flop (didn't bet)
Seat 3: RiverbendAA (small blind) folded before Flop
Seat 4: dangerhard10 (big blind) collected ($0.71)
Seat 5: tapouttazz9 folded before Flop (didn't bet)
Seat 6: Apt1a folded on the River


PokerStars Hand #157030869286:  Hold'em No Limit ($0.05/$0.10 USD) - 2016/08/16 17:48:12 ET
Table 'Apus' 6-max Seat #3 is the button
Seat 1: @japhypoker ($14.45 in chips)
Seat 3: RiverbendAA ($10.35 in chips)
Seat 4: dangerhard10 ($13.61 in chips)
Seat 5: tapouttazz9 ($10.15 in chips)
Seat 6: Apt1a ($11.39 in chips)
dangerhard10: posts small blind $0.05
tapouttazz9: posts big blind $0.10
*** HOLE CARDS ***
Dealt to tapouttazz9 [5s Ad]
Apt1a: folds
@japhypoker: raises $0.15 to $0.25
RiverbendAA: folds
dangerhard10: folds
tapouttazz9: folds
Uncalled bet ($0.15) returned to @japhypoker
@japhypoker collected $0.25 from pot
@japhypoker: doesn't show hand
*** SUMMARY ***
Total pot $0.25 | Rake $0
Seat 1: @japhypoker collected ($0.25)
Seat 3: RiverbendAA (button) folded before Flop (didn't bet)
Seat 4: dangerhard10 (small blind) folded before Flop
Seat 5: tapouttazz9 (big blind) folded before Flop
Seat 6: Apt1a folded before Flop (didn't bet)


PokerStars Hand #157030869333:  Hold'em No Limit ($0.05/$0.10 USD) - 2016/08/16 17:48:23 ET
Table 'Apus' 6-max Seat #4 is the button
Seat 1: @japhypoker ($14.60 in chips)
Seat 3: RiverbendAA ($10.35 in chips)
Seat 4: dangerhard10 ($13.56 in chips)
Seat 5: tapouttazz9 ($10.05 in chips)
Seat 6: Apt1a ($11.39 in chips)
tapouttazz9: posts small blind $0.05
Apt1a: posts big blind $0.10
*** HOLE CARDS ***
Dealt to tapouttazz9 [Qd 4h]
@japhypoker: folds
RiverbendAA: raises $0.20 to $0.30
dangerhard10: folds
tapouttazz9: folds
Apt1a: folds
Uncalled bet ($0.20) returned to RiverbendAA
RiverbendAA collected $0.25 from pot
RiverbendAA: doesn't show hand
*** SUMMARY ***
Total pot $0.25 | Rake $0
Seat 1: @japhypoker folded before Flop (didn't bet)
Seat 3: RiverbendAA collected ($0.25)
Seat 4: dangerhard10 (button) folded before Flop (didn't bet)
Seat 5: tapouttazz9 (small blind) folded before Flop
Seat 6: Apt1a (big blind) folded before Flop


PokerStars Hand #157030869382:  Hold'em No Limit ($0.05/$0.10 USD) - 2016/08/16 17:48:35 ET
Table 'Apus' 6-max Seat #5 is the button
Seat 1: @japhypoker ($14.60 in chips)
Seat 3: RiverbendAA ($10.50 in chips)
Seat 4: dangerhard10 ($13.56 in chips)
Seat 5: tapouttazz9 ($10 in chips)
Seat 6: Apt1a ($11.29 in chips)
Apt1a: posts small blind $0.05
@japhypoker: posts big blind $0.10
*** HOLE CARDS ***
Dealt to tapouttazz9 [4c Ac]
RiverbendAA: folds
dangerhard10: folds
tapouttazz9: raises $0.10 to $0.20
Apt1a: folds
@japhypoker: folds
Uncalled bet ($0.10) returned to tapouttazz9
tapouttazz9 collected $0.25 from pot
*** SUMMARY ***
Total pot $0.25 | Rake $0
Seat 1: @japhypoker (big blind) folded before Flop
Seat 3: RiverbendAA folded before Flop (didn't bet)
Seat 4: dangerhard10 folded before Flop (didn't bet)
Seat 5: tapouttazz9 (button) collected ($0.25)
Seat 6: Apt1a (small blind) folded before Flop


PokerStars Hand #157030869465:  Hold'em No Limit ($0.05/$0.10 USD) - 2016/08/16 17:48:54 ET
Table 'Apus' 6-max Seat #6 is the button
Seat 1: @japhypoker ($14.50 in chips)
Seat 3: RiverbendAA ($10.50 in chips)
Seat 4: dangerhard10 ($13.56 in chips)
Seat 5: tapouttazz9 ($10.15 in chips)
Seat 6: Apt1a ($11.24 in chips)
@japhypoker: posts small blind $0.05
RiverbendAA: posts big blind $0.10
*** HOLE CARDS ***
Dealt to tapouttazz9 [Ts 6s]
dangerhard10: folds
tapouttazz9: folds
Apt1a: folds
@japhypoker: raises $0.15 to $0.25
RiverbendAA: folds
Uncalled bet ($0.15) returned to @japhypoker
@japhypoker collected $0.20 from pot
@japhypoker: doesn't show hand
*** SUMMARY ***
Total pot $0.20 | Rake $0
Seat 1: @japhypoker (small blind) collected ($0.20)
Seat 3: RiverbendAA (big blind) folded before Flop
Seat 4: dangerhard10 folded before Flop (didn't bet)
Seat 5: tapouttazz9 folded before Flop (didn't bet)
Seat 6: Apt1a (button) folded before Flop (didn't bet)


PokerStars Hand #157030869528:  Hold'em No Limit ($0.05/$0.10 USD) - 2016/08/16 17:49:10 ET
Table 'Apus' 6-max Seat #1 is the button
Seat 1: @japhypoker ($14.60 in chips)
Seat 3: RiverbendAA ($10.40 in chips)
Seat 4: dangerhard10 ($13.56 in chips)
Seat 5: tapouttazz9 ($10.15 in chips)
Seat 6: Apt1a ($11.24 in chips)
RiverbendAA: posts small blind $0.05
dangerhard10: posts big blind $0.10
*** HOLE CARDS ***
Dealt to tapouttazz9 [5c 9h]
tapouttazz9: folds
Apt1a: folds
@japhypoker: raises $0.15 to $0.25
RiverbendAA: folds
dangerhard10: calls $0.15
*** FLOP *** [8d Jd Th]
dangerhard10: checks
@japhypoker: checks
*** TURN *** [8d Jd Th] [4h]
dangerhard10: checks
@japhypoker: bets $0.30
dangerhard10: folds
Uncalled bet ($0.30) returned to @japhypoker
@japhypoker collected $0.52 from pot
@japhypoker: doesn't show hand
*** SUMMARY ***
Total pot $0.55 | Rake $0.03
Board [8d Jd Th 4h]
Seat 1: @japhypoker (button) collected ($0.52)
Seat 3: RiverbendAA (small blind) folded before Flop
Seat 4: dangerhard10 (big blind) folded on the Turn
Seat 5: tapouttazz9 folded before Flop (didn't bet)
Seat 6: Apt1a folded before Flop (didn't bet)


PokerStars Hand #157030869680:  Hold'em No Limit ($0.05/$0.10 USD) - 2016/08/16 17:49:46 ET
Table 'Apus' 6-max Seat #3 is the button
Seat 1: @japhypoker ($14.87 in chips)
Seat 3: RiverbendAA ($10.35 in chips)
Seat 4: dangerhard10 ($13.31 in chips)
Seat 5: tapouttazz9 ($10.15 in chips)
Seat 6: Apt1a ($11.24 in chips)
dangerhard10: posts small blind $0.05
tapouttazz9: posts big blind $0.10
*** HOLE CARDS ***
Dealt to tapouttazz9 [5d Tc]
Apt1a: folds
@japhypoker: folds
RiverbendAA: folds
dangerhard10: folds
Uncalled bet ($0.05) returned to tapouttazz9
tapouttazz9 collected $0.10 from pot
*** SUMMARY ***
Total pot $0.10 | Rake $0
Seat 1: @japhypoker folded before Flop (didn't bet)
Seat 3: RiverbendAA (button) folded before Flop (didn't bet)
Seat 4: dangerhard10 (small blind) folded before Flop
Seat 5: tapouttazz9 (big blind) collected ($0.10)
Seat 6: Apt1a folded before Flop (didn't bet)


PokerStars Hand #157030869738:  Hold'em No Limit ($0.05/$0.10 USD) - 2016/08/16 17:50:02 ET
Table 'Apus' 6-max Seat #4 is the button
Seat 1: @japhypoker ($14.87 in chips)
Seat 3: RiverbendAA ($10.35 in chips)
Seat 4: dangerhard10 ($13.26 in chips)
Seat 5: tapouttazz9 ($10.20 in chips)
Seat 6: Apt1a ($11.24 in chips)
tapouttazz9: posts small blind $0.05
Apt1a: posts big blind $0.10
*** HOLE CARDS ***
Dealt to tapouttazz9 [Kh 5h]
@japhypoker: folds
RiverbendAA: folds
dangerhard10: calls $0.10
tapouttazz9: folds
Apt1a: raises $0.15 to $0.25
dangerhard10: calls $0.15
*** FLOP *** [7s 4s 5c]
Apt1a: checks
dangerhard10: checks
*** TURN *** [7s 4s 5c] [6s]
Apt1a: bets $0.30
dangerhard10: folds
Uncalled bet ($0.30) returned to Apt1a
Apt1a collected $0.52 from pot
Apt1a: doesn't show hand
*** SUMMARY ***
Total pot $0.55 | Rake $0.03
Board [7s 4s 5c 6s]
Seat 1: @japhypoker folded before Flop (didn't bet)
Seat 3: RiverbendAA folded before Flop (didn't bet)
Seat 4: dangerhard10 (button) folded on the Turn
Seat 5: tapouttazz9 (small blind) folded before Flop
Seat 6: Apt1a (big blind) collected ($0.52)


PokerStars Hand #157030869926:  Hold'em No Limit ($0.05/$0.10 USD) - 2016/08/16 17:50:46 ET
Table 'Apus' 6-max Seat #5 is the button
Seat 1: @japhypoker ($14.87 in chips)
Seat 3: RiverbendAA ($10.35 in chips)
Seat 4: dangerhard10 ($13.01 in chips)
Seat 5: tapouttazz9 ($10.15 in chips)
Seat 6: Apt1a ($11.51 in chips)
Apt1a: posts small blind $0.05
@japhypoker: posts big blind $0.10
*** HOLE CARDS ***
Dealt to tapouttazz9 [Kd 6d]
RiverbendAA: folds
Scooo13zzz joins the table at seat #2
dangerhard10: folds
tapouttazz9: raises $0.20 to $0.30
Apt1a: folds
@japhypoker: folds
Uncalled bet ($0.20) returned to tapouttazz9
tapouttazz9 collected $0.25 from pot
*** SUMMARY ***
Total pot $0.25 | Rake $0
Seat 1: @japhypoker (big blind) folded before Flop
Seat 3: RiverbendAA folded before Flop (didn't bet)
Seat 4: dangerhard10 folded before Flop (didn't bet)
Seat 5: tapouttazz9 (button) collected ($0.25)
Seat 6: Apt1a (small blind) folded before Flop


PokerStars Hand #157032882907:  Hold'em No Limit ($0.05/$0.10 USD) - 2016/08/16 17:51:05 ET
Table 'Apus' 6-max Seat #6 is the button
Seat 1: @japhypoker ($14.77 in chips)
Seat 2: Scooo13zzz ($10 in chips)
Seat 3: RiverbendAA ($10.35 in chips)
Seat 4: dangerhard10 ($13.01 in chips)
Seat 5: tapouttazz9 ($10.30 in chips)
Seat 6: Apt1a ($11.46 in chips)
@japhypoker: posts small blind $0.05
Scooo13zzz: posts big blind $0.10
*** HOLE CARDS ***
Dealt to tapouttazz9 [Kh Js]
RiverbendAA: raises $0.20 to $0.30
dangerhard10: calls $0.30
tapouttazz9: folds
Apt1a: folds
@japhypoker: folds
Scooo13zzz: folds
*** FLOP *** [3d 9s Qc]
RiverbendAA: bets $0.42
dangerhard10: folds
Uncalled bet ($0.42) returned to RiverbendAA
RiverbendAA collected $0.71 from pot
RiverbendAA: doesn't show hand
*** SUMMARY ***
Total pot $0.75 | Rake $0.04
Board [3d 9s Qc]
Seat 1: @japhypoker (small blind) folded before Flop
Seat 2: Scooo13zzz (big blind) folded before Flop
Seat 3: RiverbendAA collected ($0.71)
Seat 4: dangerhard10 folded on the Flop
Seat 5: tapouttazz9 folded before Flop (didn't bet)
Seat 6: Apt1a (button) folded before Flop (didn't bet)


PokerStars Hand #157032883110:  Hold'em No Limit ($0.05/$0.10 USD) - 2016/08/16 17:51:58 ET
Table 'Apus' 6-max Seat #1 is the button
Seat 1: @japhypoker ($14.72 in chips)
Seat 2: Scooo13zzz ($9.90 in chips)
Seat 3: RiverbendAA ($10.76 in chips)
Seat 4: dangerhard10 ($12.71 in chips)
Seat 5: tapouttazz9 ($10.30 in chips)
Seat 6: Apt1a ($11.46 in chips)
Scooo13zzz: posts small blind $0.05
RiverbendAA: posts big blind $0.10
*** HOLE CARDS ***
Dealt to tapouttazz9 [Qc 7c]
dangerhard10: folds
tapouttazz9: folds
Apt1a: raises $0.15 to $0.25
@japhypoker: folds
Scooo13zzz: folds
RiverbendAA: folds
Uncalled bet ($0.15) returned to Apt1a
Apt1a collected $0.25 from pot
Apt1a: doesn't show hand
*** SUMMARY ***
Total pot $0.25 | Rake $0
Seat 1: @japhypoker (button) folded before Flop (didn't bet)
Seat 2: Scooo13zzz (small blind) folded before Flop
Seat 3: RiverbendAA (big blind) folded before Flop
Seat 4: dangerhard10 folded before Flop (didn't bet)
Seat 5: tapouttazz9 folded before Flop (didn't bet)
Seat 6: Apt1a collected ($0.25)


PokerStars Hand #157032883163:  Hold'em No Limit ($0.05/$0.10 USD) - 2016/08/16 17:52:13 ET
Table 'Apus' 6-max Seat #2 is the button
Seat 1: @japhypoker ($14.72 in chips)
Seat 2: Scooo13zzz ($9.85 in chips)
Seat 3: RiverbendAA ($10.66 in chips)
Seat 4: dangerhard10 ($12.71 in chips)
Seat 5: tapouttazz9 ($10.30 in chips)
Seat 6: Apt1a ($11.61 in chips)
RiverbendAA: posts small blind $0.05
dangerhard10: posts big blind $0.10
*** HOLE CARDS ***
Dealt to tapouttazz9 [Ad 8h]
tapouttazz9: folds
Apt1a: folds
@japhypoker: folds
Scooo13zzz: raises $0.20 to $0.30
RiverbendAA: calls $0.25
dangerhard10: folds
*** FLOP *** [7d 4d 4c]
RiverbendAA: checks
Scooo13zzz: bets $0.40
RiverbendAA: folds
Uncalled bet ($0.40) returned to Scooo13zzz
Scooo13zzz collected $0.66 from pot
*** SUMMARY ***
Total pot $0.70 | Rake $0.04
Board [7d 4d 4c]
Seat 1: @japhypoker folded before Flop (didn't bet)
Seat 2: Scooo13zzz (button) collected ($0.66)
Seat 3: RiverbendAA (small blind) folded on the Flop
Seat 4: dangerhard10 (big blind) folded before Flop
Seat 5: tapouttazz9 folded before Flop (didn't bet)
Seat 6: Apt1a folded before Flop (didn't bet)


PokerStars Hand #157032883308:  Hold'em No Limit ($0.05/$0.10 USD) - 2016/08/16 17:52:47 ET
Table 'Apus' 6-max Seat #3 is the button
Seat 1: @japhypoker ($14.72 in chips)
Seat 2: Scooo13zzz ($10.21 in chips)
Seat 3: RiverbendAA ($10.36 in chips)
Seat 4: dangerhard10 ($12.61 in chips)
Seat 5: tapouttazz9 ($10.30 in chips)
Seat 6: Apt1a ($11.61 in chips)
dangerhard10: posts small blind $0.05
tapouttazz9: posts big blind $0.10
*** HOLE CARDS ***
Dealt to tapouttazz9 [9c Ah]
Apt1a: folds
@japhypoker: folds
Scooo13zzz: folds
RiverbendAA: folds
dangerhard10: folds
Uncalled bet ($0.05) returned to tapouttazz9
tapouttazz9 collected $0.10 from pot
*** SUMMARY ***
Total pot $0.10 | Rake $0
Seat 1: @japhypoker folded before Flop (didn't bet)
Seat 2: Scooo13zzz folded before Flop (didn't bet)
Seat 3: RiverbendAA (button) folded before Flop (didn't bet)
Seat 4: dangerhard10 (small blind) folded before Flop
Seat 5: tapouttazz9 (big blind) collected ($0.10)
Seat 6: Apt1a folded before Flop (didn't bet)


PokerStars Hand #157032883394:  Hold'em No Limit ($0.05/$0.10 USD) - 2016/08/16 17:53:09 ET
Table 'Apus' 6-max Seat #4 is the button
Seat 1: @japhypoker ($14.72 in chips)
Seat 2: Scooo13zzz ($10.21 in chips)
Seat 3: RiverbendAA ($10.36 in chips)
Seat 4: dangerhard10 ($12.56 in chips)
Seat 5: tapouttazz9 ($10.35 in chips)
Seat 6: Apt1a ($11.61 in chips)
tapouttazz9: posts small blind $0.05
Apt1a: posts big blind $0.10
*** HOLE CARDS ***
Dealt to tapouttazz9 [Th Kh]
@japhypoker: folds
Scooo13zzz: folds
RiverbendAA: folds
dangerhard10: folds
tapouttazz9: raises $0.10 to $0.20
Apt1a: folds
Uncalled bet ($0.10) returned to tapouttazz9
tapouttazz9 collected $0.20 from pot
*** SUMMARY ***
Total pot $0.20 | Rake $0
Seat 1: @japhypoker folded before Flop (didn't bet)
Seat 2: Scooo13zzz folded before Flop (didn't bet)
Seat 3: RiverbendAA folded before Flop (didn't bet)
Seat 4: dangerhard10 (button) folded before Flop (didn't bet)
Seat 5: tapouttazz9 (small blind) collected ($0.20)
Seat 6: Apt1a (big blind) folded before Flop


PokerStars Hand #157032883504:  Hold'em No Limit ($0.05/$0.10 USD) - 2016/08/16 17:53:31 ET
Table 'Apus' 6-max Seat #5 is the button
Seat 1: @japhypoker ($14.72 in chips)
Seat 2: Scooo13zzz ($10.21 in chips)
Seat 3: RiverbendAA ($10.36 in chips)
Seat 4: dangerhard10 ($12.56 in chips)
Seat 5: tapouttazz9 ($10.45 in chips)
Seat 6: Apt1a ($11.51 in chips)
Apt1a: posts small blind $0.05
@japhypoker: posts big blind $0.10
*** HOLE CARDS ***
Dealt to tapouttazz9 [6s Qc]
Scooo13zzz: folds
RiverbendAA: folds
dangerhard10: calls $0.10
tapouttazz9: folds
Apt1a: calls $0.05
@japhypoker: checks
*** FLOP *** [9d Jd Qd]
Apt1a: checks
@japhypoker: checks
dangerhard10: checks
*** TURN *** [9d Jd Qd] [9s]
Apt1a: bets $0.15
@japhypoker: calls $0.15
dangerhard10: folds
*** RIVER *** [9d Jd Qd 9s] [Ks]
Apt1a: checks
@japhypoker: bets $0.35
Apt1a: folds
Uncalled bet ($0.35) returned to @japhypoker
@japhypoker collected $0.57 from pot
@japhypoker: doesn't show hand
*** SUMMARY ***
Total pot $0.60 | Rake $0.03
Board [9d Jd Qd 9s Ks]
Seat 1: @japhypoker (big blind) collected ($0.57)
Seat 2: Scooo13zzz folded before Flop (didn't bet)
Seat 3: RiverbendAA folded before Flop (didn't bet)
Seat 4: dangerhard10 folded on the Turn
Seat 5: tapouttazz9 (button) folded before Flop (didn't bet)
Seat 6: Apt1a (small blind) folded on the River


PokerStars Hand #157032883799:  Hold'em No Limit ($0.05/$0.10 USD) - 2016/08/16 17:54:39 ET
Table 'Apus' 6-max Seat #6 is the button
Seat 1: @japhypoker ($15.04 in chips)
Seat 2: Scooo13zzz ($10.21 in chips)
Seat 3: RiverbendAA ($10.36 in chips)
Seat 4: dangerhard10 ($12.46 in chips)
Seat 5: tapouttazz9 ($10.45 in chips)
Seat 6: Apt1a ($11.26 in chips)
@japhypoker: posts small blind $0.05
Scooo13zzz: posts big blind $0.10
*** HOLE CARDS ***
Dealt to tapouttazz9 [4h Kd]
RiverbendAA: folds
dangerhard10: calls $0.10
tapouttazz9: folds
Apt1a: folds
@japhypoker: folds
Scooo13zzz: checks
*** FLOP *** [Js 3d 2c]
Scooo13zzz: checks
dangerhard10: checks
*** TURN *** [Js 3d 2c] [Ac]
Scooo13zzz: checks
dangerhard10: bets $0.10
Scooo13zzz: folds
Uncalled bet ($0.10) returned to dangerhard10
dangerhard10 collected $0.24 from pot
*** SUMMARY ***
Total pot $0.25 | Rake $0.01
Board [Js 3d 2c Ac]
Seat 1: @japhypoker (small blind) folded before Flop
Seat 2: Scooo13zzz (big blind) folded on the Turn
Seat 3: RiverbendAA folded before Flop (didn't bet)
Seat 4: dangerhard10 collected ($0.24)
Seat 5: tapouttazz9 folded before Flop (didn't bet)
Seat 6: Apt1a (button) folded before Flop (didn't bet)


PokerStars Hand #157032883890:  Hold'em No Limit ($0.05/$0.10 USD) - 2016/08/16 17:54:59 ET
Table 'Apus' 6-max Seat #1 is the button
Seat 1: @japhypoker ($14.99 in chips)
Seat 2: Scooo13zzz ($10.11 in chips)
Seat 3: RiverbendAA ($10.36 in chips)
Seat 4: dangerhard10 ($12.60 in chips)
Seat 5: tapouttazz9 ($10.45 in chips)
Seat 6: Apt1a ($11.26 in chips)
Scooo13zzz: posts small blind $0.05
RiverbendAA: posts big blind $0.10
*** HOLE CARDS ***
Dealt to tapouttazz9 [2d 7d]
dangerhard10: folds
tapouttazz9: folds
Apt1a: folds
@japhypoker: raises $0.15 to $0.25
Scooo13zzz: folds
RiverbendAA: folds
Uncalled bet ($0.15) returned to @japhypoker
@japhypoker collected $0.25 from pot
@japhypoker: doesn't show hand
*** SUMMARY ***
Total pot $0.25 | Rake $0
Seat 1: @japhypoker (button) collected ($0.25)
Seat 2: Scooo13zzz (small blind) folded before Flop
Seat 3: RiverbendAA (big blind) folded before Flop
Seat 4: dangerhard10 folded before Flop (didn't bet)
Seat 5: tapouttazz9 folded before Flop (didn't bet)
Seat 6: Apt1a folded before Flop (didn't bet)


PokerStars Hand #157032883989:  Hold'em No Limit ($0.05/$0.10 USD) - 2016/08/16 17:55:22 ET
Table 'Apus' 6-max Seat #2 is the button
Seat 1: @japhypoker ($15.14 in chips)
Seat 2: Scooo13zzz ($10.06 in chips)
Seat 3: RiverbendAA ($10.26 in chips)
Seat 4: dangerhard10 ($12.60 in chips)
Seat 5: tapouttazz9 ($10.45 in chips)
Seat 6: Apt1a ($11.26 in chips)
RiverbendAA: posts small blind $0.05
dangerhard10: posts big blind $0.10
*** HOLE CARDS ***
Dealt to tapouttazz9 [Kc 8c]
tapouttazz9: folds
Apt1a: raises $0.15 to $0.25
@japhypoker: calls $0.25
Scooo13zzz: raises $0.55 to $0.80
RiverbendAA: folds
dangerhard10: folds
Apt1a: folds
@japhypoker: folds
Uncalled bet ($0.55) returned to Scooo13zzz
Scooo13zzz collected $0.90 from pot
*** SUMMARY ***
Total pot $0.90 | Rake $0
Seat 1: @japhypoker folded before Flop
Seat 2: Scooo13zzz (button) collected ($0.90)
Seat 3: RiverbendAA (small blind) folded before Flop
Seat 4: dangerhard10 (big blind) folded before Flop
Seat 5: tapouttazz9 folded before Flop (didn't bet)
Seat 6: Apt1a folded before Flop


PokerStars Hand #157032884208:  Hold'em No Limit ($0.05/$0.10 USD) - 2016/08/16 17:56:14 ET
Table 'Apus' 6-max Seat #3 is the button
Seat 1: @japhypoker ($14.89 in chips)
Seat 2: Scooo13zzz ($10.71 in chips)
Seat 3: RiverbendAA ($10.21 in chips)
Seat 5: tapouttazz9 ($10.45 in chips)
Seat 6: Apt1a ($11.01 in chips)
tapouttazz9: posts small blind $0.05
Apt1a: posts big blind $0.10
*** HOLE CARDS ***
Dealt to tapouttazz9 [5d Jc]
@japhypoker: folds
Scooo13zzz: folds
RiverbendAA: raises $0.20 to $0.30
tapouttazz9: folds
Apt1a: folds
Uncalled bet ($0.20) returned to RiverbendAA
RiverbendAA collected $0.25 from pot
RiverbendAA: doesn't show hand
*** SUMMARY ***
Total pot $0.25 | Rake $0
Seat 1: @japhypoker folded before Flop (didn't bet)
Seat 2: Scooo13zzz folded before Flop (didn't bet)
Seat 3: RiverbendAA (button) collected ($0.25)
Seat 5: tapouttazz9 (small blind) folded before Flop
Seat 6: Apt1a (big blind) folded before Flop


PokerStars Hand #157032884322:  Hold'em No Limit ($0.05/$0.10 USD) - 2016/08/16 17:56:40 ET
Table 'Apus' 6-max Seat #5 is the button
Seat 1: @japhypoker ($14.89 in chips)
Seat 2: Scooo13zzz ($10.71 in chips)
Seat 3: RiverbendAA ($10.36 in chips)
Seat 5: tapouttazz9 ($10.40 in chips)
Seat 6: Apt1a ($10.91 in chips)
Apt1a: posts small blind $0.05
@japhypoker: posts big blind $0.10
*** HOLE CARDS ***
Dealt to tapouttazz9 [9h Jc]
Scooo13zzz: folds
RiverbendAA: folds
tapouttazz9: folds
Apt1a: raises $0.15 to $0.25
@japhypoker: folds
Uncalled bet ($0.15) returned to Apt1a
Apt1a collected $0.20 from pot
Apt1a: doesn't show hand
*** SUMMARY ***
Total pot $0.20 | Rake $0
Seat 1: @japhypoker (big blind) folded before Flop
Seat 2: Scooo13zzz folded before Flop (didn't bet)
Seat 3: RiverbendAA folded before Flop (didn't bet)
Seat 5: tapouttazz9 (button) folded before Flop (didn't bet)
Seat 6: Apt1a (small blind) collected ($0.20)


PokerStars Hand #157032884396:  Hold'em No Limit ($0.05/$0.10 USD) - 2016/08/16 17:56:58 ET
Table 'Apus' 6-max Seat #6 is the button
Seat 1: @japhypoker ($14.79 in chips)
Seat 2: Scooo13zzz ($10.71 in chips)
Seat 3: RiverbendAA ($10.36 in chips)
Seat 5: tapouttazz9 ($10.40 in chips)
Seat 6: Apt1a ($11.01 in chips)
@japhypoker: posts small blind $0.05
Scooo13zzz: posts big blind $0.10
*** HOLE CARDS ***
Dealt to tapouttazz9 [5s Kh]
RiverbendAA: raises $0.20 to $0.30
tapouttazz9: folds
Apt1a: folds
@japhypoker: folds
Scooo13zzz: folds
Uncalled bet ($0.20) returned to RiverbendAA
RiverbendAA collected $0.25 from pot
RiverbendAA: doesn't show hand
*** SUMMARY ***
Total pot $0.25 | Rake $0
Seat 1: @japhypoker (small blind) folded before Flop
Seat 2: Scooo13zzz (big blind) folded before Flop
Seat 3: RiverbendAA collected ($0.25)
Seat 5: tapouttazz9 folded before Flop (didn't bet)
Seat 6: Apt1a (button) folded before Flop (didn't bet)


PokerStars Hand #157032884530:  Hold'em No Limit ($0.05/$0.10 USD) - 2016/08/16 17:57:31 ET
Table 'Apus' 6-max Seat #1 is the button
Seat 1: @japhypoker ($14.74 in chips)
Seat 2: Scooo13zzz ($10.61 in chips)
Seat 3: RiverbendAA ($10.51 in chips)
Seat 5: tapouttazz9 ($10.40 in chips)
Seat 6: Apt1a ($11.01 in chips)
Scooo13zzz: posts small blind $0.05
RiverbendAA: posts big blind $0.10
*** HOLE CARDS ***
Dealt to tapouttazz9 [6s Qh]
tapouttazz9: folds
Apt1a: folds
@japhypoker: raises $0.15 to $0.25
Scooo13zzz: folds
RiverbendAA: folds
Uncalled bet ($0.15) returned to @japhypoker
@japhypoker collected $0.25 from pot
@japhypoker: doesn't show hand
*** SUMMARY ***
Total pot $0.25 | Rake $0
Seat 1: @japhypoker (button) collected ($0.25)
Seat 2: Scooo13zzz (small blind) folded before Flop
Seat 3: RiverbendAA (big blind) folded before Flop
Seat 5: tapouttazz9 folded before Flop (didn't bet)
Seat 6: Apt1a folded before Flop (didn't bet)


PokerStars Hand #157032884624:  Hold'em No Limit ($0.05/$0.10 USD) - 2016/08/16 17:57:51 ET
Table 'Apus' 6-max Seat #2 is the button
Seat 1: @japhypoker ($14.89 in chips)
Seat 2: Scooo13zzz ($10.56 in chips)
Seat 3: RiverbendAA ($10.41 in chips)
Seat 5: tapouttazz9 ($10.40 in chips)
Seat 6: Apt1a ($11.01 in chips)
RiverbendAA: posts small blind $0.05
tapouttazz9: posts big blind $0.10
*** HOLE CARDS ***
Dealt to tapouttazz9 [Jc Qh]
Apt1a: folds
@japhypoker: folds
Scooo13zzz: folds
RiverbendAA: raises $0.20 to $0.30
tapouttazz9: calls $0.20
*** FLOP *** [5s 7c 4c]
RiverbendAA: bets $0.40
tapouttazz9: folds
Uncalled bet ($0.40) returned to RiverbendAA
RiverbendAA collected $0.57 from pot
RiverbendAA: doesn't show hand
*** SUMMARY ***
Total pot $0.60 | Rake $0.03
Board [5s 7c 4c]
Seat 1: @japhypoker folded before Flop (didn't bet)
Seat 2: Scooo13zzz (button) folded before Flop (didn't bet)
Seat 3: RiverbendAA (small blind) collected ($0.57)
Seat 5: tapouttazz9 (big blind) folded on the Flop
Seat 6: Apt1a folded before Flop (didn't bet)


PokerStars Hand #157032884834:  Hold'em No Limit ($0.05/$0.10 USD) - 2016/08/16 17:58:39 ET
Table 'Apus' 6-max Seat #3 is the button
Seat 1: @japhypoker ($14.89 in chips)
Seat 2: Scooo13zzz ($10.56 in chips)
Seat 3: RiverbendAA ($10.68 in chips)
Seat 5: tapouttazz9 ($10.10 in chips)
Seat 6: Apt1a ($11.01 in chips)
tapouttazz9: posts small blind $0.05
Apt1a: posts big blind $0.10
*** HOLE CARDS ***
Dealt to tapouttazz9 [Th 3c]
@japhypoker: folds
Scooo13zzz: raises $0.20 to $0.30
RiverbendAA: folds
tapouttazz9: folds
Apt1a: folds
Uncalled bet ($0.20) returned to Scooo13zzz
Scooo13zzz collected $0.25 from pot
*** SUMMARY ***
Total pot $0.25 | Rake $0
Seat 1: @japhypoker folded before Flop (didn't bet)
Seat 2: Scooo13zzz collected ($0.25)
Seat 3: RiverbendAA (button) folded before Flop (didn't bet)
Seat 5: tapouttazz9 (small blind) folded before Flop
Seat 6: Apt1a (big blind) folded before Flop


PokerStars Hand #157032884915:  Hold'em No Limit ($0.05/$0.10 USD) - 2016/08/16 17:59:02 ET
Table 'Apus' 6-max Seat #5 is the button
Seat 1: @japhypoker ($14.89 in chips)
Seat 2: Scooo13zzz ($10.71 in chips)
Seat 3: RiverbendAA ($10.68 in chips)
Seat 5: tapouttazz9 ($10.05 in chips)
Seat 6: Apt1a ($10.91 in chips)
Apt1a: posts small blind $0.05
@japhypoker: posts big blind $0.10
*** HOLE CARDS ***
Dealt to tapouttazz9 [Ks 9d]
Scooo13zzz: raises $0.20 to $0.30
RiverbendAA: folds
tapouttazz9: folds
Apt1a: calls $0.25
@japhypoker: folds
*** FLOP *** [2h 7s 3s]
Apt1a: bets $0.35
Scooo13zzz: folds
Uncalled bet ($0.35) returned to Apt1a
Apt1a collected $0.66 from pot
Apt1a: doesn't show hand
*** SUMMARY ***
Total pot $0.70 | Rake $0.04
Board [2h 7s 3s]
Seat 1: @japhypoker (big blind) folded before Flop
Seat 2: Scooo13zzz folded on the Flop
Seat 3: RiverbendAA folded before Flop (didn't bet)
Seat 5: tapouttazz9 (button) folded before Flop (didn't bet)
Seat 6: Apt1a (small blind) collected ($0.66)


PokerStars Hand #157032885151:  Hold'em No Limit ($0.05/$0.10 USD) - 2016/08/16 18:00:00 ET
Table 'Apus' 6-max Seat #6 is the button
Seat 1: @japhypoker ($14.79 in chips)
Seat 2: Scooo13zzz ($10.41 in chips)
Seat 3: RiverbendAA ($10.68 in chips)
Seat 4: dangerhard10 ($12.50 in chips)
Seat 5: tapouttazz9 ($10.05 in chips)
Seat 6: Apt1a ($11.27 in chips)
@japhypoker: posts small blind $0.05
Scooo13zzz: posts big blind $0.10
dangerhard10: posts small & big blinds $0.15
*** HOLE CARDS ***
Dealt to tapouttazz9 [4s 7d]
RiverbendAA: folds
dangerhard10: checks
tapouttazz9: folds
Apt1a: folds
@japhypoker: calls $0.05
Scooo13zzz: checks
*** FLOP *** [4h 2s 9d]
@japhypoker: bets $0.16
Scooo13zzz: calls $0.16
dangerhard10: folds
*** TURN *** [4h 2s 9d] [8h]
@japhypoker: bets $0.31
Scooo13zzz: calls $0.31
*** RIVER *** [4h 2s 9d 8h] [7h]
@japhypoker: bets $0.76
Scooo13zzz: calls $0.76
*** SHOW DOWN ***
@japhypoker: shows [5c 2c] (a pair of Deuces)
Scooo13zzz: shows [Qh 9c] (a pair of Nines)
Scooo13zzz collected $2.67 from pot
*** SUMMARY ***
Total pot $2.81 | Rake $0.14
Board [4h 2s 9d 8h 7h]
Seat 1: @japhypoker (small blind) showed [5c 2c] and lost with a pair of Deuces
Seat 2: Scooo13zzz (big blind) showed [Qh 9c] and won ($2.67) with a pair of Nines
Seat 3: RiverbendAA folded before Flop (didn't bet)
Seat 4: dangerhard10 folded on the Flop
Seat 5: tapouttazz9 folded before Flop (didn't bet)
Seat 6: Apt1a (button) folded before Flop (didn't bet)


PokerStars Hand #157032885455:  Hold'em No Limit ($0.05/$0.10 USD) - 2016/08/16 18:01:06 ET
Table 'Apus' 6-max Seat #1 is the button
Seat 1: @japhypoker ($13.46 in chips)
Seat 2: Scooo13zzz ($11.75 in chips)
Seat 3: RiverbendAA ($10.68 in chips)
Seat 4: dangerhard10 ($12.35 in chips)
Seat 5: tapouttazz9 ($10.05 in chips)
Seat 6: Apt1a ($11.27 in chips)
Scooo13zzz: posts small blind $0.05
RiverbendAA: posts big blind $0.10
*** HOLE CARDS ***
Dealt to tapouttazz9 [Qd 3h]
dangerhard10: folds
tapouttazz9: folds
Apt1a: raises $0.15 to $0.25
@japhypoker: folds
Scooo13zzz: folds
RiverbendAA: folds
Uncalled bet ($0.15) returned to Apt1a
Apt1a collected $0.25 from pot
Apt1a: doesn't show hand
*** SUMMARY ***
Total pot $0.25 | Rake $0
Seat 1: @japhypoker (button) folded before Flop (didn't bet)
Seat 2: Scooo13zzz (small blind) folded before Flop
Seat 3: RiverbendAA (big blind) folded before Flop
Seat 4: dangerhard10 folded before Flop (didn't bet)
Seat 5: tapouttazz9 folded before Flop (didn't bet)
Seat 6: Apt1a collected ($0.25)


PokerStars Hand #157032885612:  Hold'em No Limit ($0.05/$0.10 USD) - 2016/08/16 18:01:38 ET
Table 'Apus' 6-max Seat #2 is the button
Seat 1: @japhypoker ($13.46 in chips)
Seat 2: Scooo13zzz ($11.70 in chips)
Seat 3: RiverbendAA ($10.58 in chips)
Seat 4: dangerhard10 ($12.35 in chips)
Seat 5: tapouttazz9 ($10.05 in chips)
Seat 6: Apt1a ($11.42 in chips)
RiverbendAA: posts small blind $0.05
dangerhard10: posts big blind $0.10
*** HOLE CARDS ***
Dealt to tapouttazz9 [Kd 8s]
tapouttazz9: folds
Apt1a: folds
@japhypoker: raises $0.15 to $0.25
Scooo13zzz: folds
RiverbendAA: folds
dangerhard10: calls $0.15
*** FLOP *** [4h Ks 7h]
dangerhard10: checks
@japhypoker: bets $0.25
dangerhard10: folds
Uncalled bet ($0.25) returned to @japhypoker
@japhypoker collected $0.52 from pot
@japhypoker: doesn't show hand
*** SUMMARY ***
Total pot $0.55 | Rake $0.03
Board [4h Ks 7h]
Seat 1: @japhypoker collected ($0.52)
Seat 2: Scooo13zzz (button) folded before Flop (didn't bet)
Seat 3: RiverbendAA (small blind) folded before Flop
Seat 4: dangerhard10 (big blind) folded on the Flop
Seat 5: tapouttazz9 folded before Flop (didn't bet)
Seat 6: Apt1a folded before Flop (didn't bet)


PokerStars Hand #157032885701:  Hold'em No Limit ($0.05/$0.10 USD) - 2016/08/16 18:01:57 ET
Table 'Apus' 6-max Seat #3 is the button
Seat 1: @japhypoker ($13.73 in chips)
Seat 2: Scooo13zzz ($11.70 in chips)
Seat 3: RiverbendAA ($10.53 in chips)
Seat 4: dangerhard10 ($12.10 in chips)
Seat 5: tapouttazz9 ($10.05 in chips)
Seat 6: Apt1a ($11.42 in chips)
dangerhard10: posts small blind $0.05
tapouttazz9: posts big blind $0.10
*** HOLE CARDS ***
Dealt to tapouttazz9 [4c Qd]
Apt1a: folds
@japhypoker: folds
Scooo13zzz: folds
RiverbendAA: raises $0.20 to $0.30
dangerhard10: folds
tapouttazz9: folds
Uncalled bet ($0.20) returned to RiverbendAA
RiverbendAA collected $0.25 from pot
RiverbendAA: doesn't show hand
*** SUMMARY ***
Total pot $0.25 | Rake $0
Seat 1: @japhypoker folded before Flop (didn't bet)
Seat 2: Scooo13zzz folded before Flop (didn't bet)
Seat 3: RiverbendAA (button) collected ($0.25)
Seat 4: dangerhard10 (small blind) folded before Flop
Seat 5: tapouttazz9 (big blind) folded before Flop
Seat 6: Apt1a folded before Flop (didn't bet)


PokerStars Hand #157032885768:  Hold'em No Limit ($0.05/$0.10 USD) - 2016/08/16 18:02:10 ET
Table 'Apus' 6-max Seat #4 is the button
Seat 1: @japhypoker ($13.73 in chips)
Seat 2: Scooo13zzz ($11.70 in chips)
Seat 3: RiverbendAA ($10.68 in chips)
Seat 4: dangerhard10 ($12.05 in chips)
Seat 5: tapouttazz9 ($9.95 in chips)
Seat 6: Apt1a ($11.42 in chips)
tapouttazz9: posts small blind $0.05
Apt1a: posts big blind $0.10
*** HOLE CARDS ***
Dealt to tapouttazz9 [6c Kc]
@japhypoker: folds
Scooo13zzz: raises $0.20 to $0.30
RiverbendAA: folds
dangerhard10: calls $0.30
tapouttazz9: folds
Apt1a: folds
*** FLOP *** [Ts 4c 7c]
Scooo13zzz: bets $0.50
dangerhard10: calls $0.50
*** TURN *** [Ts 4c 7c] [Jc]
Scooo13zzz: checks
dangerhard10: bets $0.83
Scooo13zzz: calls $0.83
*** RIVER *** [Ts 4c 7c Jc] [2c]
Scooo13zzz: checks
dangerhard10: bets $1.62
Scooo13zzz: folds
Uncalled bet ($1.62) returned to dangerhard10
dangerhard10 collected $3.24 from pot
*** SUMMARY ***
Total pot $3.41 | Rake $0.17
Board [Ts 4c 7c Jc 2c]
Seat 1: @japhypoker folded before Flop (didn't bet)
Seat 2: Scooo13zzz folded on the River
Seat 3: RiverbendAA folded before Flop (didn't bet)
Seat 4: dangerhard10 (button) collected ($3.24)
Seat 5: tapouttazz9 (small blind) folded before Flop
Seat 6: Apt1a (big blind) folded before Flop


PokerStars Hand #157032886074:  Hold'em No Limit ($0.05/$0.10 USD) - 2016/08/16 18:03:13 ET
Table 'Apus' 6-max Seat #5 is the button
Seat 1: @japhypoker ($13.73 in chips)
Seat 2: Scooo13zzz ($10.07 in chips)
Seat 3: RiverbendAA ($10.68 in chips)
Seat 4: dangerhard10 ($13.66 in chips)
Seat 5: tapouttazz9 ($9.90 in chips)
Seat 6: Apt1a ($11.32 in chips)
Apt1a: posts small blind $0.05
@japhypoker: posts big blind $0.10
*** HOLE CARDS ***
Dealt to tapouttazz9 [6c 3d]
Scooo13zzz: raises $0.20 to $0.30
RiverbendAA: folds
dangerhard10: calls $0.30
tapouttazz9: folds
Apt1a: folds
@japhypoker: folds
*** FLOP *** [4c 7h Ts]
Scooo13zzz: bets $0.42
dangerhard10: calls $0.42
*** TURN *** [4c 7h Ts] [8h]
Scooo13zzz: checks
dangerhard10: bets $1.51
Scooo13zzz: folds
Uncalled bet ($1.51) returned to dangerhard10
dangerhard10 collected $1.51 from pot
*** SUMMARY ***
Total pot $1.59 | Rake $0.08
Board [4c 7h Ts 8h]
Seat 1: @japhypoker (big blind) folded before Flop
Seat 2: Scooo13zzz folded on the Turn
Seat 3: RiverbendAA folded before Flop (didn't bet)
Seat 4: dangerhard10 collected ($1.51)
Seat 5: tapouttazz9 (button) folded before Flop (didn't bet)
Seat 6: Apt1a (small blind) folded before Flop


PokerStars Hand #157037048141:  Hold'em No Limit ($0.05/$0.10 USD) - 2016/08/16 19:38:47 ET
Table 'Apus' 6-max Seat #2 is the button
Seat 2: UIGEA2016 ($10.10 in chips)
Seat 3: mrpolelock ($7.90 in chips)
Seat 4: tapouttazz9 ($10 in chips)
mrpolelock: posts small blind $0.05
tapouttazz9: posts big blind $0.10
*** HOLE CARDS ***
Dealt to tapouttazz9 [Jd 8h]
UIGEA2016: folds
mrpolelock: calls $0.05
tapouttazz9: checks
*** FLOP *** [Qd Js Jc]
mrpolelock: bets $0.10
tapouttazz9: calls $0.10
*** TURN *** [Qd Js Jc] [9h]
tclick joins the table at seat #6
mrpolelock: checks
tapouttazz9: bets $0.19
mrpolelock: folds
Uncalled bet ($0.19) returned to tapouttazz9
tapouttazz9 collected $0.38 from pot
*** SUMMARY ***
Total pot $0.40 | Rake $0.02
Board [Qd Js Jc 9h]
Seat 2: UIGEA2016 (button) folded before Flop (didn't bet)
Seat 3: mrpolelock (small blind) folded on the Turn
Seat 4: tapouttazz9 (big blind) collected ($0.38)


PokerStars Hand #157037048239:  Hold'em No Limit ($0.05/$0.10 USD) - 2016/08/16 19:39:06 ET
Table 'Apus' 6-max Seat #3 is the button
Seat 2: UIGEA2016 ($10.10 in chips)
Seat 3: mrpolelock ($7.70 in chips)
Seat 4: tapouttazz9 ($10.18 in chips)
Seat 6: tclick ($8 in chips)
tapouttazz9: posts small blind $0.05
tclick: posts big blind $0.10
*** HOLE CARDS ***
Dealt to tapouttazz9 [8d 5c]
UIGEA2016: folds
mrpolelock: calls $0.10
tapouttazz9: folds
tclick: checks
*** FLOP *** [5h Js 7d]
tclick: bets $0.24
mrpolelock: calls $0.24
*** TURN *** [5h Js 7d] [7s]
tclick: bets $0.10
mrpolelock: calls $0.10
*** RIVER *** [5h Js 7d 7s] [4h]
tclick: bets $0.60
mrpolelock: raises $0.60 to $1.20
tclick: calls $0.60
*** SHOW DOWN ***
mrpolelock: shows [8h 6h] (a straight, Four to Eight)
tclick: mucks hand
mrpolelock collected $3.16 from pot
*** SUMMARY ***
Total pot $3.33 | Rake $0.17
Board [5h Js 7d 7s 4h]
Seat 2: UIGEA2016 folded before Flop (didn't bet)
Seat 3: mrpolelock (button) showed [8h 6h] and won ($3.16) with a straight, Four to Eight
Seat 4: tapouttazz9 (small blind) folded before Flop
Seat 6: tclick (big blind) mucked [Jh Td]


PokerStars Hand #157037048523:  Hold'em No Limit ($0.05/$0.10 USD) - 2016/08/16 19:39:56 ET
Table 'Apus' 6-max Seat #4 is the button
Seat 2: UIGEA2016 ($10.10 in chips)
Seat 3: mrpolelock ($9.22 in chips)
Seat 4: tapouttazz9 ($10.13 in chips)
Seat 6: tclick ($6.36 in chips)
tclick: posts small blind $0.05
UIGEA2016: posts big blind $0.10
*** HOLE CARDS ***
Dealt to tapouttazz9 [3c 7h]
ultrasii86 joins the table at seat #5
mrpolelock: raises $0.20 to $0.30
tapouttazz9: folds
tclick: folds
UIGEA2016: calls $0.20
*** FLOP *** [Th Qd Ad]
UIGEA2016: checks
mrpolelock: bets $0.31
UIGEA2016: folds
Uncalled bet ($0.31) returned to mrpolelock
mrpolelock collected $0.62 from pot
mrpolelock: doesn't show hand
*** SUMMARY ***
Total pot $0.65 | Rake $0.03
Board [Th Qd Ad]
Seat 2: UIGEA2016 (big blind) folded on the Flop
Seat 3: mrpolelock collected ($0.62)
Seat 4: tapouttazz9 (button) folded before Flop (didn't bet)
Seat 6: tclick (small blind) folded before Flop


PokerStars Hand #157037048629:  Hold'em No Limit ($0.05/$0.10 USD) - 2016/08/16 19:40:16 ET
Table 'Apus' 6-max Seat #6 is the button
Seat 2: UIGEA2016 ($9.80 in chips)
Seat 3: mrpolelock ($9.54 in chips)
Seat 4: tapouttazz9 ($10.13 in chips)
Seat 6: tclick ($6.31 in chips)
UIGEA2016: posts small blind $0.05
mrpolelock: posts big blind $0.10
ultrasii86: sits out
*** HOLE CARDS ***
Dealt to tapouttazz9 [2c 6h]
tapouttazz9: folds
tclick: calls $0.10
UIGEA2016: folds
mrpolelock: checks
*** FLOP *** [Jd Jh 2s]
mrpolelock: checks
tclick: checks
*** TURN *** [Jd Jh 2s] [3c]
mrpolelock: checks
tclick: checks
*** RIVER *** [Jd Jh 2s 3c] [Th]
mrpolelock: bets $0.10
runbich joins the table at seat #1
tclick: calls $0.10
*** SHOW DOWN ***
mrpolelock: shows [3h 4s] (two pair, Jacks and Threes)
tclick: mucks hand
mrpolelock collected $0.43 from pot
*** SUMMARY ***
Total pot $0.45 | Rake $0.02
Board [Jd Jh 2s 3c Th]
Seat 2: UIGEA2016 (small blind) folded before Flop
Seat 3: mrpolelock (big blind) showed [3h 4s] and won ($0.43) with two pair, Jacks and Threes
Seat 4: tapouttazz9 folded before Flop (didn't bet)
Seat 6: tclick (button) mucked [6d Ac]


PokerStars Hand #157037048771:  Hold'em No Limit ($0.05/$0.10 USD) - 2016/08/16 19:40:42 ET
Table 'Apus' 6-max Seat #2 is the button
Seat 2: UIGEA2016 ($9.75 in chips)
Seat 3: mrpolelock ($9.77 in chips)
Seat 4: tapouttazz9 ($10.13 in chips)
Seat 6: tclick ($6.11 in chips)
mrpolelock: posts small blind $0.05
tapouttazz9: posts big blind $0.10
ultrasii86: sits out
runbich: sits out
*** HOLE CARDS ***
Dealt to tapouttazz9 [5h 4c]
tclick: folds
UIGEA2016: folds
mrpolelock: raises $0.20 to $0.30
tapouttazz9: folds
Uncalled bet ($0.20) returned to mrpolelock
mrpolelock collected $0.20 from pot
mrpolelock: doesn't show hand
*** SUMMARY ***
Total pot $0.20 | Rake $0
Seat 2: UIGEA2016 (button) folded before Flop (didn't bet)
Seat 3: mrpolelock (small blind) collected ($0.20)
Seat 4: tapouttazz9 (big blind) folded before Flop
Seat 6: tclick folded before Flop (didn't bet)


PokerStars Hand #157037048820:  Hold'em No Limit ($0.05/$0.10 USD) - 2016/08/16 19:40:52 ET
Table 'Apus' 6-max Seat #3 is the button
Seat 2: UIGEA2016 ($9.75 in chips)
Seat 3: mrpolelock ($9.87 in chips)
Seat 4: tapouttazz9 ($10.03 in chips)
Seat 5: ultrasii86 ($10 in chips)
Seat 6: tclick ($6.11 in chips)
tapouttazz9: posts small blind $0.05
ultrasii86: posts big blind $0.10
runbich: sits out
*** HOLE CARDS ***
Dealt to tapouttazz9 [Ad Kc]
tclick: calls $0.10
UIGEA2016: folds
mrpolelock: calls $0.10
tapouttazz9: raises $0.20 to $0.30
ultrasii86: calls $0.20
tclick: calls $0.20
mrpolelock: folds
*** FLOP *** [4h 3h 2c]
tapouttazz9: bets $0.95
ultrasii86: raises $1.35 to $2.30
tclick: folds
tapouttazz9: calls $1.35
*** TURN *** [4h 3h 2c] [3d]
tapouttazz9: bets $7.43 and is all-in
ultrasii86: folds
Uncalled bet ($7.43) returned to tapouttazz9
tapouttazz9 collected $5.32 from pot
*** SUMMARY ***
Total pot $5.60 | Rake $0.28
Board [4h 3h 2c 3d]
Seat 2: UIGEA2016 folded before Flop (didn't bet)
Seat 3: mrpolelock (button) folded before Flop
Seat 4: tapouttazz9 (small blind) collected ($5.32)
Seat 5: ultrasii86 (big blind) folded on the Turn
Seat 6: tclick folded on the Flop


PokerStars Hand #157037049150:  Hold'em No Limit ($0.05/$0.10 USD) - 2016/08/16 19:41:54 ET
Table 'Apus' 6-max Seat #4 is the button
Seat 2: UIGEA2016 ($9.75 in chips)
Seat 3: mrpolelock ($9.77 in chips)
Seat 4: tapouttazz9 ($12.75 in chips)
Seat 5: ultrasii86 ($7.40 in chips)
Seat 6: tclick ($5.81 in chips)
ultrasii86: posts small blind $0.05
tclick: posts big blind $0.10
runbich: sits out
*** HOLE CARDS ***
Dealt to tapouttazz9 [4h Jd]
ultrasii86 said, "99 no good?"
UIGEA2016: raises $0.20 to $0.30
mrpolelock: folds
tapouttazz9: folds
ultrasii86: folds
tclick: folds
Uncalled bet ($0.20) returned to UIGEA2016
UIGEA2016 collected $0.25 from pot
UIGEA2016: doesn't show hand
*** SUMMARY ***
Total pot $0.25 | Rake $0
Seat 2: UIGEA2016 collected ($0.25)
Seat 3: mrpolelock folded before Flop (didn't bet)
Seat 4: tapouttazz9 (button) folded before Flop (didn't bet)
Seat 5: ultrasii86 (small blind) folded before Flop
Seat 6: tclick (big blind) folded before Flop


PokerStars Hand #157037049234:  Hold'em No Limit ($0.05/$0.10 USD) - 2016/08/16 19:42:08 ET
Table 'Apus' 6-max Seat #5 is the button
Seat 1: runbich ($8.78 in chips)
Seat 2: UIGEA2016 ($9.90 in chips)
Seat 3: mrpolelock ($9.77 in chips)
Seat 4: tapouttazz9 ($12.75 in chips)
Seat 5: ultrasii86 ($7.35 in chips)
Seat 6: tclick ($5.71 in chips)
tclick: posts small blind $0.05
runbich: posts big blind $0.10
*** HOLE CARDS ***
Dealt to tapouttazz9 [Th 8s]
UIGEA2016: folds
mrpolelock: folds
tapouttazz9: folds
ultrasii86: folds
tclick: calls $0.05
runbich: raises $0.20 to $0.30
tclick: calls $0.20
*** FLOP *** [9h Ac 3c]
tclick: checks
runbich: bets $0.40
tclick: calls $0.40
*** TURN *** [9h Ac 3c] [9c]
tclick: checks
runbich: bets $0.90
tclick: calls $0.90
*** RIVER *** [9h Ac 3c 9c] [7d]
tclick: checks
runbich: checks
*** SHOW DOWN ***
tclick: shows [Js 9s] (three of a kind, Nines)
runbich: mucks hand
tclick collected $3.04 from pot
*** SUMMARY ***
Total pot $3.20 | Rake $0.16
Board [9h Ac 3c 9c 7d]
Seat 1: runbich (big blind) mucked [2c 2h]
Seat 2: UIGEA2016 folded before Flop (didn't bet)
Seat 3: mrpolelock folded before Flop (didn't bet)
Seat 4: tapouttazz9 folded before Flop (didn't bet)
Seat 5: ultrasii86 (button) folded before Flop (didn't bet)
Seat 6: tclick (small blind) showed [Js 9s] and won ($3.04) with three of a kind, Nines


PokerStars Hand #157037049669:  Hold'em No Limit ($0.05/$0.10 USD) - 2016/08/16 19:43:28 ET
Table 'Apus' 6-max Seat #6 is the button
Seat 1: runbich ($7.18 in chips)
Seat 2: UIGEA2016 ($9.90 in chips)
Seat 3: mrpolelock ($9.77 in chips)
Seat 4: tapouttazz9 ($12.75 in chips)
Seat 5: ultrasii86 ($7.35 in chips)
Seat 6: tclick ($7.15 in chips)
runbich: posts small blind $0.05
UIGEA2016: posts big blind $0.10
*** HOLE CARDS ***
Dealt to tapouttazz9 [Qs Jd]
mrpolelock: folds
tapouttazz9: raises $0.10 to $0.20
ultrasii86: raises $0.30 to $0.50
tclick: folds
runbich: raises $1.30 to $1.80
UIGEA2016: folds
tapouttazz9: folds
ultrasii86: raises $2.40 to $4.20
tapouttazz9 said, ":D"
runbich: raises $2.60 to $6.80
ultrasii86: raises $0.55 to $7.35 and is all-in
runbich: calls $0.38 and is all-in
Uncalled bet ($0.17) returned to ultrasii86
*** FLOP *** [Jh 9d 4d]
*** TURN *** [Jh 9d 4d] [5d]
*** RIVER *** [Jh 9d 4d 5d] [8d]
*** SHOW DOWN ***
runbich: shows [Ah Ad] (a flush, Ace high)
ultrasii86: shows [Ks Kh] (a pair of Kings)
runbich collected $13.93 from pot
*** SUMMARY ***
Total pot $14.66 | Rake $0.73
Board [Jh 9d 4d 5d 8d]
Seat 1: runbich (small blind) showed [Ah Ad] and won ($13.93) with a flush, Ace high
Seat 2: UIGEA2016 (big blind) folded before Flop
Seat 3: mrpolelock folded before Flop (didn't bet)
Seat 4: tapouttazz9 folded before Flop
Seat 5: ultrasii86 showed [Ks Kh] and lost with a pair of Kings
Seat 6: tclick (button) folded before Flop (didn't bet)


PokerStars Hand #157038109195:  Hold'em No Limit ($0.05/$0.10 USD) - 2016/08/16 19:44:35 ET
Table 'Apus' 6-max Seat #1 is the button
Seat 1: runbich ($13.93 in chips)
Seat 2: UIGEA2016 ($9.80 in chips)
Seat 3: mrpolelock ($9.77 in chips)
Seat 4: tapouttazz9 ($12.55 in chips)
Seat 5: ultrasii86 ($0.17 in chips)
Seat 6: tclick ($7.15 in chips)
UIGEA2016: posts small blind $0.05
mrpolelock: posts big blind $0.10
*** HOLE CARDS ***
Dealt to tapouttazz9 [Th 7c]
tapouttazz9: folds
ultrasii86: folds
tclick: folds
runbich: folds
UIGEA2016: folds
Uncalled bet ($0.05) returned to mrpolelock
mrpolelock collected $0.10 from pot
mrpolelock: doesn't show hand
ultrasii86 said, "lol welcome to the site for me"
*** SUMMARY ***
Total pot $0.10 | Rake $0
Seat 1: runbich (button) folded before Flop (didn't bet)
Seat 2: UIGEA2016 (small blind) folded before Flop
Seat 3: mrpolelock (big blind) collected ($0.10)
Seat 4: tapouttazz9 folded before Flop (didn't bet)
Seat 5: ultrasii86 folded before Flop (didn't bet)
Seat 6: tclick folded before Flop (didn't bet)


PokerStars Hand #157038109262:  Hold'em No Limit ($0.05/$0.10 USD) - 2016/08/16 19:44:47 ET
Table 'Apus' 6-max Seat #2 is the button
Seat 1: runbich ($13.93 in chips)
Seat 2: UIGEA2016 ($9.75 in chips)
Seat 3: mrpolelock ($9.82 in chips)
Seat 4: tapouttazz9 ($12.55 in chips)
Seat 5: ultrasii86 ($0.17 in chips)
Seat 6: tclick ($7.15 in chips)
mrpolelock: posts small blind $0.05
tapouttazz9: posts big blind $0.10
*** HOLE CARDS ***
Dealt to tapouttazz9 [Jd Tc]
ultrasii86: folds
ultrasii86 leaves the table
tclick: folds
runbich: folds
UIGEA2016: folds
mrpolelock: calls $0.05
tapouttazz9: checks
*** FLOP *** [8h 4c 9s]
mrpolelock: bets $0.10
tapouttazz9: calls $0.10
*** TURN *** [8h 4c 9s] [Qd]
mrpolelock: bets $0.10
tapouttazz9: raises $0.30 to $0.40
mrpolelock: folds
Uncalled bet ($0.30) returned to tapouttazz9
tapouttazz9 collected $0.57 from pot
*** SUMMARY ***
Total pot $0.60 | Rake $0.03
Board [8h 4c 9s Qd]
Seat 1: runbich folded before Flop (didn't bet)
Seat 2: UIGEA2016 (button) folded before Flop (didn't bet)
Seat 3: mrpolelock (small blind) folded on the Turn
Seat 4: tapouttazz9 (big blind) collected ($0.57)
Seat 5: ultrasii86 folded before Flop (didn't bet)
Seat 6: tclick folded before Flop (didn't bet)


PokerStars Hand #157038109459:  Hold'em No Limit ($0.05/$0.10 USD) - 2016/08/16 19:45:19 ET
Table 'Apus' 6-max Seat #3 is the button
Seat 2: UIGEA2016 ($9.75 in chips)
Seat 3: mrpolelock ($9.52 in chips)
Seat 4: tapouttazz9 ($12.82 in chips)
tapouttazz9: posts small blind $0.05
tclick: is sitting out
runbich: is sitting out
UIGEA2016: posts big blind $0.10
*** HOLE CARDS ***
Dealt to tapouttazz9 [7h Jh]
mrpolelock: folds
tapouttazz9: folds
Uncalled bet ($0.05) returned to UIGEA2016
gutterdad60 joins the table at seat #5
UIGEA2016 collected $0.10 from pot
UIGEA2016: doesn't show hand
*** SUMMARY ***
Total pot $0.10 | Rake $0
Seat 2: UIGEA2016 (big blind) collected ($0.10)
Seat 3: mrpolelock (button) folded before Flop (didn't bet)
Seat 4: tapouttazz9 (small blind) folded before Flop


PokerStars Hand #157038109486:  Hold'em No Limit ($0.05/$0.10 USD) - 2016/08/16 19:45:24 ET
Table 'Apus' 6-max Seat #4 is the button
Seat 2: UIGEA2016 ($9.80 in chips)
Seat 3: mrpolelock ($9.52 in chips)
Seat 4: tapouttazz9 ($12.77 in chips)
gutterdad60 will be allowed to play after the button
UIGEA2016: posts small blind $0.05
mrpolelock: posts big blind $0.10
*** HOLE CARDS ***
Dealt to tapouttazz9 [Kc Ah]
tapouttazz9: raises $0.20 to $0.30
UIGEA2016 is disconnected
UIGEA2016 has timed out while disconnected
UIGEA2016: folds
mrpolelock: folds
Uncalled bet ($0.20) returned to tapouttazz9
tapouttazz9 collected $0.25 from pot
*** SUMMARY ***
Total pot $0.25 | Rake $0
Seat 2: UIGEA2016 (small blind) folded before Flop
Seat 3: mrpolelock (big blind) folded before Flop
Seat 4: tapouttazz9 (button) collected ($0.25)


PokerStars Hand #157038109665:  Hold'em No Limit ($0.05/$0.10 USD) - 2016/08/16 19:45:55 ET
Table 'Apus' 6-max Seat #3 is the button
Seat 3: mrpolelock ($9.42 in chips)
Seat 4: tapouttazz9 ($12.92 in chips)
Seat 5: gutterdad60 ($8 in chips)
tapouttazz9: posts small blind $0.05
gutterdad60: posts big blind $0.10
tclick: sits out
*** HOLE CARDS ***
Dealt to tapouttazz9 [4s 6d]
mrpolelock: calls $0.10
tapouttazz9: folds
gutterdad60: checks
*** FLOP *** [6c Qs 9s]
gutterdad60: checks
mrpolelock: bets $0.12
gutterdad60: calls $0.12
*** TURN *** [6c Qs 9s] [3s]
gutterdad60: checks
mrpolelock: bets $0.23
gutterdad60: calls $0.23
*** RIVER *** [6c Qs 9s 3s] [Ah]
gutterdad60: checks
mrpolelock: checks
*** SHOW DOWN ***
gutterdad60: shows [Th Jc] (high card Ace)
mrpolelock: shows [5d Kd] (high card Ace - King kicker)
mrpolelock collected $0.90 from pot
*** SUMMARY ***
Total pot $0.95 | Rake $0.05
Board [6c Qs 9s 3s Ah]
Seat 3: mrpolelock (button) showed [5d Kd] and won ($0.90) with high card Ace
Seat 4: tapouttazz9 (small blind) folded before Flop
Seat 5: gutterdad60 (big blind) showed [Th Jc] and lost with high card Ace


PokerStars Hand #157038109849:  Hold'em No Limit ($0.05/$0.10 USD) - 2016/08/16 19:46:25 ET
Table 'Apus' 6-max Seat #4 is the button
Seat 3: mrpolelock ($9.87 in chips)
Seat 4: tapouttazz9 ($12.87 in chips)
Seat 5: gutterdad60 ($7.55 in chips)
Seat 6: tclick ($7.15 in chips)
gutterdad60: posts small blind $0.05
tclick: posts big blind $0.10
*** HOLE CARDS ***
Dealt to tapouttazz9 [7c Th]
mrpolelock: folds
tapouttazz9: folds
gutterdad60: folds
Uncalled bet ($0.05) returned to tclick
tclick collected $0.10 from pot
*** SUMMARY ***
Total pot $0.10 | Rake $0
Seat 3: mrpolelock folded before Flop (didn't bet)
Seat 4: tapouttazz9 (button) folded before Flop (didn't bet)
Seat 5: gutterdad60 (small blind) folded before Flop
Seat 6: tclick (big blind) collected ($0.10)


PokerStars Hand #157038109900:  Hold'em No Limit ($0.05/$0.10 USD) - 2016/08/16 19:46:34 ET
Table 'Apus' 6-max Seat #5 is the button
Seat 3: mrpolelock ($9.87 in chips)
Seat 4: tapouttazz9 ($12.87 in chips)
Seat 5: gutterdad60 ($7.50 in chips)
Seat 6: tclick ($7.20 in chips)
tclick: posts small blind $0.05
mrpolelock: posts big blind $0.10
*** HOLE CARDS ***
Dealt to tapouttazz9 [3h 8d]
tapouttazz9: folds
gutterdad60: folds
tclick: calls $0.05
mrpolelock: raises $0.20 to $0.30
tclick: folds
Uncalled bet ($0.20) returned to mrpolelock
mrpolelock collected $0.20 from pot
mrpolelock: doesn't show hand
*** SUMMARY ***
Total pot $0.20 | Rake $0
Seat 3: mrpolelock (big blind) collected ($0.20)
Seat 4: tapouttazz9 folded before Flop (didn't bet)
Seat 5: gutterdad60 (button) folded before Flop (didn't bet)
Seat 6: tclick (small blind) folded before Flop


PokerStars Hand #157038109978:  Hold'em No Limit ($0.05/$0.10 USD) - 2016/08/16 19:46:46 ET
Table 'Apus' 6-max Seat #6 is the button
Seat 3: mrpolelock ($9.97 in chips)
Seat 4: tapouttazz9 ($12.87 in chips)
Seat 5: gutterdad60 ($7.50 in chips)
Seat 6: tclick ($7.10 in chips)
UIGEA2016 will be allowed to play after the button
mrpolelock: posts small blind $0.05
tapouttazz9: posts big blind $0.10
*** HOLE CARDS ***
Dealt to tapouttazz9 [Tc 8d]
gutterdad60: folds
tclick: folds
mrpolelock: calls $0.05
tapouttazz9: checks
*** FLOP *** [7d 4h 5s]
mrpolelock: bets $0.10
tapouttazz9: calls $0.10
*** TURN *** [7d 4h 5s] [5c]
mrpolelock: bets $0.10
tapouttazz9: calls $0.10
*** RIVER *** [7d 4h 5s 5c] [9s]
mrpolelock: bets $0.10
tapouttazz9: folds
Uncalled bet ($0.10) returned to mrpolelock
mrpolelock collected $0.57 from pot
mrpolelock: doesn't show hand
*** SUMMARY ***
Total pot $0.60 | Rake $0.03
Board [7d 4h 5s 5c 9s]
Seat 3: mrpolelock (small blind) collected ($0.57)
Seat 4: tapouttazz9 (big blind) folded on the River
Seat 5: gutterdad60 folded before Flop (didn't bet)
Seat 6: tclick (button) folded before Flop (didn't bet)


PokerStars Hand #157038236355:  Hold'em No Limit ($0.05/$0.10 USD) - 2016/08/16 19:47:16 ET
Table 'Apus' 6-max Seat #3 is the button
Seat 3: mrpolelock ($10.24 in chips)
Seat 4: tapouttazz9 ($12.57 in chips)
Seat 5: gutterdad60 ($7.50 in chips)
Seat 6: tclick ($7.10 in chips)
tapouttazz9: posts small blind $0.05
gutterdad60: posts big blind $0.10
UIGEA2016: sits out
*** HOLE CARDS ***
Dealt to tapouttazz9 [Td Ah]
tclick: folds
mrpolelock: folds
tapouttazz9: raises $0.20 to $0.30
gutterdad60: folds
Uncalled bet ($0.20) returned to tapouttazz9
tapouttazz9 collected $0.20 from pot
*** SUMMARY ***
Total pot $0.20 | Rake $0
Seat 3: mrpolelock (button) folded before Flop (didn't bet)
Seat 4: tapouttazz9 (small blind) collected ($0.20)
Seat 5: gutterdad60 (big blind) folded before Flop
Seat 6: tclick folded before Flop (didn't bet)


PokerStars Hand #157038236443:  Hold'em No Limit ($0.05/$0.10 USD) - 2016/08/16 19:47:30 ET
Table 'Apus' 6-max Seat #4 is the button
Seat 3: mrpolelock ($10.24 in chips)
Seat 4: tapouttazz9 ($12.67 in chips)
Seat 5: gutterdad60 ($7.40 in chips)
Seat 6: tclick ($7.10 in chips)
gutterdad60: posts small blind $0.05
tclick: posts big blind $0.10
UIGEA2016: sits out
*** HOLE CARDS ***
Dealt to tapouttazz9 [4c 4d]
mrpolelock: folds
tapouttazz9: raises $0.20 to $0.30
gutterdad60: folds
tclick: folds
Uncalled bet ($0.20) returned to tapouttazz9
tapouttazz9 collected $0.25 from pot
*** SUMMARY ***
Total pot $0.25 | Rake $0
Seat 3: mrpolelock folded before Flop (didn't bet)
Seat 4: tapouttazz9 (button) collected ($0.25)
Seat 5: gutterdad60 (small blind) folded before Flop
Seat 6: tclick (big blind) folded before Flop


PokerStars Hand #157038236530:  Hold'em No Limit ($0.05/$0.10 USD) - 2016/08/16 19:47:43 ET
Table 'Apus' 6-max Seat #5 is the button
Seat 2: UIGEA2016 ($9.75 in chips)
Seat 3: mrpolelock ($10.24 in chips)
Seat 4: tapouttazz9 ($12.82 in chips)
Seat 5: gutterdad60 ($7.35 in chips)
Seat 6: tclick ($7 in chips)
tclick: posts small blind $0.05
UIGEA2016: posts big blind $0.10
*** HOLE CARDS ***
Dealt to tapouttazz9 [2c As]
mrpolelock: folds
tapouttazz9: folds
gutterdad60: folds
tclick: folds
Uncalled bet ($0.05) returned to UIGEA2016
UIGEA2016 collected $0.10 from pot
UIGEA2016: doesn't show hand
*** SUMMARY ***
Total pot $0.10 | Rake $0
Seat 2: UIGEA2016 (big blind) collected ($0.10)
Seat 3: mrpolelock folded before Flop (didn't bet)
Seat 4: tapouttazz9 folded before Flop (didn't bet)
Seat 5: gutterdad60 (button) folded before Flop (didn't bet)
Seat 6: tclick (small blind) folded before Flop


PokerStars Hand #157038236561:  Hold'em No Limit ($0.05/$0.10 USD) - 2016/08/16 19:47:50 ET
Table 'Apus' 6-max Seat #6 is the button
Seat 2: UIGEA2016 ($9.80 in chips)
Seat 3: mrpolelock ($10.24 in chips)
Seat 4: tapouttazz9 ($12.82 in chips)
Seat 5: gutterdad60 ($7.35 in chips)
Seat 6: tclick ($6.95 in chips)
UIGEA2016: posts small blind $0.05
mrpolelock: posts big blind $0.10
*** HOLE CARDS ***
Dealt to tapouttazz9 [3c 3h]
tapouttazz9: calls $0.10
gutterdad60: calls $0.10
tclick: calls $0.10
UIGEA2016: folds
mrpolelock: checks
*** FLOP *** [9d Jd Tc]
mrpolelock: checks
tapouttazz9: checks
gutterdad60: checks
tclick: bets $0.60
mrpolelock: folds
tapouttazz9: folds
gutterdad60: calls $0.60
*** TURN *** [9d Jd Tc] [4d]
gutterdad60: checks
runbich leaves the table
tclick: checks
*** RIVER *** [9d Jd Tc 4d] [7c]
gutterdad60: checks
tclick: checks
*** SHOW DOWN ***
gutterdad60: shows [Th Qs] (a pair of Tens)
tclick: shows [Js 9s] (two pair, Jacks and Nines)
tclick collected $1.57 from pot
*** SUMMARY ***
Total pot $1.65 | Rake $0.08
Board [9d Jd Tc 4d 7c]
Seat 2: UIGEA2016 (small blind) folded before Flop
Seat 3: mrpolelock (big blind) folded on the Flop
Seat 4: tapouttazz9 folded on the Flop
Seat 5: gutterdad60 showed [Th Qs] and lost with a pair of Tens
Seat 6: tclick (button) showed [Js 9s] and won ($1.57) with two pair, Jacks and Nines


PokerStars Hand #157038236828:  Hold'em No Limit ($0.05/$0.10 USD) - 2016/08/16 19:48:34 ET
Table 'Apus' 6-max Seat #2 is the button
Seat 2: UIGEA2016 ($9.75 in chips)
Seat 3: mrpolelock ($10.14 in chips)
Seat 4: tapouttazz9 ($12.72 in chips)
Seat 5: gutterdad60 ($6.65 in chips)
Seat 6: tclick ($7.82 in chips)
mrpolelock: posts small blind $0.05
tapouttazz9: posts big blind $0.10
*** HOLE CARDS ***
Dealt to tapouttazz9 [8h 8c]
gutterdad60: folds
tclick: calls $0.10
UIGEA2016: calls $0.10
mrpolelock: calls $0.05
tapouttazz9: checks
*** FLOP *** [Qd Ks As]
mrpolelock: checks
tapouttazz9: bets $0.19
tclick: folds
scrapmetal9 joins the table at seat #1
UIGEA2016: folds
mrpolelock: folds
Uncalled bet ($0.19) returned to tapouttazz9
tapouttazz9 collected $0.38 from pot
*** SUMMARY ***
Total pot $0.40 | Rake $0.02
Board [Qd Ks As]
Seat 2: UIGEA2016 (button) folded on the Flop
Seat 3: mrpolelock (small blind) folded on the Flop
Seat 4: tapouttazz9 (big blind) collected ($0.38)
Seat 5: gutterdad60 folded before Flop (didn't bet)
Seat 6: tclick folded on the Flop


PokerStars Hand #157038237049:  Hold'em No Limit ($0.05/$0.10 USD) - 2016/08/16 19:49:11 ET
Table 'Apus' 6-max Seat #3 is the button
Seat 2: UIGEA2016 ($9.65 in chips)
Seat 3: mrpolelock ($10.04 in chips)
Seat 4: tapouttazz9 ($13 in chips)
Seat 6: tclick ($7.72 in chips)
tapouttazz9: posts small blind $0.05
tclick: posts big blind $0.10
scrapmetal9: sits out
*** HOLE CARDS ***
Dealt to tapouttazz9 [Ks 4h]
UIGEA2016: folds
mrpolelock: folds
tapouttazz9: folds
Uncalled bet ($0.05) returned to tclick
tclick collected $0.10 from pot
*** SUMMARY ***
Total pot $0.10 | Rake $0
Seat 2: UIGEA2016 folded before Flop (didn't bet)
Seat 3: mrpolelock (button) folded before Flop (didn't bet)
Seat 4: tapouttazz9 (small blind) folded before Flop
Seat 6: tclick (big blind) collected ($0.10)


PokerStars Hand #157038237075:  Hold'em No Limit ($0.05/$0.10 USD) - 2016/08/16 19:49:17 ET
Table 'Apus' 6-max Seat #4 is the button
Seat 1: scrapmetal9 ($8 in chips)
Seat 2: UIGEA2016 ($9.65 in chips)
Seat 3: mrpolelock ($10.04 in chips)
Seat 4: tapouttazz9 ($12.95 in chips)
Seat 6: tclick ($7.77 in chips)
tclick: posts small blind $0.05
scrapmetal9: posts big blind $0.10
*** HOLE CARDS ***
Dealt to tapouttazz9 [Ac 2c]
UIGEA2016: folds
mrpolelock: folds
tapouttazz9: raises $0.20 to $0.30
tclick: folds
scrapmetal9: calls $0.20
*** FLOP *** [9d Ad 2d]
scrapmetal9: checks
tapouttazz9: bets $0.40
scrapmetal9: folds
Uncalled bet ($0.40) returned to tapouttazz9
tapouttazz9 collected $0.62 from pot
*** SUMMARY ***
Total pot $0.65 | Rake $0.03
Board [9d Ad 2d]
Seat 1: scrapmetal9 (big blind) folded on the Flop
Seat 2: UIGEA2016 folded before Flop (didn't bet)
Seat 3: mrpolelock folded before Flop (didn't bet)
Seat 4: tapouttazz9 (button) collected ($0.62)
Seat 6: tclick (small blind) folded before Flop


PokerStars Hand #157038237218:  Hold'em No Limit ($0.05/$0.10 USD) - 2016/08/16 19:49:42 ET
Table 'Apus' 6-max Seat #6 is the button
Seat 1: scrapmetal9 ($7.70 in chips)
Seat 2: UIGEA2016 ($9.65 in chips)
Seat 3: mrpolelock ($10.04 in chips)
Seat 4: tapouttazz9 ($13.27 in chips)
Seat 6: tclick ($7.72 in chips)
scrapmetal9: posts small blind $0.05
UIGEA2016: posts big blind $0.10
*** HOLE CARDS ***
Dealt to tapouttazz9 [Ts Js]
mrpolelock: folds
tapouttazz9: raises $0.10 to $0.20
tclick: raises $0.10 to $0.30
scrapmetal9: calls $0.25
UIGEA2016: folds
tapouttazz9: calls $0.10
*** FLOP *** [7c 5c 2c]
scrapmetal9: checks
tapouttazz9: checks
tclick: bets $0.95
scrapmetal9: folds
tapouttazz9: folds
Uncalled bet ($0.95) returned to tclick
tclick collected $0.95 from pot
*** SUMMARY ***
Total pot $1 | Rake $0.05
Board [7c 5c 2c]
Seat 1: scrapmetal9 (small blind) folded on the Flop
Seat 2: UIGEA2016 (big blind) folded before Flop
Seat 3: mrpolelock folded before Flop (didn't bet)
Seat 4: tapouttazz9 folded on the Flop
Seat 6: tclick (button) collected ($0.95)


PokerStars Hand #157038237371:  Hold'em No Limit ($0.05/$0.10 USD) - 2016/08/16 19:50:09 ET
Table 'Apus' 6-max Seat #1 is the button
Seat 1: scrapmetal9 ($7.40 in chips)
Seat 2: UIGEA2016 ($9.55 in chips)
Seat 3: mrpolelock ($10.04 in chips)
Seat 4: tapouttazz9 ($12.97 in chips)
Seat 6: tclick ($8.37 in chips)
UIGEA2016: posts small blind $0.05
mrpolelock: posts big blind $0.10
*** HOLE CARDS ***
Dealt to tapouttazz9 [7d Ks]
tapouttazz9: folds
tclick: calls $0.10
scrapmetal9: raises $0.35 to $0.45
UIGEA2016: folds
mrpolelock: folds
tclick: folds
Uncalled bet ($0.35) returned to scrapmetal9
scrapmetal9 collected $0.35 from pot
scrapmetal9: doesn't show hand
*** SUMMARY ***
Total pot $0.35 | Rake $0
Seat 1: scrapmetal9 (button) collected ($0.35)
Seat 2: UIGEA2016 (small blind) folded before Flop
Seat 3: mrpolelock (big blind) folded before Flop
Seat 4: tapouttazz9 folded before Flop (didn't bet)
Seat 6: tclick folded before Flop


PokerStars Hand #157038237466:  Hold'em No Limit ($0.05/$0.10 USD) - 2016/08/16 19:50:25 ET
Table 'Apus' 6-max Seat #2 is the button
Seat 1: scrapmetal9 ($7.65 in chips)
Seat 2: UIGEA2016 ($9.50 in chips)
Seat 3: mrpolelock ($9.94 in chips)
Seat 4: tapouttazz9 ($12.97 in chips)
Seat 6: tclick ($8.27 in chips)
mrpolelock: posts small blind $0.05
tapouttazz9: posts big blind $0.10
*** HOLE CARDS ***
Dealt to tapouttazz9 [Qh 8d]
tclick: folds
scrapmetal9: raises $0.25 to $0.35
UIGEA2016: calls $0.35
mrpolelock: folds
tapouttazz9: calls $0.25
*** FLOP *** [8s 6d Jd]
tapouttazz9: checks
scrapmetal9: bets $1.20
UIGEA2016: folds
tapouttazz9: folds
Uncalled bet ($1.20) returned to scrapmetal9
scrapmetal9 collected $1.04 from pot
scrapmetal9: doesn't show hand
*** SUMMARY ***
Total pot $1.10 | Rake $0.06
Board [8s 6d Jd]
Seat 1: scrapmetal9 collected ($1.04)
Seat 2: UIGEA2016 (button) folded on the Flop
Seat 3: mrpolelock (small blind) folded before Flop
Seat 4: tapouttazz9 (big blind) folded on the Flop
Seat 6: tclick folded before Flop (didn't bet)


PokerStars Hand #157038237652:  Hold'em No Limit ($0.05/$0.10 USD) - 2016/08/16 19:50:59 ET
Table 'Apus' 6-max Seat #3 is the button
Seat 1: scrapmetal9 ($8.34 in chips)
Seat 2: UIGEA2016 ($9.15 in chips)
Seat 3: mrpolelock ($9.89 in chips)
Seat 4: tapouttazz9 ($12.62 in chips)
Seat 5: gutterdad60 ($6.71 in chips)
Seat 6: tclick ($8.27 in chips)
tapouttazz9: posts small blind $0.05
gutterdad60: posts big blind $0.10
*** HOLE CARDS ***
Dealt to tapouttazz9 [Qd As]
tclick: calls $0.10
scrapmetal9: calls $0.10
UIGEA2016: folds
mrpolelock: folds
tapouttazz9: raises $0.20 to $0.30
gutterdad60: folds
tclick: raises $0.20 to $0.50
scrapmetal9: folds
tapouttazz9: calls $0.20
*** FLOP *** [Js 3c Qh]
tapouttazz9: checks
tclick: bets $1.50
tapouttazz9: calls $1.50
*** TURN *** [Js 3c Qh] [2s]
tapouttazz9: checks
tclick: bets $2.10
tapouttazz9: raises $8.19 to $10.29
tclick: calls $4.17 and is all-in
Uncalled bet ($4.02) returned to tapouttazz9
*** RIVER *** [Js 3c Qh 2s] [6d]
*** SHOW DOWN ***
tapouttazz9: shows [Qd As] (a pair of Queens)
tclick: shows [Ad Ac] (a pair of Aces)
tclick collected $15.90 from pot
*** SUMMARY ***
Total pot $16.74 | Rake $0.84
Board [Js 3c Qh 2s 6d]
Seat 1: scrapmetal9 folded before Flop
Seat 2: UIGEA2016 folded before Flop (didn't bet)
Seat 3: mrpolelock (button) folded before Flop (didn't bet)
Seat 4: tapouttazz9 (small blind) showed [Qd As] and lost with a pair of Queens
Seat 5: gutterdad60 (big blind) folded before Flop
Seat 6: tclick showed [Ad Ac] and won ($15.90) with a pair of Aces


PokerStars Hand #157038238052:  Hold'em No Limit ($0.05/$0.10 USD) - 2016/08/16 19:52:06 ET
Table 'Apus' 6-max Seat #4 is the button
Seat 1: scrapmetal9 ($8.24 in chips)
Seat 2: UIGEA2016 ($9.15 in chips)
Seat 3: mrpolelock ($9.89 in chips)
Seat 4: tapouttazz9 ($4.35 in chips)
Seat 5: gutterdad60 ($6.61 in chips)
Seat 6: tclick ($15.90 in chips)
gutterdad60: posts small blind $0.05
tclick: posts big blind $0.10
*** HOLE CARDS ***
Dealt to tapouttazz9 [5d Jd]
scrapmetal9: calls $0.10
UIGEA2016: folds
mrpolelock: raises $0.20 to $0.30
tapouttazz9: folds
gutterdad60: calls $0.25
tclick: folds
scrapmetal9: calls $0.20
*** FLOP *** [2h 7h Qh]
gutterdad60: checks
scrapmetal9: bets $0.90
mrpolelock: calls $0.90
gutterdad60: folds
*** TURN *** [2h 7h Qh] [9c]
scrapmetal9: checks
mrpolelock: bets $1.33
scrapmetal9: folds
Uncalled bet ($1.33) returned to mrpolelock
mrpolelock collected $2.66 from pot
mrpolelock: doesn't show hand
*** SUMMARY ***
Total pot $2.80 | Rake $0.14
Board [2h 7h Qh 9c]
Seat 1: scrapmetal9 folded on the Turn
Seat 2: UIGEA2016 folded before Flop (didn't bet)
Seat 3: mrpolelock collected ($2.66)
Seat 4: tapouttazz9 (button) folded before Flop (didn't bet)
Seat 5: gutterdad60 (small blind) folded on the Flop
Seat 6: tclick (big blind) folded before Flop


PokerStars Hand #157038238385:  Hold'em No Limit ($0.05/$0.10 USD) - 2016/08/16 19:53:03 ET
Table 'Apus' 6-max Seat #5 is the button
Seat 1: scrapmetal9 ($7.04 in chips)
Seat 2: UIGEA2016 ($9.15 in chips)
Seat 3: mrpolelock ($11.35 in chips)
Seat 4: tapouttazz9 ($10 in chips)
Seat 5: gutterdad60 ($6.31 in chips)
Seat 6: tclick ($15.80 in chips)
tclick: posts small blind $0.05
scrapmetal9: posts big blind $0.10
*** HOLE CARDS ***
Dealt to tapouttazz9 [7c Th]
UIGEA2016: folds
mrpolelock: raises $0.20 to $0.30
tapouttazz9: folds
gutterdad60: folds
tclick: calls $0.25
scrapmetal9: folds
*** FLOP *** [4c 3h 6c]
tclick: bets $0.33
mrpolelock: calls $0.33
*** TURN *** [4c 3h 6c] [5h]
tclick: checks
mrpolelock: bets $0.64
tclick: calls $0.64
*** RIVER *** [4c 3h 6c 5h] [Kh]
tclick: checks
mrpolelock: bets $1.25
tclick: folds
Uncalled bet ($1.25) returned to mrpolelock
mrpolelock collected $2.51 from pot
mrpolelock: doesn't show hand
*** SUMMARY ***
Total pot $2.64 | Rake $0.13
Board [4c 3h 6c 5h Kh]
Seat 1: scrapmetal9 (big blind) folded before Flop
Seat 2: UIGEA2016 folded before Flop (didn't bet)
Seat 3: mrpolelock collected ($2.51)
Seat 4: tapouttazz9 folded before Flop (didn't bet)
Seat 5: gutterdad60 (button) folded before Flop (didn't bet)
Seat 6: tclick (small blind) folded on the River


PokerStars Hand #157038238737:  Hold'em No Limit ($0.05/$0.10 USD) - 2016/08/16 19:54:05 ET
Table 'Apus' 6-max Seat #6 is the button
Seat 1: scrapmetal9 ($6.94 in chips)
Seat 3: mrpolelock ($12.59 in chips)
Seat 4: tapouttazz9 ($10 in chips)
Seat 5: gutterdad60 ($6.31 in chips)
Seat 6: tclick ($14.53 in chips)
scrapmetal9: posts small blind $0.05
UIGEA2016: is sitting out
mrpolelock: posts big blind $0.10
*** HOLE CARDS ***
Dealt to tapouttazz9 [Td Ah]
UIGEA2016 leaves the table
tapouttazz9: raises $0.20 to $0.30
gutterdad60: folds
tclick: folds
scrapmetal9: calls $0.25
mrpolelock: folds
*** FLOP *** [6d As Js]
scrapmetal9: checks
tapouttazz9: bets $0.33
scrapmetal9: folds
Uncalled bet ($0.33) returned to tapouttazz9
alphabae00 joins the table at seat #2
tapouttazz9 collected $0.66 from pot
*** SUMMARY ***
Total pot $0.70 | Rake $0.04
Board [6d As Js]
Seat 1: scrapmetal9 (small blind) folded on the Flop
Seat 3: mrpolelock (big blind) folded before Flop
Seat 4: tapouttazz9 collected ($0.66)
Seat 5: gutterdad60 folded before Flop (didn't bet)
Seat 6: tclick (button) folded before Flop (didn't bet)


PokerStars Hand #157038238921:  Hold'em No Limit ($0.05/$0.10 USD) - 2016/08/16 19:54:35 ET
Table 'Apus' 6-max Seat #1 is the button
Seat 1: scrapmetal9 ($6.64 in chips)
Seat 3: mrpolelock ($12.49 in chips)
Seat 4: tapouttazz9 ($10.36 in chips)
Seat 5: gutterdad60 ($6.31 in chips)
Seat 6: tclick ($14.53 in chips)
alphabae00 will be allowed to play after the button
mrpolelock: posts small blind $0.05
tapouttazz9: posts big blind $0.10
*** HOLE CARDS ***
Dealt to tapouttazz9 [Qh 7c]
gutterdad60: folds
tclick: folds
scrapmetal9: folds
mrpolelock: calls $0.05
tapouttazz9: checks
*** FLOP *** [7d 7s 4d]
mrpolelock: checks
tapouttazz9: bets $0.19
mrpolelock: folds
Uncalled bet ($0.19) returned to tapouttazz9
tapouttazz9 collected $0.19 from pot
*** SUMMARY ***
Total pot $0.20 | Rake $0.01
Board [7d 7s 4d]
Seat 1: scrapmetal9 (button) folded before Flop (didn't bet)
Seat 3: mrpolelock (small blind) folded on the Flop
Seat 4: tapouttazz9 (big blind) collected ($0.19)
Seat 5: gutterdad60 folded before Flop (didn't bet)
Seat 6: tclick folded before Flop (didn't bet)


PokerStars Hand #157038239055:  Hold'em No Limit ($0.05/$0.10 USD) - 2016/08/16 19:54:55 ET
Table 'Apus' 6-max Seat #3 is the button
Seat 1: scrapmetal9 ($6.64 in chips)
Seat 3: mrpolelock ($12.39 in chips)
Seat 4: tapouttazz9 ($10.45 in chips)
Seat 5: gutterdad60 ($6.31 in chips)
Seat 6: tclick ($14.53 in chips)
tapouttazz9: posts small blind $0.05
gutterdad60: posts big blind $0.10
alphabae00: sits out
*** HOLE CARDS ***
Dealt to tapouttazz9 [Td 6s]
tclick: folds
scrapmetal9: calls $0.10
mrpolelock: calls $0.10
tapouttazz9: folds
gutterdad60: checks
*** FLOP *** [6d 9c Ks]
gutterdad60: checks
scrapmetal9: bets $0.30
mrpolelock: folds
gutterdad60: folds
Uncalled bet ($0.30) returned to scrapmetal9
scrapmetal9 collected $0.33 from pot
scrapmetal9: doesn't show hand
*** SUMMARY ***
Total pot $0.35 | Rake $0.02
Board [6d 9c Ks]
Seat 1: scrapmetal9 collected ($0.33)
Seat 3: mrpolelock (button) folded on the Flop
Seat 4: tapouttazz9 (small blind) folded before Flop
Seat 5: gutterdad60 (big blind) folded on the Flop
Seat 6: tclick folded before Flop (didn't bet)


PokerStars Hand #157038239250:  Hold'em No Limit ($0.05/$0.10 USD) - 2016/08/16 19:55:33 ET
Table 'Apus' 6-max Seat #4 is the button
Seat 1: scrapmetal9 ($6.87 in chips)
Seat 3: mrpolelock ($12.29 in chips)
Seat 4: tapouttazz9 ($10.40 in chips)
Seat 5: gutterdad60 ($6.21 in chips)
Seat 6: tclick ($14.53 in chips)
gutterdad60: posts small blind $0.05
tclick: posts big blind $0.10
alphabae00: sits out
*** HOLE CARDS ***
Dealt to tapouttazz9 [7c 9c]
scrapmetal9: folds
mrpolelock: folds
tapouttazz9: folds
gutterdad60: calls $0.05
tclick: checks
*** FLOP *** [8d 5c 4h]
gutterdad60: checks
tclick: checks
*** TURN *** [8d 5c 4h] [Kc]
gutterdad60: checks
tclick: checks
*** RIVER *** [8d 5c 4h Kc] [Ah]
gutterdad60: bets $0.10
tclick: folds
Uncalled bet ($0.10) returned to gutterdad60
gutterdad60 collected $0.19 from pot
gutterdad60: doesn't show hand
*** SUMMARY ***
Total pot $0.20 | Rake $0.01
Board [8d 5c 4h Kc Ah]
Seat 1: scrapmetal9 folded before Flop (didn't bet)
Seat 3: mrpolelock folded before Flop (didn't bet)
Seat 4: tapouttazz9 (button) folded before Flop (didn't bet)
Seat 5: gutterdad60 (small blind) collected ($0.19)
Seat 6: tclick (big blind) folded on the River


PokerStars Hand #157038239504:  Hold'em No Limit ($0.05/$0.10 USD) - 2016/08/16 19:56:23 ET
Table 'Apus' 6-max Seat #5 is the button
Seat 1: scrapmetal9 ($6.87 in chips)
Seat 3: mrpolelock ($12.29 in chips)
Seat 4: tapouttazz9 ($10.40 in chips)
Seat 5: gutterdad60 ($6.30 in chips)
Seat 6: tclick ($14.43 in chips)
tclick: posts small blind $0.05
scrapmetal9: posts big blind $0.10
alphabae00: sits out
*** HOLE CARDS ***
Dealt to tapouttazz9 [9c 4h]
mrpolelock: folds
tapouttazz9: folds
gutterdad60: folds
tclick: folds
Uncalled bet ($0.05) returned to scrapmetal9
scrapmetal9 collected $0.10 from pot
scrapmetal9: doesn't show hand
*** SUMMARY ***
Total pot $0.10 | Rake $0
Seat 1: scrapmetal9 (big blind) collected ($0.10)
Seat 3: mrpolelock folded before Flop (didn't bet)
Seat 4: tapouttazz9 folded before Flop (didn't bet)
Seat 5: gutterdad60 (button) folded before Flop (didn't bet)
Seat 6: tclick (small blind) folded before Flop


PokerStars Hand #157038239611:  Hold'em No Limit ($0.05/$0.10 USD) - 2016/08/16 19:56:44 ET
Table 'Apus' 6-max Seat #6 is the button
Seat 1: scrapmetal9 ($6.92 in chips)
Seat 2: alphabae00 ($8 in chips)
Seat 3: mrpolelock ($12.29 in chips)
Seat 4: tapouttazz9 ($10.40 in chips)
Seat 5: gutterdad60 ($6.30 in chips)
Seat 6: tclick ($14.38 in chips)
scrapmetal9: posts small blind $0.05
alphabae00: posts big blind $0.10
*** HOLE CARDS ***
Dealt to tapouttazz9 [2c 3c]
mrpolelock: folds
tapouttazz9: folds
gutterdad60: folds
tclick: raises $0.10 to $0.20
scrapmetal9: raises $0.50 to $0.70
alphabae00: folds
tclick: calls $0.50
*** FLOP *** [7h 5h Qs]
scrapmetal9: bets $1.40
tclick: folds
Uncalled bet ($1.40) returned to scrapmetal9
scrapmetal9 collected $1.42 from pot
scrapmetal9: doesn't show hand
*** SUMMARY ***
Total pot $1.50 | Rake $0.08
Board [7h 5h Qs]
Seat 1: scrapmetal9 (small blind) collected ($1.42)
Seat 2: alphabae00 (big blind) folded before Flop
Seat 3: mrpolelock folded before Flop (didn't bet)
Seat 4: tapouttazz9 folded before Flop (didn't bet)
Seat 5: gutterdad60 folded before Flop (didn't bet)
Seat 6: tclick (button) folded on the Flop


PokerStars Hand #157038239758:  Hold'em No Limit ($0.05/$0.10 USD) - 2016/08/16 19:57:14 ET
Table 'Apus' 6-max Seat #1 is the button
Seat 1: scrapmetal9 ($7.64 in chips)
Seat 2: alphabae00 ($7.90 in chips)
Seat 3: mrpolelock ($12.29 in chips)
Seat 4: tapouttazz9 ($10.40 in chips)
Seat 5: gutterdad60 ($6.30 in chips)
Seat 6: tclick ($13.68 in chips)
alphabae00: posts small blind $0.05
mrpolelock: posts big blind $0.10
*** HOLE CARDS ***
Dealt to tapouttazz9 [5d 5c]
tapouttazz9: raises $0.10 to $0.20
gutterdad60: folds
tclick: folds
scrapmetal9: calls $0.20
alphabae00: folds
mrpolelock: calls $0.10
*** FLOP *** [3d 6h As]
mrpolelock: checks
tapouttazz9: checks
scrapmetal9: checks
*** TURN *** [3d 6h As] [Js]
mrpolelock: checks
tapouttazz9: checks
scrapmetal9: bets $0.60
mrpolelock: folds
tapouttazz9: folds
Uncalled bet ($0.60) returned to scrapmetal9
scrapmetal9 collected $0.62 from pot
scrapmetal9: doesn't show hand
*** SUMMARY ***
Total pot $0.65 | Rake $0.03
Board [3d 6h As Js]
Seat 1: scrapmetal9 (button) collected ($0.62)
Seat 2: alphabae00 (small blind) folded before Flop
Seat 3: mrpolelock (big blind) folded on the Turn
Seat 4: tapouttazz9 folded on the Turn
Seat 5: gutterdad60 folded before Flop (didn't bet)
Seat 6: tclick folded before Flop (didn't bet)


PokerStars Hand #157038239975:  Hold'em No Limit ($0.05/$0.10 USD) - 2016/08/16 19:57:58 ET
Table 'Apus' 6-max Seat #2 is the button
Seat 1: scrapmetal9 ($8.06 in chips)
Seat 2: alphabae00 ($7.85 in chips)
Seat 3: mrpolelock ($12.09 in chips)
Seat 4: tapouttazz9 ($10.20 in chips)
Seat 5: gutterdad60 ($6.30 in chips)
Seat 6: tclick ($13.68 in chips)
mrpolelock: posts small blind $0.05
tapouttazz9: posts big blind $0.10
*** HOLE CARDS ***
Dealt to tapouttazz9 [7s Qs]
gutterdad60: folds
tclick: folds
scrapmetal9: folds
alphabae00: folds
mrpolelock: calls $0.05
tapouttazz9: checks
*** FLOP *** [Ah Qd Qh]
mrpolelock: bets $0.10
tapouttazz9: calls $0.10
*** TURN *** [Ah Qd Qh] [5c]
mrpolelock: bets $0.10
tapouttazz9: raises $0.60 to $0.70
mrpolelock: folds
Uncalled bet ($0.60) returned to tapouttazz9
tapouttazz9 collected $0.57 from pot
*** SUMMARY ***
Total pot $0.60 | Rake $0.03
Board [Ah Qd Qh 5c]
Seat 1: scrapmetal9 folded before Flop (didn't bet)
Seat 2: alphabae00 (button) folded before Flop (didn't bet)
Seat 3: mrpolelock (small blind) folded on the Turn
Seat 4: tapouttazz9 (big blind) collected ($0.57)
Seat 5: gutterdad60 folded before Flop (didn't bet)
Seat 6: tclick folded before Flop (didn't bet)


PokerStars Hand #157038756329:  Hold'em No Limit ($0.05/$0.10 USD) - 2016/08/16 19:58:28 ET
Table 'Apus' 6-max Seat #3 is the button
Seat 1: scrapmetal9 ($8.06 in chips)
Seat 2: alphabae00 ($7.85 in chips)
Seat 3: mrpolelock ($11.79 in chips)
Seat 4: tapouttazz9 ($10.47 in chips)
Seat 5: gutterdad60 ($6.30 in chips)
Seat 6: tclick ($13.68 in chips)
tapouttazz9: posts small blind $0.05
gutterdad60: posts big blind $0.10
*** HOLE CARDS ***
Dealt to tapouttazz9 [4s 3h]
tclick: folds
scrapmetal9: folds
alphabae00: folds
mrpolelock: raises $0.20 to $0.30
tapouttazz9: folds
gutterdad60: calls $0.20
*** FLOP *** [Jc 9h Ks]
gutterdad60: checks
mrpolelock: bets $0.31
gutterdad60: folds
Uncalled bet ($0.31) returned to mrpolelock
mrpolelock collected $0.62 from pot
mrpolelock: doesn't show hand
*** SUMMARY ***
Total pot $0.65 | Rake $0.03
Board [Jc 9h Ks]
Seat 1: scrapmetal9 folded before Flop (didn't bet)
Seat 2: alphabae00 folded before Flop (didn't bet)
Seat 3: mrpolelock (button) collected ($0.62)
Seat 4: tapouttazz9 (small blind) folded before Flop
Seat 5: gutterdad60 (big blind) folded on the Flop
Seat 6: tclick folded before Flop (didn't bet)


PokerStars Hand #157038756536:  Hold'em No Limit ($0.05/$0.10 USD) - 2016/08/16 19:59:09 ET
Table 'Apus' 6-max Seat #4 is the button
Seat 1: scrapmetal9 ($8.06 in chips)
Seat 2: alphabae00 ($7.85 in chips)
Seat 3: mrpolelock ($12.11 in chips)
Seat 4: tapouttazz9 ($10.42 in chips)
Seat 5: gutterdad60 ($6 in chips)
Seat 6: tclick ($13.68 in chips)
gutterdad60: posts small blind $0.05
tclick: posts big blind $0.10
*** HOLE CARDS ***
Dealt to tapouttazz9 [Qh Ah]
scrapmetal9: folds
alphabae00: folds
mrpolelock: calls $0.10
tapouttazz9: raises $0.20 to $0.30
scrapmetal9 leaves the table
gutterdad60: folds
tclick: folds
mrpolelock: calls $0.20
*** FLOP *** [5h 6h 3h]
mrpolelock: bets $0.35
tapouttazz9: raises $0.35 to $0.70
mrpolelock: calls $0.35
*** TURN *** [5h 6h 3h] [8d]
mrpolelock: checks
tapouttazz9: bets $3.40
mrpolelock: folds
Uncalled bet ($3.40) returned to tapouttazz9
tapouttazz9 collected $2.04 from pot
*** SUMMARY ***
Total pot $2.15 | Rake $0.11
Board [5h 6h 3h 8d]
Seat 1: scrapmetal9 folded before Flop (didn't bet)
Seat 2: alphabae00 folded before Flop (didn't bet)
Seat 3: mrpolelock folded on the Turn
Seat 4: tapouttazz9 (button) collected ($2.04)
Seat 5: gutterdad60 (small blind) folded before Flop
Seat 6: tclick (big blind) folded before Flop


PokerStars Hand #157038756672:  Hold'em No Limit ($0.05/$0.10 USD) - 2016/08/16 19:59:41 ET
Table 'Apus' 6-max Seat #5 is the button
Seat 2: alphabae00 ($7.85 in chips)
Seat 3: mrpolelock ($11.11 in chips)
Seat 4: tapouttazz9 ($11.46 in chips)
Seat 5: gutterdad60 ($5.95 in chips)
Seat 6: tclick ($13.58 in chips)
tclick: posts small blind $0.05
alphabae00: posts big blind $0.10
*** HOLE CARDS ***
Dealt to tapouttazz9 [9d Ks]
mrpolelock: folds
tapouttazz9: folds
gutterdad60: folds
tclick: folds
Uncalled bet ($0.05) returned to alphabae00
alphabae00 collected $0.10 from pot
alphabae00: doesn't show hand
*** SUMMARY ***
Total pot $0.10 | Rake $0
Seat 2: alphabae00 (big blind) collected ($0.10)
Seat 3: mrpolelock folded before Flop (didn't bet)
Seat 4: tapouttazz9 folded before Flop (didn't bet)
Seat 5: gutterdad60 (button) folded before Flop (didn't bet)
Seat 6: tclick (small blind) folded before Flop


PokerStars Hand #157038756717:  Hold'em No Limit ($0.05/$0.10 USD) - 2016/08/16 19:59:50 ET
Table 'Apus' 6-max Seat #6 is the button
Seat 2: alphabae00 ($7.90 in chips)
Seat 3: mrpolelock ($11.11 in chips)
Seat 4: tapouttazz9 ($11.46 in chips)
Seat 5: gutterdad60 ($5.95 in chips)
Seat 6: tclick ($13.53 in chips)
alphabae00: posts small blind $0.05
mrpolelock: posts big blind $0.10
*** HOLE CARDS ***
Dealt to tapouttazz9 [3h 7c]
tapouttazz9: folds
gutterdad60: folds
tclick: calls $0.10
alphabae00: folds
mrpolelock: checks
*** FLOP *** [9h 2c 2s]
mrpolelock: checks
tclick: checks
*** TURN *** [9h 2c 2s] [6d]
mrpolelock: checks
tclick: checks
*** RIVER *** [9h 2c 2s 6d] [Kd]
mrpolelock: bets $0.12
tclick: folds
Uncalled bet ($0.12) returned to mrpolelock
mrpolelock collected $0.24 from pot
mrpolelock: doesn't show hand
*** SUMMARY ***
Total pot $0.25 | Rake $0.01
Board [9h 2c 2s 6d Kd]
Seat 2: alphabae00 (small blind) folded before Flop
Seat 3: mrpolelock (big blind) collected ($0.24)
Seat 4: tapouttazz9 folded before Flop (didn't bet)
Seat 5: gutterdad60 folded before Flop (didn't bet)
Seat 6: tclick (button) folded on the River


PokerStars Hand #157038756867:  Hold'em No Limit ($0.05/$0.10 USD) - 2016/08/16 20:00:22 ET
Table 'Apus' 6-max Seat #2 is the button
Seat 2: alphabae00 ($7.85 in chips)
Seat 3: mrpolelock ($11.25 in chips)
Seat 4: tapouttazz9 ($11.46 in chips)
Seat 5: gutterdad60 ($5.95 in chips)
Seat 6: tclick ($13.43 in chips)
mrpolelock: posts small blind $0.05
tapouttazz9: posts big blind $0.10
*** HOLE CARDS ***
Dealt to tapouttazz9 [9h 2d]
gutterdad60: folds
tclick: raises $0.10 to $0.20
alphabae00: folds
mrpolelock: calls $0.15
tapouttazz9: folds
*** FLOP *** [7s 3s 4h]
mrpolelock: checks
tclick: checks
*** TURN *** [7s 3s 4h] [8c]
mrpolelock: checks
tclick: checks
*** RIVER *** [7s 3s 4h 8c] [6s]
mrpolelock: checks
tclick: checks
*** SHOW DOWN ***
mrpolelock: shows [Jc Qh] (high card Queen)
tclick: shows [Ah Js] (high card Ace)
tclick collected $0.48 from pot
*** SUMMARY ***
Total pot $0.50 | Rake $0.02
Board [7s 3s 4h 8c 6s]
Seat 2: alphabae00 (button) folded before Flop (didn't bet)
Seat 3: mrpolelock (small blind) showed [Jc Qh] and lost with high card Queen
Seat 4: tapouttazz9 (big blind) folded before Flop
Seat 5: gutterdad60 folded before Flop (didn't bet)
Seat 6: tclick showed [Ah Js] and won ($0.48) with high card Ace


PokerStars Hand #157038757021:  Hold'em No Limit ($0.05/$0.10 USD) - 2016/08/16 20:00:51 ET
Table 'Apus' 6-max Seat #3 is the button
Seat 2: alphabae00 ($7.85 in chips)
Seat 3: mrpolelock ($11.05 in chips)
Seat 4: tapouttazz9 ($11.36 in chips)
Seat 5: gutterdad60 ($5.95 in chips)
Seat 6: tclick ($13.71 in chips)
tapouttazz9: posts small blind $0.05
gutterdad60: posts big blind $0.10
*** HOLE CARDS ***
Dealt to tapouttazz9 [4c Qc]
tclick: folds
alphabae00: raises $0.20 to $0.30
mrpolelock: folds
tapouttazz9: folds
gutterdad60: folds
Uncalled bet ($0.20) returned to alphabae00
alphabae00 collected $0.25 from pot
alphabae00: doesn't show hand
*** SUMMARY ***
Total pot $0.25 | Rake $0
Seat 2: alphabae00 collected ($0.25)
Seat 3: mrpolelock (button) folded before Flop (didn't bet)
Seat 4: tapouttazz9 (small blind) folded before Flop
Seat 5: gutterdad60 (big blind) folded before Flop
Seat 6: tclick folded before Flop (didn't bet)


PokerStars Hand #157038757157:  Hold'em No Limit ($0.05/$0.10 USD) - 2016/08/16 20:01:13 ET
Table 'Apus' 6-max Seat #4 is the button
Seat 2: alphabae00 ($8 in chips)
Seat 3: mrpolelock ($11.05 in chips)
Seat 4: tapouttazz9 ($11.31 in chips)
Seat 5: gutterdad60 ($5.85 in chips)
Seat 6: tclick ($13.71 in chips)
gutterdad60: posts small blind $0.05
tclick: posts big blind $0.10
*** HOLE CARDS ***
Dealt to tapouttazz9 [9s As]
alphabae00: calls $0.10
mrpolelock: calls $0.10
tapouttazz9: raises $0.20 to $0.30
gutterdad60: folds
tclick: folds
alphabae00: calls $0.20
mrpolelock: calls $0.20
*** FLOP *** [7c 4d Qd]
alphabae00: checks
mrpolelock: bets $0.50
Rexxmortis88 joins the table at seat #1
tapouttazz9: folds
alphabae00: folds
Uncalled bet ($0.50) returned to mrpolelock
mrpolelock collected $1 from pot
mrpolelock: doesn't show hand
*** SUMMARY ***
Total pot $1.05 | Rake $0.05
Board [7c 4d Qd]
Seat 2: alphabae00 folded on the Flop
Seat 3: mrpolelock collected ($1)
Seat 4: tapouttazz9 (button) folded on the Flop
Seat 5: gutterdad60 (small blind) folded before Flop
Seat 6: tclick (big blind) folded before Flop


PokerStars Hand #157038757337:  Hold'em No Limit ($0.05/$0.10 USD) - 2016/08/16 20:01:47 ET
Table 'Apus' 6-max Seat #5 is the button
Seat 1: Rexxmortis88 ($4 in chips)
Seat 2: alphabae00 ($7.70 in chips)
Seat 3: mrpolelock ($11.75 in chips)
Seat 4: tapouttazz9 ($11.01 in chips)
Seat 5: gutterdad60 ($5.80 in chips)
Seat 6: tclick ($13.61 in chips)
tclick: posts small blind $0.05
Rexxmortis88: posts big blind $0.10
*** HOLE CARDS ***
Dealt to tapouttazz9 [9c 7h]
alphabae00: folds
mrpolelock: folds
tapouttazz9: folds
gutterdad60: folds
tclick: folds
Uncalled bet ($0.05) returned to Rexxmortis88
Rexxmortis88 collected $0.10 from pot
Rexxmortis88: doesn't show hand
*** SUMMARY ***
Total pot $0.10 | Rake $0
Seat 1: Rexxmortis88 (big blind) collected ($0.10)
Seat 2: alphabae00 folded before Flop (didn't bet)
Seat 3: mrpolelock folded before Flop (didn't bet)
Seat 4: tapouttazz9 folded before Flop (didn't bet)
Seat 5: gutterdad60 (button) folded before Flop (didn't bet)
Seat 6: tclick (small blind) folded before Flop


PokerStars Hand #157038757418:  Hold'em No Limit ($0.05/$0.10 USD) - 2016/08/16 20:02:03 ET
Table 'Apus' 6-max Seat #6 is the button
Seat 1: Rexxmortis88 ($4.05 in chips)
Seat 3: mrpolelock ($11.75 in chips)
Seat 4: tapouttazz9 ($11.01 in chips)
Seat 5: gutterdad60 ($5.80 in chips)
Seat 6: tclick ($13.56 in chips)
Rexxmortis88: posts small blind $0.05
mrpolelock: posts big blind $0.10
*** HOLE CARDS ***
Dealt to tapouttazz9 [2h 6h]
tapouttazz9: folds
gutterdad60: folds
tclick: folds
Rexxmortis88: folds
Uncalled bet ($0.05) returned to mrpolelock
mrpolelock collected $0.10 from pot
mrpolelock: doesn't show hand
*** SUMMARY ***
Total pot $0.10 | Rake $0
Seat 1: Rexxmortis88 (small blind) folded before Flop
Seat 3: mrpolelock (big blind) collected ($0.10)
Seat 4: tapouttazz9 folded before Flop (didn't bet)
Seat 5: gutterdad60 folded before Flop (didn't bet)
Seat 6: tclick (button) folded before Flop (didn't bet)


PokerStars Hand #157038757460:  Hold'em No Limit ($0.05/$0.10 USD) - 2016/08/16 20:02:10 ET
Table 'Apus' 6-max Seat #1 is the button
Seat 1: Rexxmortis88 ($4 in chips)
Seat 3: mrpolelock ($11.80 in chips)
Seat 4: tapouttazz9 ($11.01 in chips)
Seat 5: gutterdad60 ($5.80 in chips)
Seat 6: tclick ($13.56 in chips)
mrpolelock: posts small blind $0.05
tapouttazz9: posts big blind $0.10
*** HOLE CARDS ***
Dealt to tapouttazz9 [Tc 2d]
gutterdad60: folds
tclick: raises $0.10 to $0.20
Rexxmortis88: folds
mrpolelock: calls $0.15
tapouttazz9: folds
*** FLOP *** [As 5c 7h]
mrpolelock: checks
tclick: checks
*** TURN *** [As 5c 7h] [3s]
mrpolelock: bets $0.20
tclick: folds
Uncalled bet ($0.20) returned to mrpolelock
mrpolelock collected $0.48 from pot
mrpolelock: doesn't show hand
*** SUMMARY ***
Total pot $0.50 | Rake $0.02
Board [As 5c 7h 3s]
Seat 1: Rexxmortis88 (button) folded before Flop (didn't bet)
Seat 3: mrpolelock (small blind) collected ($0.48)
Seat 4: tapouttazz9 (big blind) folded before Flop
Seat 5: gutterdad60 folded before Flop (didn't bet)
Seat 6: tclick folded on the Turn


PokerStars Hand #157038757629:  Hold'em No Limit ($0.05/$0.10 USD) - 2016/08/16 20:02:44 ET
Table 'Apus' 6-max Seat #3 is the button
Seat 1: Rexxmortis88 ($4 in chips)
Seat 3: mrpolelock ($12.08 in chips)
Seat 4: tapouttazz9 ($10.91 in chips)
Seat 5: gutterdad60 ($5.80 in chips)
Seat 6: tclick ($13.36 in chips)
tapouttazz9: posts small blind $0.05
gutterdad60: posts big blind $0.10
*** HOLE CARDS ***
Dealt to tapouttazz9 [Th Qd]
tclick: calls $0.10
Rexxmortis88: raises $0.30 to $0.40
mrpolelock: calls $0.40
tapouttazz9: folds
gutterdad60: folds
tclick: raises $0.80 to $1.20
Rexxmortis88: folds
mrpolelock: calls $0.80
*** FLOP *** [5c 4h Kc]
tclick: bets $1.40
mrpolelock: folds
Uncalled bet ($1.40) returned to tclick
tclick collected $2.80 from pot
*** SUMMARY ***
Total pot $2.95 | Rake $0.15
Board [5c 4h Kc]
Seat 1: Rexxmortis88 folded before Flop
Seat 3: mrpolelock (button) folded on the Flop
Seat 4: tapouttazz9 (small blind) folded before Flop
Seat 5: gutterdad60 (big blind) folded before Flop
Seat 6: tclick collected ($2.80)


PokerStars Hand #157038758022:  Hold'em No Limit ($0.05/$0.10 USD) - 2016/08/16 20:03:54 ET
Table 'Apus' 6-max Seat #4 is the button
Seat 1: Rexxmortis88 ($3.60 in chips)
Seat 3: mrpolelock ($10.88 in chips)
Seat 4: tapouttazz9 ($10.86 in chips)
Seat 5: gutterdad60 ($5.70 in chips)
Seat 6: tclick ($14.96 in chips)
gutterdad60: posts small blind $0.05
tclick: posts big blind $0.10
*** HOLE CARDS ***
Dealt to tapouttazz9 [3s 4h]
Rexxmortis88: raises $0.30 to $0.40
mrpolelock: folds
tapouttazz9: folds
gutterdad60: folds
tclick: folds
Uncalled bet ($0.30) returned to Rexxmortis88
Rexxmortis88 collected $0.25 from pot
Rexxmortis88: doesn't show hand
*** SUMMARY ***
Total pot $0.25 | Rake $0
Seat 1: Rexxmortis88 collected ($0.25)
Seat 3: mrpolelock folded before Flop (didn't bet)
Seat 4: tapouttazz9 (button) folded before Flop (didn't bet)
Seat 5: gutterdad60 (small blind) folded before Flop
Seat 6: tclick (big blind) folded before Flop


PokerStars Hand #157038758112:  Hold'em No Limit ($0.05/$0.10 USD) - 2016/08/16 20:04:10 ET
Table 'Apus' 6-max Seat #5 is the button
Seat 1: Rexxmortis88 ($3.75 in chips)
Seat 3: mrpolelock ($10.88 in chips)
Seat 4: tapouttazz9 ($10.86 in chips)
Seat 5: gutterdad60 ($5.65 in chips)
Seat 6: tclick ($14.86 in chips)
tclick: posts small blind $0.05
Rexxmortis88: posts big blind $0.10
*** HOLE CARDS ***
Dealt to tapouttazz9 [2h 8s]
mrpolelock: folds
tapouttazz9: folds
gutterdad60: folds
tclick: calls $0.05
Rexxmortis88: raises $0.30 to $0.40
tclick: calls $0.30
*** FLOP *** [2c 7d 8d]
tclick: checks
Rexxmortis88: bets $0.50
tclick: folds
Uncalled bet ($0.50) returned to Rexxmortis88
Rexxmortis88 collected $0.76 from pot
Rexxmortis88: doesn't show hand
*** SUMMARY ***
Total pot $0.80 | Rake $0.04
Board [2c 7d 8d]
Seat 1: Rexxmortis88 (big blind) collected ($0.76)
Seat 3: mrpolelock folded before Flop (didn't bet)
Seat 4: tapouttazz9 folded before Flop (didn't bet)
Seat 5: gutterdad60 (button) folded before Flop (didn't bet)
Seat 6: tclick (small blind) folded on the Flop


PokerStars Hand #157038758237:  Hold'em No Limit ($0.05/$0.10 USD) - 2016/08/16 20:04:34 ET
Table 'Apus' 6-max Seat #6 is the button
Seat 1: Rexxmortis88 ($4.11 in chips)
Seat 3: mrpolelock ($10.88 in chips)
Seat 4: tapouttazz9 ($10.86 in chips)
Seat 5: gutterdad60 ($5.65 in chips)
Seat 6: tclick ($14.46 in chips)
Rexxmortis88: posts small blind $0.05
mrpolelock: posts big blind $0.10
*** HOLE CARDS ***
Dealt to tapouttazz9 [3h Ad]
tapouttazz9: folds
gutterdad60: folds
tclick: folds
Rexxmortis88: folds
Uncalled bet ($0.05) returned to mrpolelock
mrpolelock collected $0.10 from pot
mrpolelock: doesn't show hand
*** SUMMARY ***
Total pot $0.10 | Rake $0
Seat 1: Rexxmortis88 (small blind) folded before Flop
Seat 3: mrpolelock (big blind) collected ($0.10)
Seat 4: tapouttazz9 folded before Flop (didn't bet)
Seat 5: gutterdad60 folded before Flop (didn't bet)
Seat 6: tclick (button) folded before Flop (didn't bet)


PokerStars Hand #157038758286:  Hold'em No Limit ($0.05/$0.10 USD) - 2016/08/16 20:04:42 ET
Table 'Apus' 6-max Seat #1 is the button
Seat 1: Rexxmortis88 ($4.06 in chips)
Seat 3: mrpolelock ($10.93 in chips)
Seat 4: tapouttazz9 ($10.86 in chips)
Seat 5: gutterdad60 ($5.65 in chips)
Seat 6: tclick ($14.46 in chips)
mrpolelock: posts small blind $0.05
tapouttazz9: posts big blind $0.10
*** HOLE CARDS ***
Dealt to tapouttazz9 [8s 5s]
gutterdad60: folds
tclick: folds
Rexxmortis88: raises $0.30 to $0.40
mrpolelock: folds
tapouttazz9: calls $0.30
*** FLOP *** [Qd Jh Ah]
tapouttazz9: bets $0.40
Rexxmortis88: folds
Uncalled bet ($0.40) returned to tapouttazz9
tapouttazz9 collected $0.81 from pot
*** SUMMARY ***
Total pot $0.85 | Rake $0.04
Board [Qd Jh Ah]
Seat 1: Rexxmortis88 (button) folded on the Flop
Seat 3: mrpolelock (small blind) folded before Flop
Seat 4: tapouttazz9 (big blind) collected ($0.81)
Seat 5: gutterdad60 folded before Flop (didn't bet)
Seat 6: tclick folded before Flop (didn't bet)


PokerStars Hand #157038758396:  Hold'em No Limit ($0.05/$0.10 USD) - 2016/08/16 20:05:01 ET
Table 'Apus' 6-max Seat #3 is the button
Seat 1: Rexxmortis88 ($3.66 in chips)
Seat 3: mrpolelock ($10.88 in chips)
Seat 4: tapouttazz9 ($11.27 in chips)
Seat 5: gutterdad60 ($5.65 in chips)
Seat 6: tclick ($14.46 in chips)
tapouttazz9: posts small blind $0.05
gutterdad60: posts big blind $0.10
*** HOLE CARDS ***
Dealt to tapouttazz9 [2c 9h]
tclick: calls $0.10
Rexxmortis88: folds
mrpolelock: folds
tapouttazz9: folds
gutterdad60: checks
*** FLOP *** [5h Qc Ts]
gutterdad60: checks
tclick: bets $0.12
gutterdad60: calls $0.12
*** TURN *** [5h Qc Ts] [7d]
gutterdad60: checks
tclick: checks
*** RIVER *** [5h Qc Ts 7d] [2h]
gutterdad60: checks
tclick: checks
*** SHOW DOWN ***
gutterdad60: shows [4h 5d] (a pair of Fives)
tclick: shows [6h Th] (a pair of Tens)
tclick collected $0.47 from pot
*** SUMMARY ***
Total pot $0.49 | Rake $0.02
Board [5h Qc Ts 7d 2h]
Seat 1: Rexxmortis88 folded before Flop (didn't bet)
Seat 3: mrpolelock (button) folded before Flop (didn't bet)
Seat 4: tapouttazz9 (small blind) folded before Flop
Seat 5: gutterdad60 (big blind) showed [4h 5d] and lost with a pair of Fives
Seat 6: tclick showed [6h Th] and won ($0.47) with a pair of Tens


PokerStars Hand #157038758696:  Hold'em No Limit ($0.05/$0.10 USD) - 2016/08/16 20:05:53 ET
Table 'Apus' 6-max Seat #4 is the button
Seat 1: Rexxmortis88 ($3.66 in chips)
Seat 3: mrpolelock ($10.88 in chips)
Seat 4: tapouttazz9 ($11.22 in chips)
Seat 5: gutterdad60 ($5.43 in chips)
Seat 6: tclick ($14.71 in chips)
gutterdad60: posts small blind $0.05
tclick: posts big blind $0.10
alphabae00: sits out
*** HOLE CARDS ***
Dealt to tapouttazz9 [Tc 5c]
Rexxmortis88: folds
mrpolelock: folds
tapouttazz9: folds
gutterdad60: folds
Uncalled bet ($0.05) returned to tclick
tclick collected $0.10 from pot
*** SUMMARY ***
Total pot $0.10 | Rake $0
Seat 1: Rexxmortis88 folded before Flop (didn't bet)
Seat 3: mrpolelock folded before Flop (didn't bet)
Seat 4: tapouttazz9 (button) folded before Flop (didn't bet)
Seat 5: gutterdad60 (small blind) folded before Flop
Seat 6: tclick (big blind) collected ($0.10)


PokerStars Hand #157038758768:  Hold'em No Limit ($0.05/$0.10 USD) - 2016/08/16 20:06:08 ET
Table 'Apus' 6-max Seat #5 is the button
Seat 1: Rexxmortis88 ($3.66 in chips)
Seat 3: mrpolelock ($10.88 in chips)
Seat 4: tapouttazz9 ($11.22 in chips)
Seat 5: gutterdad60 ($5.38 in chips)
Seat 6: tclick ($14.76 in chips)
tclick: posts small blind $0.05
Rexxmortis88: posts big blind $0.10
alphabae00: sits out
*** HOLE CARDS ***
Dealt to tapouttazz9 [6s As]
mrpolelock: folds
tapouttazz9: raises $0.20 to $0.30
gutterdad60: folds
tclick: folds
Rexxmortis88: raises $0.40 to $0.70
tapouttazz9: calls $0.40
*** FLOP *** [3s Jh 9h]
Rexxmortis88: bets $0.69
tapouttazz9: folds
Uncalled bet ($0.69) returned to Rexxmortis88
Rexxmortis88 collected $1.38 from pot
Rexxmortis88: doesn't show hand
*** SUMMARY ***
Total pot $1.45 | Rake $0.07
Board [3s Jh 9h]
Seat 1: Rexxmortis88 (big blind) collected ($1.38)
Seat 3: mrpolelock folded before Flop (didn't bet)
Seat 4: tapouttazz9 folded on the Flop
Seat 5: gutterdad60 (button) folded before Flop (didn't bet)
Seat 6: tclick (small blind) folded before Flop


PokerStars Hand #157038758909:  Hold'em No Limit ($0.05/$0.10 USD) - 2016/08/16 20:06:33 ET
Table 'Apus' 6-max Seat #6 is the button
Seat 1: Rexxmortis88 ($4.34 in chips)
Seat 2: alphabae00 ($7.70 in chips)
Seat 3: mrpolelock ($10.88 in chips)
Seat 4: tapouttazz9 ($10.52 in chips)
Seat 5: gutterdad60 ($5.38 in chips)
Seat 6: tclick ($14.71 in chips)
Rexxmortis88: posts small blind $0.05
alphabae00: posts big blind $0.10
*** HOLE CARDS ***
Dealt to tapouttazz9 [7c 7s]
mrpolelock: raises $0.20 to $0.30
tapouttazz9: calls $0.30
gutterdad60: calls $0.30
tclick: folds
Rexxmortis88: folds
alphabae00: folds
*** FLOP *** [Kd 9s 3d]
mrpolelock: bets $0.10
tapouttazz9: calls $0.10
gutterdad60: raises $4.98 to $5.08 and is all-in
mrpolelock: folds
tapouttazz9: folds
Uncalled bet ($4.98) returned to gutterdad60
gutterdad60 collected $1.28 from pot
gutterdad60: doesn't show hand
*** SUMMARY ***
Total pot $1.35 | Rake $0.07
Board [Kd 9s 3d]
Seat 1: Rexxmortis88 (small blind) folded before Flop
Seat 2: alphabae00 (big blind) folded before Flop
Seat 3: mrpolelock folded on the Flop
Seat 4: tapouttazz9 folded on the Flop
Seat 5: gutterdad60 collected ($1.28)
Seat 6: tclick (button) folded before Flop (didn't bet)


PokerStars Hand #157038759060:  Hold'em No Limit ($0.05/$0.10 USD) - 2016/08/16 20:06:59 ET
Table 'Apus' 6-max Seat #1 is the button
Seat 1: Rexxmortis88 ($4.29 in chips)
Seat 2: alphabae00 ($7.60 in chips)
Seat 3: mrpolelock ($10.48 in chips)
Seat 4: tapouttazz9 ($10.12 in chips)
Seat 5: gutterdad60 ($6.26 in chips)
Seat 6: tclick ($14.71 in chips)
alphabae00: posts small blind $0.05
mrpolelock: posts big blind $0.10
*** HOLE CARDS ***
Dealt to tapouttazz9 [9c Ad]
tapouttazz9: folds
gutterdad60: folds
tclick: folds
Rexxmortis88: folds
alphabae00: raises $0.20 to $0.30
mrpolelock: folds
Uncalled bet ($0.20) returned to alphabae00
alphabae00 collected $0.20 from pot
alphabae00: doesn't show hand
*** SUMMARY ***
Total pot $0.20 | Rake $0
Seat 1: Rexxmortis88 (button) folded before Flop (didn't bet)
Seat 2: alphabae00 (small blind) collected ($0.20)
Seat 3: mrpolelock (big blind) folded before Flop
Seat 4: tapouttazz9 folded before Flop (didn't bet)
Seat 5: gutterdad60 folded before Flop (didn't bet)
Seat 6: tclick folded before Flop (didn't bet)


PokerStars Hand #157038759223:  Hold'em No Limit ($0.05/$0.10 USD) - 2016/08/16 20:07:30 ET
Table 'Apus' 6-max Seat #2 is the button
Seat 1: Rexxmortis88 ($4.29 in chips)
Seat 2: alphabae00 ($7.70 in chips)
Seat 3: mrpolelock ($10.38 in chips)
Seat 4: tapouttazz9 ($10.12 in chips)
Seat 5: gutterdad60 ($6.26 in chips)
Seat 6: tclick ($14.71 in chips)
mrpolelock: posts small blind $0.05
tapouttazz9: posts big blind $0.10
*** HOLE CARDS ***
Dealt to tapouttazz9 [7d 9d]
gutterdad60: folds
tclick: raises $0.20 to $0.30
Rexxmortis88: raises $0.40 to $0.70
alphabae00: folds
mrpolelock: folds
tapouttazz9: folds
tclick: calls $0.40
*** FLOP *** [8d 5c 9c]
tclick: checks
Rexxmortis88: bets $0.73
tclick: folds
Uncalled bet ($0.73) returned to Rexxmortis88
Rexxmortis88 collected $1.47 from pot
Rexxmortis88: doesn't show hand
*** SUMMARY ***
Total pot $1.55 | Rake $0.08
Board [8d 5c 9c]
Seat 1: Rexxmortis88 collected ($1.47)
Seat 2: alphabae00 (button) folded before Flop (didn't bet)
Seat 3: mrpolelock (small blind) folded before Flop
Seat 4: tapouttazz9 (big blind) folded before Flop
Seat 5: gutterdad60 folded before Flop (didn't bet)
Seat 6: tclick folded on the Flop


PokerStars Hand #157038759404:  Hold'em No Limit ($0.05/$0.10 USD) - 2016/08/16 20:08:03 ET
Table 'Apus' 6-max Seat #3 is the button
Seat 1: Rexxmortis88 ($5.06 in chips)
Seat 2: alphabae00 ($7.70 in chips)
Seat 3: mrpolelock ($10.33 in chips)
Seat 4: tapouttazz9 ($10.02 in chips)
Seat 5: gutterdad60 ($6.26 in chips)
Seat 6: tclick ($14.01 in chips)
tapouttazz9: posts small blind $0.05
gutterdad60: posts big blind $0.10
*** HOLE CARDS ***
Dealt to tapouttazz9 [Ad 6d]
tclick: folds
Rexxmortis88: raises $0.30 to $0.40
alphabae00: calls $0.40
mrpolelock: folds
tapouttazz9: raises $1.30 to $1.70
gutterdad60: folds
Rexxmortis88: calls $1.30
alphabae00: folds
*** FLOP *** [8h 8d 4c]
tapouttazz9: bets $8.32 and is all-in
Rexxmortis88: folds
Uncalled bet ($8.32) returned to tapouttazz9
tapouttazz9 collected $3.70 from pot
*** SUMMARY ***
Total pot $3.90 | Rake $0.20
Board [8h 8d 4c]
Seat 1: Rexxmortis88 folded on the Flop
Seat 2: alphabae00 folded before Flop
Seat 3: mrpolelock (button) folded before Flop (didn't bet)
Seat 4: tapouttazz9 (small blind) collected ($3.70)
Seat 5: gutterdad60 (big blind) folded before Flop
Seat 6: tclick folded before Flop (didn't bet)


PokerStars Hand #157038759626:  Hold'em No Limit ($0.05/$0.10 USD) - 2016/08/16 20:08:44 ET
Table 'Apus' 6-max Seat #4 is the button
Seat 1: Rexxmortis88 ($3.36 in chips)
Seat 2: alphabae00 ($7.30 in chips)
Seat 3: mrpolelock ($10.33 in chips)
Seat 4: tapouttazz9 ($12.02 in chips)
Seat 5: gutterdad60 ($6.16 in chips)
Seat 6: tclick ($14.01 in chips)
gutterdad60: posts small blind $0.05
tclick: posts big blind $0.10
*** HOLE CARDS ***
Dealt to tapouttazz9 [3c 9s]
Rexxmortis88: raises $0.30 to $0.40
alphabae00: folds
mrpolelock: folds
tapouttazz9: folds
gutterdad60: folds
tclick: calls $0.30
*** FLOP *** [Jh 4h Kc]
tclick: bets $0.40
Rexxmortis88: folds
Uncalled bet ($0.40) returned to tclick
tclick collected $0.81 from pot
*** SUMMARY ***
Total pot $0.85 | Rake $0.04
Board [Jh 4h Kc]
Seat 1: Rexxmortis88 folded on the Flop
Seat 2: alphabae00 folded before Flop (didn't bet)
Seat 3: mrpolelock folded before Flop (didn't bet)
Seat 4: tapouttazz9 (button) folded before Flop (didn't bet)
Seat 5: gutterdad60 (small blind) folded before Flop
Seat 6: tclick (big blind) collected ($0.81)


PokerStars Hand #157038759741:  Hold'em No Limit ($0.05/$0.10 USD) - 2016/08/16 20:09:05 ET
Table 'Apus' 6-max Seat #5 is the button
Seat 1: Rexxmortis88 ($2.96 in chips)
Seat 2: alphabae00 ($7.30 in chips)
Seat 3: mrpolelock ($10.33 in chips)
Seat 4: tapouttazz9 ($12.02 in chips)
Seat 5: gutterdad60 ($6.11 in chips)
Seat 6: tclick ($14.42 in chips)
tclick: posts small blind $0.05
Rexxmortis88: posts big blind $0.10
*** HOLE CARDS ***
Dealt to tapouttazz9 [9c Ah]
alphabae00: folds
mrpolelock: folds
tapouttazz9: raises $0.10 to $0.20
gutterdad60: calls $0.20
tclick: folds
Rexxmortis88: calls $0.10
*** FLOP *** [8c 9h 3d]
Rexxmortis88: checks
tapouttazz9: bets $0.31
gutterdad60: folds
Rexxmortis88: folds
Uncalled bet ($0.31) returned to tapouttazz9
tapouttazz9 collected $0.62 from pot
*** SUMMARY ***
Total pot $0.65 | Rake $0.03
Board [8c 9h 3d]
Seat 1: Rexxmortis88 (big blind) folded on the Flop
Seat 2: alphabae00 folded before Flop (didn't bet)
Seat 3: mrpolelock folded before Flop (didn't bet)
Seat 4: tapouttazz9 collected ($0.62)
Seat 5: gutterdad60 (button) folded on the Flop
Seat 6: tclick (small blind) folded before Flop


PokerStars Hand #157039278418:  Hold'em No Limit ($0.05/$0.10 USD) - 2016/08/16 20:09:56 ET
Table 'Apus' 6-max Seat #6 is the button
Seat 1: Rexxmortis88 ($2.76 in chips)
Seat 2: alphabae00 ($7.30 in chips)
Seat 3: mrpolelock ($10.33 in chips)
Seat 4: tapouttazz9 ($12.44 in chips)
Seat 5: gutterdad60 ($5.91 in chips)
Seat 6: tclick ($14.37 in chips)
Rexxmortis88: posts small blind $0.05
alphabae00: posts big blind $0.10
*** HOLE CARDS ***
Dealt to tapouttazz9 [Ac 2d]
mrpolelock: folds
tapouttazz9: folds
gutterdad60: folds
tclick: raises $0.10 to $0.20
Rexxmortis88: raises $0.30 to $0.50
alphabae00: calls $0.40
tclick: calls $0.30
*** FLOP *** [Qh 4d 8h]
Rexxmortis88: checks
alphabae00: bets $1.40
tclick: calls $1.40
Rexxmortis88: folds
*** TURN *** [Qh 4d 8h] [Kc]
alphabae00: bets $2
tclick: calls $2
*** RIVER *** [Qh 4d 8h Kc] [9d]
alphabae00: checks
tclick: checks
*** SHOW DOWN ***
alphabae00: shows [Ts As] (high card Ace)
tclick: shows [Qd Th] (a pair of Queens)
tclick collected $7.88 from pot
*** SUMMARY ***
Total pot $8.30 | Rake $0.42
Board [Qh 4d 8h Kc 9d]
Seat 1: Rexxmortis88 (small blind) folded on the Flop
Seat 2: alphabae00 (big blind) showed [Ts As] and lost with high card Ace
Seat 3: mrpolelock folded before Flop (didn't bet)
Seat 4: tapouttazz9 folded before Flop (didn't bet)
Seat 5: gutterdad60 folded before Flop (didn't bet)
Seat 6: tclick (button) showed [Qd Th] and won ($7.88) with a pair of Queens


PokerStars Hand #157039278769:  Hold'em No Limit ($0.05/$0.10 USD) - 2016/08/16 20:11:00 ET
Table 'Apus' 6-max Seat #1 is the button
Seat 1: Rexxmortis88 ($2.26 in chips)
Seat 2: alphabae00 ($3.40 in chips)
Seat 3: mrpolelock ($10.33 in chips)
Seat 4: tapouttazz9 ($12.44 in chips)
Seat 5: gutterdad60 ($5.91 in chips)
Seat 6: tclick ($18.35 in chips)
alphabae00: posts small blind $0.05
mrpolelock: posts big blind $0.10
*** HOLE CARDS ***
Dealt to tapouttazz9 [8h 6h]
tapouttazz9: folds
gutterdad60: folds
tclick: raises $0.10 to $0.20
Rexxmortis88: raises $0.30 to $0.50
alphabae00: folds
mrpolelock: folds
tclick: calls $0.30
*** FLOP *** [2s 3s 5d]
tclick: checks
Rexxmortis88: bets $1.09
tclick: calls $1.09
*** TURN *** [2s 3s 5d] [Kc]
tclick: checks
Rexxmortis88: bets $0.67 and is all-in
tclick: calls $0.67
*** RIVER *** [2s 3s 5d Kc] [Js]
*** SHOW DOWN ***
tclick: shows [Jc Qs] (a pair of Jacks)
Rexxmortis88: shows [Ah Jh] (a pair of Jacks - Ace kicker)
Rexxmortis88 collected $4.44 from pot
*** SUMMARY ***
Total pot $4.67 | Rake $0.23
Board [2s 3s 5d Kc Js]
Seat 1: Rexxmortis88 (button) showed [Ah Jh] and won ($4.44) with a pair of Jacks
Seat 2: alphabae00 (small blind) folded before Flop
Seat 3: mrpolelock (big blind) folded before Flop
Seat 4: tapouttazz9 folded before Flop (didn't bet)
Seat 5: gutterdad60 folded before Flop (didn't bet)
Seat 6: tclick showed [Jc Qs] and lost with a pair of Jacks


PokerStars Hand #157039279014:  Hold'em No Limit ($0.05/$0.10 USD) - 2016/08/16 20:11:45 ET
Table 'Apus' 6-max Seat #2 is the button
Seat 1: Rexxmortis88 ($4.44 in chips)
Seat 2: alphabae00 ($3.35 in chips)
Seat 3: mrpolelock ($10.23 in chips)
Seat 4: tapouttazz9 ($12.44 in chips)
Seat 5: gutterdad60 ($5.91 in chips)
Seat 6: tclick ($16.09 in chips)
mrpolelock: posts small blind $0.05
tapouttazz9: posts big blind $0.10
*** HOLE CARDS ***
Dealt to tapouttazz9 [Th As]
gutterdad60: folds
tclick: folds
Rexxmortis88: folds
alphabae00: folds
mrpolelock: calls $0.05
tapouttazz9: raises $0.30 to $0.40
mrpolelock: calls $0.30
*** FLOP *** [Jc Qc 6c]
mrpolelock: bets $0.38
tapouttazz9: calls $0.38
*** TURN *** [Jc Qc 6c] [9d]
mrpolelock: bets $0.74
tapouttazz9: calls $0.74
*** RIVER *** [Jc Qc 6c 9d] [Ac]
mrpolelock: bets $1.44
tapouttazz9: folds [As]
Uncalled bet ($1.44) returned to mrpolelock
mrpolelock collected $2.89 from pot
mrpolelock: doesn't show hand
*** SUMMARY ***
Total pot $3.04 | Rake $0.15
Board [Jc Qc 6c 9d Ac]
Seat 1: Rexxmortis88 folded before Flop (didn't bet)
Seat 2: alphabae00 (button) folded before Flop (didn't bet)
Seat 3: mrpolelock (small blind) collected ($2.89)
Seat 4: tapouttazz9 (big blind) folded on the River
Seat 5: gutterdad60 folded before Flop (didn't bet)
Seat 6: tclick folded before Flop (didn't bet)


PokerStars Hand #157039279288:  Hold'em No Limit ($0.05/$0.10 USD) - 2016/08/16 20:12:36 ET
Table 'Apus' 6-max Seat #3 is the button
Seat 1: Rexxmortis88 ($4.44 in chips)
Seat 3: mrpolelock ($11.60 in chips)
Seat 4: tapouttazz9 ($10.92 in chips)
Seat 5: gutterdad60 ($5.91 in chips)
Seat 6: tclick ($16.09 in chips)
tapouttazz9: posts small blind $0.05
gutterdad60: posts big blind $0.10
*** HOLE CARDS ***
Dealt to tapouttazz9 [4s Ks]
tclick: folds
Rexxmortis88: raises $0.30 to $0.40
mrpolelock: calls $0.40
tapouttazz9: calls $0.35
gutterdad60: folds
*** FLOP *** [6s 6d Kc]
tapouttazz9: bets $1.24
Rexxmortis88: folds
mrpolelock: folds
Uncalled bet ($1.24) returned to tapouttazz9
tapouttazz9 collected $1.24 from pot
*** SUMMARY ***
Total pot $1.30 | Rake $0.06
Board [6s 6d Kc]
Seat 1: Rexxmortis88 folded on the Flop
Seat 3: mrpolelock (button) folded on the Flop
Seat 4: tapouttazz9 (small blind) collected ($1.24)
Seat 5: gutterdad60 (big blind) folded before Flop
Seat 6: tclick folded before Flop (didn't bet)


PokerStars Hand #157039279498:  Hold'em No Limit ($0.05/$0.10 USD) - 2016/08/16 20:13:12 ET
Table 'Apus' 6-max Seat #4 is the button
Seat 1: Rexxmortis88 ($4.04 in chips)
Seat 3: mrpolelock ($11.20 in chips)
Seat 4: tapouttazz9 ($11.76 in chips)
Seat 5: gutterdad60 ($5.81 in chips)
Seat 6: tclick ($16.09 in chips)
gutterdad60: posts small blind $0.05
tclick: posts big blind $0.10
*** HOLE CARDS ***
Dealt to tapouttazz9 [3s 7d]
Rexxmortis88: folds
mrpolelock: calls $0.10
tapouttazz9: folds
gutterdad60: calls $0.05
tclick: checks
*** FLOP *** [7c Ts 6d]
gutterdad60: checks
tclick: checks
mrpolelock: checks
*** TURN *** [7c Ts 6d] [Th]
gutterdad60: checks
tclick: checks
mrpolelock: checks
*** RIVER *** [7c Ts 6d Th] [8h]
gutterdad60: bets $0.10
tclick: folds
mrpolelock: folds
Uncalled bet ($0.10) returned to gutterdad60
gutterdad60 collected $0.28 from pot
gutterdad60: doesn't show hand
*** SUMMARY ***
Total pot $0.30 | Rake $0.02
Board [7c Ts 6d Th 8h]
Seat 1: Rexxmortis88 folded before Flop (didn't bet)
Seat 3: mrpolelock folded on the River
Seat 4: tapouttazz9 (button) folded before Flop (didn't bet)
Seat 5: gutterdad60 (small blind) collected ($0.28)
Seat 6: tclick (big blind) folded on the River


PokerStars Hand #157039279825:  Hold'em No Limit ($0.05/$0.10 USD) - 2016/08/16 20:14:09 ET
Table 'Apus' 6-max Seat #5 is the button
Seat 1: Rexxmortis88 ($4.04 in chips)
Seat 3: mrpolelock ($11.10 in chips)
Seat 4: tapouttazz9 ($11.76 in chips)
Seat 5: gutterdad60 ($5.99 in chips)
Seat 6: tclick ($15.99 in chips)
tclick: posts small blind $0.05
Rexxmortis88: posts big blind $0.10
*** HOLE CARDS ***
Dealt to tapouttazz9 [7s 5s]
mrpolelock: folds
tapouttazz9: folds
gutterdad60: folds
tclick: calls $0.05
Rexxmortis88: raises $0.30 to $0.40
tclick: calls $0.30
*** FLOP *** [7h 2c 8h]
tclick: bets $0.90
Rexxmortis88: folds
Uncalled bet ($0.90) returned to tclick
tclick collected $0.76 from pot
*** SUMMARY ***
Total pot $0.80 | Rake $0.04
Board [7h 2c 8h]
Seat 1: Rexxmortis88 (big blind) folded on the Flop
Seat 3: mrpolelock folded before Flop (didn't bet)
Seat 4: tapouttazz9 folded before Flop (didn't bet)
Seat 5: gutterdad60 (button) folded before Flop (didn't bet)
Seat 6: tclick (small blind) collected ($0.76)


PokerStars Hand #157039481002:  Hold'em No Limit ($0.05/$0.10 USD) - 2016/08/16 20:14:40 ET
Table 'Apus' 6-max Seat #6 is the button
Seat 1: Rexxmortis88 ($3.64 in chips)
Seat 3: mrpolelock ($11.10 in chips)
Seat 4: tapouttazz9 ($11.76 in chips)
Seat 5: gutterdad60 ($5.99 in chips)
Seat 6: tclick ($16.35 in chips)
Rexxmortis88: posts small blind $0.05
mrpolelock: posts big blind $0.10
*** HOLE CARDS ***
Dealt to tapouttazz9 [Kc 9s]
tapouttazz9: folds
gutterdad60: raises $0.40 to $0.50
tclick: folds
Rexxmortis88: folds
mrpolelock: folds
Uncalled bet ($0.40) returned to gutterdad60
gutterdad60 collected $0.25 from pot
gutterdad60: doesn't show hand
*** SUMMARY ***
Total pot $0.25 | Rake $0
Seat 1: Rexxmortis88 (small blind) folded before Flop
Seat 3: mrpolelock (big blind) folded before Flop
Seat 4: tapouttazz9 folded before Flop (didn't bet)
Seat 5: gutterdad60 collected ($0.25)
Seat 6: tclick (button) folded before Flop (didn't bet)


PokerStars Hand #157039481052:  Hold'em No Limit ($0.05/$0.10 USD) - 2016/08/16 20:14:49 ET
Table 'Apus' 6-max Seat #1 is the button
Seat 1: Rexxmortis88 ($3.59 in chips)
Seat 3: mrpolelock ($11 in chips)
Seat 4: tapouttazz9 ($11.76 in chips)
Seat 5: gutterdad60 ($6.14 in chips)
Seat 6: tclick ($16.35 in chips)
mrpolelock: posts small blind $0.05
tapouttazz9: posts big blind $0.10
*** HOLE CARDS ***
Dealt to tapouttazz9 [6h Qs]
gutterdad60: folds
tclick: folds
Rexxmortis88: folds
mrpolelock: calls $0.05
tapouttazz9: checks
*** FLOP *** [Qd 8h 2c]
mrpolelock: checks
tapouttazz9: checks
*** TURN *** [Qd 8h 2c] [8s]
mrpolelock: checks
tapouttazz9: checks
*** RIVER *** [Qd 8h 2c 8s] [As]
mrpolelock: checks
tapouttazz9: checks
*** SHOW DOWN ***
mrpolelock: shows [6c Ts] (a pair of Eights)
tapouttazz9: shows [6h Qs] (two pair, Queens and Eights)
tapouttazz9 collected $0.19 from pot
*** SUMMARY ***
Total pot $0.20 | Rake $0.01
Board [Qd 8h 2c 8s As]
Seat 1: Rexxmortis88 (button) folded before Flop (didn't bet)
Seat 3: mrpolelock (small blind) showed [6c Ts] and lost with a pair of Eights
Seat 4: tapouttazz9 (big blind) showed [6h Qs] and won ($0.19) with two pair, Queens and Eights
Seat 5: gutterdad60 folded before Flop (didn't bet)
Seat 6: tclick folded before Flop (didn't bet)


PokerStars Hand #157039481187:  Hold'em No Limit ($0.05/$0.10 USD) - 2016/08/16 20:15:14 ET
Table 'Apus' 6-max Seat #3 is the button
Seat 1: Rexxmortis88 ($3.59 in chips)
Seat 3: mrpolelock ($10.90 in chips)
Seat 4: tapouttazz9 ($11.85 in chips)
Seat 5: gutterdad60 ($6.14 in chips)
Seat 6: tclick ($16.35 in chips)
tapouttazz9: posts small blind $0.05
gutterdad60: posts big blind $0.10
*** HOLE CARDS ***
Dealt to tapouttazz9 [3s Qc]
tclick: folds
Rexxmortis88: folds
mrpolelock: raises $0.20 to $0.30
tapouttazz9: folds
gutterdad60: folds
Uncalled bet ($0.20) returned to mrpolelock
mrpolelock collected $0.25 from pot
mrpolelock: doesn't show hand
*** SUMMARY ***
Total pot $0.25 | Rake $0
Seat 1: Rexxmortis88 folded before Flop (didn't bet)
Seat 3: mrpolelock (button) collected ($0.25)
Seat 4: tapouttazz9 (small blind) folded before Flop
Seat 5: gutterdad60 (big blind) folded before Flop
Seat 6: tclick folded before Flop (didn't bet)


PokerStars Hand #157039481254:  Hold'em No Limit ($0.05/$0.10 USD) - 2016/08/16 20:15:25 ET
Table 'Apus' 6-max Seat #4 is the button
Seat 1: Rexxmortis88 ($3.59 in chips)
Seat 3: mrpolelock ($11.05 in chips)
Seat 4: tapouttazz9 ($11.80 in chips)
Seat 5: gutterdad60 ($6.04 in chips)
Seat 6: tclick ($16.35 in chips)
gutterdad60: posts small blind $0.05
tclick: posts big blind $0.10
*** HOLE CARDS ***
Dealt to tapouttazz9 [7c Td]
Rexxmortis88: folds
mrpolelock: folds
tapouttazz9: folds
gutterdad60: calls $0.05
tclick: checks
*** FLOP *** [Jc 7d 2d]
gutterdad60: bets $0.30
tclick: folds
Uncalled bet ($0.30) returned to gutterdad60
gutterdad60 collected $0.19 from pot
gutterdad60: doesn't show hand
*** SUMMARY ***
Total pot $0.20 | Rake $0.01
Board [Jc 7d 2d]
Seat 1: Rexxmortis88 folded before Flop (didn't bet)
Seat 3: mrpolelock folded before Flop (didn't bet)
Seat 4: tapouttazz9 (button) folded before Flop (didn't bet)
Seat 5: gutterdad60 (small blind) collected ($0.19)
Seat 6: tclick (big blind) folded on the Flop


PokerStars Hand #157039481379:  Hold'em No Limit ($0.05/$0.10 USD) - 2016/08/16 20:15:47 ET
Table 'Apus' 6-max Seat #5 is the button
Seat 1: Rexxmortis88 ($3.59 in chips)
Seat 3: mrpolelock ($11.05 in chips)
Seat 4: tapouttazz9 ($11.80 in chips)
Seat 5: gutterdad60 ($6.13 in chips)
Seat 6: tclick ($16.25 in chips)
tclick: posts small blind $0.05
Rexxmortis88: posts big blind $0.10
*** HOLE CARDS ***
Dealt to tapouttazz9 [Ac Th]
mrpolelock: folds
tapouttazz9: raises $0.20 to $0.30
gutterdad60: folds
tclick: folds
Rexxmortis88: folds
Uncalled bet ($0.20) returned to tapouttazz9
tapouttazz9 collected $0.25 from pot
*** SUMMARY ***
Total pot $0.25 | Rake $0
Seat 1: Rexxmortis88 (big blind) folded before Flop
Seat 3: mrpolelock folded before Flop (didn't bet)
Seat 4: tapouttazz9 collected ($0.25)
Seat 5: gutterdad60 (button) folded before Flop (didn't bet)
Seat 6: tclick (small blind) folded before Flop


PokerStars Hand #157039481441:  Hold'em No Limit ($0.05/$0.10 USD) - 2016/08/16 20:15:58 ET
Table 'Apus' 6-max Seat #6 is the button
Seat 1: Rexxmortis88 ($3.49 in chips)
Seat 3: mrpolelock ($11.05 in chips)
Seat 4: tapouttazz9 ($11.95 in chips)
Seat 5: gutterdad60 ($6.13 in chips)
Seat 6: tclick ($16.20 in chips)
Rexxmortis88: posts small blind $0.05
mrpolelock: posts big blind $0.10
*** HOLE CARDS ***
Dealt to tapouttazz9 [Qs Ac]
tapouttazz9: raises $0.20 to $0.30
gutterdad60: folds
tclick: folds
Rexxmortis88: calls $0.25
mrpolelock: folds
*** FLOP *** [Qd 2s 4d]
Rexxmortis88: checks
tapouttazz9: bets $0.33
Rexxmortis88: raises $1.32 to $1.65
tapouttazz9: calls $1.32
*** TURN *** [Qd 2s 4d] [Jc]
Rexxmortis88: bets $1.54 and is all-in
tapouttazz9: calls $1.54
*** RIVER *** [Qd 2s 4d Jc] [Qc]
*** SHOW DOWN ***
Rexxmortis88: shows [Qh Ks] (three of a kind, Queens)
tapouttazz9: shows [Qs Ac] (three of a kind, Queens - Ace kicker)
tapouttazz9 collected $6.73 from pot
*** SUMMARY ***
Total pot $7.08 | Rake $0.35
Board [Qd 2s 4d Jc Qc]
Seat 1: Rexxmortis88 (small blind) showed [Qh Ks] and lost with three of a kind, Queens
Seat 3: mrpolelock (big blind) folded before Flop
Seat 4: tapouttazz9 showed [Qs Ac] and won ($6.73) with three of a kind, Queens
Seat 5: gutterdad60 folded before Flop (didn't bet)
Seat 6: tclick (button) folded before Flop (didn't bet)


PokerStars Hand #157039481624:  Hold'em No Limit ($0.05/$0.10 USD) - 2016/08/16 20:16:32 ET
Table 'Apus' 6-max Seat #3 is the button
Seat 3: mrpolelock ($10.95 in chips)
Seat 4: tapouttazz9 ($15.19 in chips)
Seat 5: gutterdad60 ($6.13 in chips)
Seat 6: tclick ($16.20 in chips)
tapouttazz9: posts small blind $0.05
gutterdad60: posts big blind $0.10
*** HOLE CARDS ***
Dealt to tapouttazz9 [3h 4c]
Rexxmortis88 leaves the table
tclick: raises $0.10 to $0.20
mrpolelock: folds
tapouttazz9: folds
gutterdad60: folds
Uncalled bet ($0.10) returned to tclick
tclick collected $0.25 from pot
*** SUMMARY ***
Total pot $0.25 | Rake $0
Seat 3: mrpolelock (button) folded before Flop (didn't bet)
Seat 4: tapouttazz9 (small blind) folded before Flop
Seat 5: gutterdad60 (big blind) folded before Flop
Seat 6: tclick collected ($0.25)


PokerStars Hand #157039481694:  Hold'em No Limit ($0.05/$0.10 USD) - 2016/08/16 20:16:45 ET
Table 'Apus' 6-max Seat #4 is the button
Seat 3: mrpolelock ($10.95 in chips)
Seat 4: tapouttazz9 ($15.14 in chips)
Seat 5: gutterdad60 ($6.03 in chips)
Seat 6: tclick ($16.35 in chips)
gutterdad60: posts small blind $0.05
tclick: posts big blind $0.10
*** HOLE CARDS ***
Dealt to tapouttazz9 [2d Jc]
mrpolelock: folds
tapouttazz9: folds
Scooo13zzz joins the table at seat #1
gutterdad60: folds
Uncalled bet ($0.05) returned to tclick
tclick collected $0.10 from pot
*** SUMMARY ***
Total pot $0.10 | Rake $0
Seat 3: mrpolelock folded before Flop (didn't bet)
Seat 4: tapouttazz9 (button) folded before Flop (didn't bet)
Seat 5: gutterdad60 (small blind) folded before Flop
Seat 6: tclick (big blind) collected ($0.10)


PokerStars Hand #157039481762:  Hold'em No Limit ($0.05/$0.10 USD) - 2016/08/16 20:16:56 ET
Table 'Apus' 6-max Seat #5 is the button
Seat 1: Scooo13zzz ($10 in chips)
Seat 3: mrpolelock ($10.95 in chips)
Seat 4: tapouttazz9 ($15.14 in chips)
Seat 5: gutterdad60 ($5.98 in chips)
Seat 6: tclick ($16.40 in chips)
tclick: posts small blind $0.05
Scooo13zzz: posts big blind $0.10
*** HOLE CARDS ***
Dealt to tapouttazz9 [Ks Ad]
mrpolelock: raises $0.20 to $0.30
tapouttazz9: calls $0.30
gutterdad60: folds
tclick: folds
Scooo13zzz: raises $0.60 to $0.90
mrpolelock: folds
tapouttazz9: calls $0.60
*** FLOP *** [3s Js 3h]
Scooo13zzz: checks
tapouttazz9: bets $1.02
Scooo13zzz: folds
Uncalled bet ($1.02) returned to tapouttazz9
tapouttazz9 collected $2.04 from pot
*** SUMMARY ***
Total pot $2.15 | Rake $0.11
Board [3s Js 3h]
Seat 1: Scooo13zzz (big blind) folded on the Flop
Seat 3: mrpolelock folded before Flop
Seat 4: tapouttazz9 collected ($2.04)
Seat 5: gutterdad60 (button) folded before Flop (didn't bet)
Seat 6: tclick (small blind) folded before Flop


PokerStars Hand #157039482191:  Hold'em No Limit ($0.05/$0.10 USD) - 2016/08/16 20:18:11 ET
Table 'Apus' 6-max Seat #6 is the button
Seat 1: Scooo13zzz ($9.10 in chips)
Seat 3: mrpolelock ($10.65 in chips)
Seat 4: tapouttazz9 ($16.28 in chips)
Seat 5: gutterdad60 ($5.98 in chips)
Seat 6: tclick ($16.35 in chips)
Scooo13zzz: posts small blind $0.05
mrpolelock: posts big blind $0.10
*** HOLE CARDS ***
Dealt to tapouttazz9 [3d 2s]
tapouttazz9: folds
gutterdad60: folds
tclick: folds
Scooo13zzz: folds
Uncalled bet ($0.05) returned to mrpolelock
mrpolelock collected $0.10 from pot
mrpolelock: doesn't show hand
*** SUMMARY ***
Total pot $0.10 | Rake $0
Seat 1: Scooo13zzz (small blind) folded before Flop
Seat 3: mrpolelock (big blind) collected ($0.10)
Seat 4: tapouttazz9 folded before Flop (didn't bet)
Seat 5: gutterdad60 folded before Flop (didn't bet)
Seat 6: tclick (button) folded before Flop (didn't bet)


PokerStars Hand #157039482305:  Hold'em No Limit ($0.05/$0.10 USD) - 2016/08/16 20:18:33 ET
Table 'Apus' 6-max Seat #1 is the button
Seat 1: Scooo13zzz ($10 in chips)
Seat 3: mrpolelock ($10.70 in chips)
Seat 4: tapouttazz9 ($16.28 in chips)
Seat 5: gutterdad60 ($5.98 in chips)
Seat 6: tclick ($16.35 in chips)
mrpolelock: posts small blind $0.05
tapouttazz9: posts big blind $0.10
*** HOLE CARDS ***
Dealt to tapouttazz9 [6h 4c]
gutterdad60: folds
tclick: calls $0.10
Scooo13zzz: raises $0.30 to $0.40
mrpolelock: folds
tapouttazz9: folds
tclick: folds
Uncalled bet ($0.30) returned to Scooo13zzz
Scooo13zzz collected $0.35 from pot
*** SUMMARY ***
Total pot $0.35 | Rake $0
Seat 1: Scooo13zzz (button) collected ($0.35)
Seat 3: mrpolelock (small blind) folded before Flop
Seat 4: tapouttazz9 (big blind) folded before Flop
Seat 5: gutterdad60 folded before Flop (didn't bet)
Seat 6: tclick folded before Flop


PokerStars Hand #157039482590:  Hold'em No Limit ($0.05/$0.10 USD) - 2016/08/16 20:19:26 ET
Table 'Apus' 6-max Seat #3 is the button
Seat 1: Scooo13zzz ($10.25 in chips)
Seat 3: mrpolelock ($10.65 in chips)
Seat 4: tapouttazz9 ($16.18 in chips)
Seat 5: gutterdad60 ($5.98 in chips)
Seat 6: tclick ($16.25 in chips)
tapouttazz9: posts small blind $0.05
gutterdad60: posts big blind $0.10
*** HOLE CARDS ***
Dealt to tapouttazz9 [Ks Jd]
tclick: folds
Scooo13zzz: folds
mrpolelock: folds
tapouttazz9: raises $0.10 to $0.20
gutterdad60: raises $0.80 to $1
tapouttazz9: folds
Uncalled bet ($0.80) returned to gutterdad60
gutterdad60 collected $0.40 from pot
gutterdad60: doesn't show hand
*** SUMMARY ***
Total pot $0.40 | Rake $0
Seat 1: Scooo13zzz folded before Flop (didn't bet)
Seat 3: mrpolelock (button) folded before Flop (didn't bet)
Seat 4: tapouttazz9 (small blind) folded before Flop
Seat 5: gutterdad60 (big blind) collected ($0.40)
Seat 6: tclick folded before Flop (didn't bet)


PokerStars Hand #157039482720:  Hold'em No Limit ($0.05/$0.10 USD) - 2016/08/16 20:19:48 ET
Table 'Apus' 6-max Seat #4 is the button
Seat 1: Scooo13zzz ($10.25 in chips)
Seat 3: mrpolelock ($10.65 in chips)
Seat 4: tapouttazz9 ($15.98 in chips)
Seat 5: gutterdad60 ($6.18 in chips)
gutterdad60: posts small blind $0.05
tclick: is sitting out
Scooo13zzz: posts big blind $0.10
*** HOLE CARDS ***
Dealt to tapouttazz9 [4s 3s]
mrpolelock: calls $0.10
tapouttazz9: folds
gutterdad60: folds
tclick leaves the table
Scooo13zzz: checks
*** FLOP *** [7c 4h 2c]
Scooo13zzz: checks
mrpolelock: bets $0.10
Scooo13zzz: folds
Uncalled bet ($0.10) returned to mrpolelock
mrpolelock collected $0.24 from pot
mrpolelock: doesn't show hand
*** SUMMARY ***
Total pot $0.25 | Rake $0.01
Board [7c 4h 2c]
Seat 1: Scooo13zzz (big blind) folded on the Flop
Seat 3: mrpolelock collected ($0.24)
Seat 4: tapouttazz9 (button) folded before Flop (didn't bet)
Seat 5: gutterdad60 (small blind) folded before Flop


PokerStars Hand #157039482841:  Hold'em No Limit ($0.05/$0.10 USD) - 2016/08/16 20:20:10 ET
Table 'Apus' 6-max Seat #5 is the button
Seat 1: Scooo13zzz ($10.15 in chips)
Seat 3: mrpolelock ($10.79 in chips)
Seat 4: tapouttazz9 ($15.98 in chips)
Seat 5: gutterdad60 ($6.13 in chips)
Scooo13zzz: posts small blind $0.05
mrpolelock: posts big blind $0.10
*** HOLE CARDS ***
Dealt to tapouttazz9 [Qd 2c]
tapouttazz9: folds
gutterdad60: folds
Scooo13zzz: calls $0.05
mrpolelock: raises $0.20 to $0.30
Scooo13zzz: folds
Uncalled bet ($0.20) returned to mrpolelock
mrpolelock collected $0.20 from pot
mrpolelock: doesn't show hand
*** SUMMARY ***
Total pot $0.20 | Rake $0
Seat 1: Scooo13zzz (small blind) folded before Flop
Seat 3: mrpolelock (big blind) collected ($0.20)
Seat 4: tapouttazz9 folded before Flop (didn't bet)
Seat 5: gutterdad60 (button) folded before Flop (didn't bet)


PokerStars Hand #157039482967:  Hold'em No Limit ($0.05/$0.10 USD) - 2016/08/16 20:20:31 ET
Table 'Apus' 6-max Seat #1 is the button
Seat 1: Scooo13zzz ($10.05 in chips)
Seat 3: mrpolelock ($10.89 in chips)
Seat 4: tapouttazz9 ($15.98 in chips)
Seat 5: gutterdad60 ($6.13 in chips)
mrpolelock: posts small blind $0.05
tapouttazz9: posts big blind $0.10
*** HOLE CARDS ***
Dealt to tapouttazz9 [4h Qd]
gutterdad60: folds
Scooo13zzz: raises $0.20 to $0.30
mrpolelock: folds
tapouttazz9: folds
Uncalled bet ($0.20) returned to Scooo13zzz
Scooo13zzz collected $0.25 from pot
*** SUMMARY ***
Total pot $0.25 | Rake $0
Seat 1: Scooo13zzz (button) collected ($0.25)
Seat 3: mrpolelock (small blind) folded before Flop
Seat 4: tapouttazz9 (big blind) folded before Flop
Seat 5: gutterdad60 folded before Flop (didn't bet)


PokerStars Hand #157039483050:  Hold'em No Limit ($0.05/$0.10 USD) - 2016/08/16 20:20:46 ET
Table 'Apus' 6-max Seat #3 is the button
Seat 1: Scooo13zzz ($10.20 in chips)
Seat 3: mrpolelock ($10.84 in chips)
Seat 4: tapouttazz9 ($15.88 in chips)
Seat 5: gutterdad60 ($6.13 in chips)
tapouttazz9: posts small blind $0.05
gutterdad60: posts big blind $0.10
*** HOLE CARDS ***
Dealt to tapouttazz9 [8s 6d]
Scooo13zzz: folds
mrpolelock: folds
tapouttazz9: folds
Uncalled bet ($0.05) returned to gutterdad60
gutterdad60 collected $0.10 from pot
gutterdad60: doesn't show hand
*** SUMMARY ***
Total pot $0.10 | Rake $0
Seat 1: Scooo13zzz folded before Flop (didn't bet)
Seat 3: mrpolelock (button) folded before Flop (didn't bet)
Seat 4: tapouttazz9 (small blind) folded before Flop
Seat 5: gutterdad60 (big blind) collected ($0.10)


PokerStars Hand #157039483085:  Hold'em No Limit ($0.05/$0.10 USD) - 2016/08/16 20:20:51 ET
Table 'Apus' 6-max Seat #4 is the button
Seat 1: Scooo13zzz ($10.20 in chips)
Seat 3: mrpolelock ($10.84 in chips)
Seat 4: tapouttazz9 ($15.83 in chips)
Seat 5: gutterdad60 ($6.18 in chips)
gutterdad60: posts small blind $0.05
Scooo13zzz: posts big blind $0.10
*** HOLE CARDS ***
Dealt to tapouttazz9 [9d Jc]
mrpolelock: calls $0.10
tapouttazz9: raises $0.20 to $0.30
gutterdad60: folds
Scooo13zzz: folds
mrpolelock: calls $0.20
*** FLOP *** [7s 5c 2c]
mrpolelock: checks
tapouttazz9: bets $0.35
mrpolelock: calls $0.35
*** TURN *** [7s 5c 2c] [9s]
mrpolelock: checks
tapouttazz9: checks
*** RIVER *** [7s 5c 2c 9s] [Qd]
mrpolelock: bets $0.69
tapouttazz9: calls $0.69
*** SHOW DOWN ***
mrpolelock: shows [7c Qc] (two pair, Queens and Sevens)
tapouttazz9: mucks hand
mrpolelock collected $2.69 from pot
*** SUMMARY ***
Total pot $2.83 | Rake $0.14
Board [7s 5c 2c 9s Qd]
Seat 1: Scooo13zzz (big blind) folded before Flop
Seat 3: mrpolelock showed [7c Qc] and won ($2.69) with two pair, Queens and Sevens
Seat 4: tapouttazz9 (button) mucked [9d Jc]
Seat 5: gutterdad60 (small blind) folded before Flop


PokerStars Hand #157039483296:  Hold'em No Limit ($0.05/$0.10 USD) - 2016/08/16 20:21:25 ET
Table 'Apus' 6-max Seat #5 is the button
Seat 1: Scooo13zzz ($10.10 in chips)
Seat 3: mrpolelock ($12.19 in chips)
Seat 4: tapouttazz9 ($14.49 in chips)
Seat 5: gutterdad60 ($6.13 in chips)
Scooo13zzz: posts small blind $0.05
mrpolelock: posts big blind $0.10
*** HOLE CARDS ***
Dealt to tapouttazz9 [4c 7c]
77Moriarty joins the table at seat #6
tapouttazz9: folds
gutterdad60: folds
Scooo13zzz: calls $0.05
mrpolelock: checks
*** FLOP *** [Td Js 8c]
Scooo13zzz: checks
mrpolelock: bets $0.10
Scooo13zzz: raises $0.20 to $0.30
mrpolelock: calls $0.20
*** TURN *** [Td Js 8c] [7h]
Scooo13zzz: checks
mrpolelock: checks
*** RIVER *** [Td Js 8c 7h] [Ad]
Scooo13zzz: checks
mrpolelock: checks
*** SHOW DOWN ***
Scooo13zzz: shows [8s Th] (two pair, Tens and Eights)
mrpolelock: mucks hand
Scooo13zzz collected $0.76 from pot
*** SUMMARY ***
Total pot $0.80 | Rake $0.04
Board [Td Js 8c 7h Ad]
Seat 1: Scooo13zzz (small blind) showed [8s Th] and won ($0.76) with two pair, Tens and Eights
Seat 3: mrpolelock (big blind) mucked [Ah Qd]
Seat 4: tapouttazz9 folded before Flop (didn't bet)
Seat 5: gutterdad60 (button) folded before Flop (didn't bet)


PokerStars Hand #157039483540:  Hold'em No Limit ($0.05/$0.10 USD) - 2016/08/16 20:22:06 ET
Table 'Apus' 6-max Seat #1 is the button
Seat 1: Scooo13zzz ($10.46 in chips)
Seat 3: mrpolelock ($11.79 in chips)
Seat 4: tapouttazz9 ($14.49 in chips)
Seat 5: gutterdad60 ($6.13 in chips)
mrpolelock: posts small blind $0.05
tapouttazz9: posts big blind $0.10
77Moriarty: sits out
*** HOLE CARDS ***
Dealt to tapouttazz9 [8h 3c]
gutterdad60: folds
Scooo13zzz: raises $0.20 to $0.30
mrpolelock: folds
gutterdad60 leaves the table
tapouttazz9: folds
Uncalled bet ($0.20) returned to Scooo13zzz
Scooo13zzz collected $0.25 from pot
*** SUMMARY ***
Total pot $0.25 | Rake $0
Seat 1: Scooo13zzz (button) collected ($0.25)
Seat 3: mrpolelock (small blind) folded before Flop
Seat 4: tapouttazz9 (big blind) folded before Flop
Seat 5: gutterdad60 folded before Flop (didn't bet)


PokerStars Hand #157039483636:  Hold'em No Limit ($0.05/$0.10 USD) - 2016/08/16 20:22:20 ET
Table 'Apus' 6-max Seat #3 is the button
Seat 1: Scooo13zzz ($10.61 in chips)
Seat 3: mrpolelock ($11.74 in chips)
Seat 4: tapouttazz9 ($14.39 in chips)
Seat 6: 77Moriarty ($8 in chips)
tapouttazz9: posts small blind $0.05
77Moriarty: posts big blind $0.10
*** HOLE CARDS ***
Dealt to tapouttazz9 [Kh 5h]
Scooo13zzz: raises $0.20 to $0.30
mrpolelock: folds
tapouttazz9: calls $0.25
77Moriarty: folds
*** FLOP *** [2d 7d 2h]
tapouttazz9: checks
Scooo13zzz: bets $0.40
tapouttazz9: calls $0.40
*** TURN *** [2d 7d 2h] [Ad]
tapouttazz9: bets $1.42
StatenRyan18 joins the table at seat #5
Scooo13zzz: calls $1.42
*** RIVER *** [2d 7d 2h Ad] [Jd]
tapouttazz9: bets $2.06
Scooo13zzz: folds
Uncalled bet ($2.06) returned to tapouttazz9
tapouttazz9 collected $4.12 from pot
*** SUMMARY ***
Total pot $4.34 | Rake $0.22
Board [2d 7d 2h Ad Jd]
Seat 1: Scooo13zzz folded on the River
Seat 3: mrpolelock (button) folded before Flop (didn't bet)
Seat 4: tapouttazz9 (small blind) collected ($4.12)
Seat 6: 77Moriarty (big blind) folded before Flop


PokerStars Hand #157039484040:  Hold'em No Limit ($0.05/$0.10 USD) - 2016/08/16 20:23:38 ET
Table 'Apus' 6-max Seat #4 is the button
Seat 1: Scooo13zzz ($8.49 in chips)
Seat 3: mrpolelock ($11.74 in chips)
Seat 4: tapouttazz9 ($16.39 in chips)
Seat 6: 77Moriarty ($7.90 in chips)
StatenRyan18 will be allowed to play after the button
77Moriarty: posts small blind $0.05
Scooo13zzz: posts big blind $0.10
*** HOLE CARDS ***
Dealt to tapouttazz9 [Ks 7h]
mrpolelock: folds
tapouttazz9: folds
77Moriarty: folds
Uncalled bet ($0.05) returned to Scooo13zzz
Scooo13zzz collected $0.10 from pot
*** SUMMARY ***
Total pot $0.10 | Rake $0
Seat 1: Scooo13zzz (big blind) collected ($0.10)
Seat 3: mrpolelock folded before Flop (didn't bet)
Seat 4: tapouttazz9 (button) folded before Flop (didn't bet)
Seat 6: 77Moriarty (small blind) folded before Flop


PokerStars Hand #157039484089:  Hold'em No Limit ($0.05/$0.10 USD) - 2016/08/16 20:23:47 ET
Table 'Apus' 6-max Seat #6 is the button
Seat 1: Scooo13zzz ($10 in chips)
Seat 3: mrpolelock ($11.74 in chips)
Seat 4: tapouttazz9 ($16.39 in chips)
Seat 6: 77Moriarty ($7.85 in chips)
Scooo13zzz: posts small blind $0.05
mrpolelock: posts big blind $0.10
StatenRyan18: sits out
*** HOLE CARDS ***
Dealt to tapouttazz9 [5h 6d]
tapouttazz9: folds
77Moriarty: calls $0.10
Scooo13zzz: calls $0.05
StatenRyan18 leaves the table
mrpolelock: checks
*** FLOP *** [5d Ac 8d]
Scooo13zzz: checks
mrpolelock: bets $0.10
77Moriarty: folds
Scooo13zzz: folds
Uncalled bet ($0.10) returned to mrpolelock
gambit3755 joins the table at seat #5
mrpolelock collected $0.28 from pot
mrpolelock: doesn't show hand
*** SUMMARY ***
Total pot $0.30 | Rake $0.02
Board [5d Ac 8d]
Seat 1: Scooo13zzz (small blind) folded on the Flop
Seat 3: mrpolelock (big blind) collected ($0.28)
Seat 4: tapouttazz9 folded before Flop (didn't bet)
Seat 6: 77Moriarty (button) folded on the Flop


PokerStars Hand #157039484209:  Hold'em No Limit ($0.05/$0.10 USD) - 2016/08/16 20:24:11 ET
Table 'Apus' 6-max Seat #1 is the button
Seat 1: Scooo13zzz ($9.90 in chips)
Seat 3: mrpolelock ($11.92 in chips)
Seat 4: tapouttazz9 ($16.39 in chips)
Seat 6: 77Moriarty ($7.75 in chips)
mrpolelock: posts small blind $0.05
tapouttazz9: posts big blind $0.10
gambit3755: sits out
*** HOLE CARDS ***
Dealt to tapouttazz9 [5d 4s]
77Moriarty: calls $0.10
Scooo13zzz: raises $0.20 to $0.30
mrpolelock: folds
tapouttazz9: folds
77Moriarty: calls $0.20
*** FLOP *** [9s Kh 3h]
77Moriarty: bets $0.10
Scooo13zzz: raises $0.54 to $0.64
77Moriarty: calls $0.54
*** TURN *** [9s Kh 3h] [4h]
77Moriarty: checks
Scooo13zzz: bets $1.15
77Moriarty: folds
Uncalled bet ($1.15) returned to Scooo13zzz
Scooo13zzz collected $1.93 from pot
*** SUMMARY ***
Total pot $2.03 | Rake $0.10
Board [9s Kh 3h 4h]
Seat 1: Scooo13zzz (button) collected ($1.93)
Seat 3: mrpolelock (small blind) folded before Flop
Seat 4: tapouttazz9 (big blind) folded before Flop
Seat 6: 77Moriarty folded on the Turn


PokerStars Hand #157039484508:  Hold'em No Limit ($0.05/$0.10 USD) - 2016/08/16 20:25:05 ET
Table 'Apus' 6-max Seat #3 is the button
Seat 1: Scooo13zzz ($10.89 in chips)
Seat 3: mrpolelock ($11.87 in chips)
Seat 4: tapouttazz9 ($16.29 in chips)
Seat 5: gambit3755 ($8 in chips)
Seat 6: 77Moriarty ($6.81 in chips)
tapouttazz9: posts small blind $0.05
gambit3755: posts big blind $0.10
*** HOLE CARDS ***
Dealt to tapouttazz9 [7h Kh]
77Moriarty: calls $0.10
Scooo13zzz: folds
mrpolelock: calls $0.10
tapouttazz9: calls $0.05
gambit3755: raises $0.40 to $0.50
77Moriarty: folds
mrpolelock: folds
tapouttazz9: calls $0.40
*** FLOP *** [4s Th Js]
tapouttazz9: bets $0.57
gambit3755: calls $0.57
*** TURN *** [4s Th Js] [4h]
tapouttazz9: bets $1.11
gambit3755: calls $1.11
*** RIVER *** [4s Th Js 4h] [5h]
tapouttazz9: bets $14.11 and is all-in
gambit3755: calls $5.82 and is all-in
Uncalled bet ($8.29) returned to tapouttazz9
*** SHOW DOWN ***
tapouttazz9: shows [7h Kh] (a flush, King high)
gambit3755: shows [Ah Kc] (a pair of Fours)
tapouttazz9 collected $15.39 from pot
*** SUMMARY ***
Total pot $16.20 | Rake $0.81
Board [4s Th Js 4h 5h]
Seat 1: Scooo13zzz folded before Flop (didn't bet)
Seat 3: mrpolelock (button) folded before Flop
Seat 4: tapouttazz9 (small blind) showed [7h Kh] and won ($15.39) with a flush, King high
Seat 5: gambit3755 (big blind) showed [Ah Kc] and lost with a pair of Fours
Seat 6: 77Moriarty folded before Flop


PokerStars Hand #157039484754:  Hold'em No Limit ($0.05/$0.10 USD) - 2016/08/16 20:25:51 ET
Table 'Apus' 6-max Seat #4 is the button
Seat 1: Scooo13zzz ($10.89 in chips)
Seat 3: mrpolelock ($11.77 in chips)
Seat 4: tapouttazz9 ($23.68 in chips)
Seat 6: 77Moriarty ($6.71 in chips)
77Moriarty: posts small blind $0.05
Scooo13zzz: posts big blind $0.10
*** HOLE CARDS ***
Dealt to tapouttazz9 [7d Tc]
mrpolelock: folds
tapouttazz9: folds
gambit3755 leaves the table
77Moriarty: folds
Uncalled bet ($0.05) returned to Scooo13zzz
Scooo13zzz collected $0.10 from pot
*** SUMMARY ***
Total pot $0.10 | Rake $0
Seat 1: Scooo13zzz (big blind) collected ($0.10)
Seat 3: mrpolelock folded before Flop (didn't bet)
Seat 4: tapouttazz9 (button) folded before Flop (didn't bet)
Seat 6: 77Moriarty (small blind) folded before Flop


PokerStars Hand #157066438927:  Hold'em No Limit ($0.05/$0.10 USD) - 2016/08/17 17:06:03 ET
Table 'Kraz' 6-max Seat #1 is the button
Seat 1: scrapmetal9 ($9.19 in chips)
Seat 2: Mattymar98 ($8.05 in chips)
Seat 3: tapouttazz9 ($10 in chips)
Seat 4: dougwid ($11.61 in chips)
Seat 5: DaGr8Gatzby ($12.05 in chips)
Seat 6: lacilobaid ($17.69 in chips)
Mattymar98: posts small blind $0.05
tapouttazz9: posts big blind $0.10
*** HOLE CARDS ***
Dealt to tapouttazz9 [7c 7h]
dougwid: calls $0.10
DaGr8Gatzby: folds
lacilobaid: folds
scrapmetal9: folds
Mattymar98: calls $0.05
tapouttazz9: checks
*** FLOP *** [Ts Th 3s]
Mattymar98: checks
tapouttazz9: bets $0.14
dougwid: folds
Mattymar98: folds
Uncalled bet ($0.14) returned to tapouttazz9
tapouttazz9 collected $0.28 from pot
*** SUMMARY ***
Total pot $0.30 | Rake $0.02
Board [Ts Th 3s]
Seat 1: scrapmetal9 (button) folded before Flop (didn't bet)
Seat 2: Mattymar98 (small blind) folded on the Flop
Seat 3: tapouttazz9 (big blind) collected ($0.28)
Seat 4: dougwid folded on the Flop
Seat 5: DaGr8Gatzby folded before Flop (didn't bet)
Seat 6: lacilobaid folded before Flop (didn't bet)


PokerStars Hand #157066439081:  Hold'em No Limit ($0.05/$0.10 USD) - 2016/08/17 17:06:40 ET
Table 'Kraz' 6-max Seat #2 is the button
Seat 1: scrapmetal9 ($9.19 in chips)
Seat 2: Mattymar98 ($7.95 in chips)
Seat 3: tapouttazz9 ($10.18 in chips)
Seat 4: dougwid ($11.51 in chips)
Seat 5: DaGr8Gatzby ($12.05 in chips)
Seat 6: lacilobaid ($17.69 in chips)
tapouttazz9: posts small blind $0.05
dougwid: posts big blind $0.10
*** HOLE CARDS ***
Dealt to tapouttazz9 [Jc 9d]
DaGr8Gatzby: folds
lacilobaid: folds
scrapmetal9: folds
Mattymar98: folds
tapouttazz9: folds
Uncalled bet ($0.05) returned to dougwid
dougwid collected $0.10 from pot
dougwid: doesn't show hand
*** SUMMARY ***
Total pot $0.10 | Rake $0
Seat 1: scrapmetal9 folded before Flop (didn't bet)
Seat 2: Mattymar98 (button) folded before Flop (didn't bet)
Seat 3: tapouttazz9 (small blind) folded before Flop
Seat 4: dougwid (big blind) collected ($0.10)
Seat 5: DaGr8Gatzby folded before Flop (didn't bet)
Seat 6: lacilobaid folded before Flop (didn't bet)


PokerStars Hand #157066439143:  Hold'em No Limit ($0.05/$0.10 USD) - 2016/08/17 17:06:56 ET
Table 'Kraz' 6-max Seat #3 is the button
Seat 1: scrapmetal9 ($9.19 in chips)
Seat 2: Mattymar98 ($7.95 in chips)
Seat 3: tapouttazz9 ($10.13 in chips)
Seat 4: dougwid ($11.56 in chips)
Seat 6: lacilobaid ($17.69 in chips)
dougwid: posts small blind $0.05
DaGr8Gatzby: is sitting out
DaGr8Gatzby leaves the table
lacilobaid: posts big blind $0.10
*** HOLE CARDS ***
Dealt to tapouttazz9 [3s As]
scrapmetal9: folds
imsobad402 joins the table at seat #5
Mattymar98: folds
tapouttazz9: raises $0.10 to $0.20
dougwid: raises $0.50 to $0.70
lacilobaid: folds
tapouttazz9: folds
Uncalled bet ($0.50) returned to dougwid
dougwid collected $0.50 from pot
dougwid: doesn't show hand
*** SUMMARY ***
Total pot $0.50 | Rake $0
Seat 1: scrapmetal9 folded before Flop (didn't bet)
Seat 2: Mattymar98 folded before Flop (didn't bet)
Seat 3: tapouttazz9 (button) folded before Flop
Seat 4: dougwid (small blind) collected ($0.50)
Seat 6: lacilobaid (big blind) folded before Flop


PokerStars Hand #157066439274:  Hold'em No Limit ($0.05/$0.10 USD) - 2016/08/17 17:07:27 ET
Table 'Kraz' 6-max Seat #4 is the button
Seat 1: scrapmetal9 ($9.19 in chips)
Seat 2: Mattymar98 ($7.95 in chips)
Seat 3: tapouttazz9 ($9.93 in chips)
Seat 4: dougwid ($11.86 in chips)
Seat 6: lacilobaid ($17.59 in chips)
imsobad402 will be allowed to play after the button
lacilobaid: posts small blind $0.05
scrapmetal9: posts big blind $0.10
*** HOLE CARDS ***
Dealt to tapouttazz9 [6c Js]
Mattymar98: folds
tapouttazz9: folds
dougwid: raises $0.25 to $0.35
lacilobaid: calls $0.30
scrapmetal9: folds
*** FLOP *** [8d Ad Th]
lacilobaid: checks
dougwid: checks
*** TURN *** [8d Ad Th] [9d]
lacilobaid: checks
dougwid: bets $0.38
lacilobaid: folds
Uncalled bet ($0.38) returned to dougwid
dougwid collected $0.76 from pot
dougwid: doesn't show hand
*** SUMMARY ***
Total pot $0.80 | Rake $0.04
Board [8d Ad Th 9d]
Seat 1: scrapmetal9 (big blind) folded before Flop
Seat 2: Mattymar98 folded before Flop (didn't bet)
Seat 3: tapouttazz9 folded before Flop (didn't bet)
Seat 4: dougwid (button) collected ($0.76)
Seat 6: lacilobaid (small blind) folded on the Turn


PokerStars Hand #157066439412:  Hold'em No Limit ($0.05/$0.10 USD) - 2016/08/17 17:07:56 ET
Table 'Kraz' 6-max Seat #6 is the button
Seat 1: scrapmetal9 ($9.09 in chips)
Seat 2: Mattymar98 ($7.95 in chips)
Seat 3: tapouttazz9 ($9.93 in chips)
Seat 4: dougwid ($12.27 in chips)
Seat 6: lacilobaid ($17.24 in chips)
scrapmetal9: posts small blind $0.05
Mattymar98: posts big blind $0.10
imsobad402: sits out
*** HOLE CARDS ***
Dealt to tapouttazz9 [2c Qh]
tapouttazz9: folds
dougwid: folds
lacilobaid: folds
scrapmetal9: folds
Uncalled bet ($0.05) returned to Mattymar98
Mattymar98 collected $0.10 from pot
*** SUMMARY ***
Total pot $0.10 | Rake $0
Seat 1: scrapmetal9 (small blind) folded before Flop
Seat 2: Mattymar98 (big blind) collected ($0.10)
Seat 3: tapouttazz9 folded before Flop (didn't bet)
Seat 4: dougwid folded before Flop (didn't bet)
Seat 6: lacilobaid (button) folded before Flop (didn't bet)


PokerStars Hand #157066439454:  Hold'em No Limit ($0.05/$0.10 USD) - 2016/08/17 17:08:05 ET
Table 'Kraz' 6-max Seat #1 is the button
Seat 1: scrapmetal9 ($9.04 in chips)
Seat 2: Mattymar98 ($8 in chips)
Seat 3: tapouttazz9 ($9.93 in chips)
Seat 4: dougwid ($12.27 in chips)
Seat 6: lacilobaid ($17.24 in chips)
Mattymar98: posts small blind $0.05
tapouttazz9: posts big blind $0.10
imsobad402: sits out
*** HOLE CARDS ***
Dealt to tapouttazz9 [2h 5h]
dougwid: folds
lacilobaid: folds
scrapmetal9: folds
Mattymar98: folds
Uncalled bet ($0.05) returned to tapouttazz9
tapouttazz9 collected $0.10 from pot
*** SUMMARY ***
Total pot $0.10 | Rake $0
Seat 1: scrapmetal9 (button) folded before Flop (didn't bet)
Seat 2: Mattymar98 (small blind) folded before Flop
Seat 3: tapouttazz9 (big blind) collected ($0.10)
Seat 4: dougwid folded before Flop (didn't bet)
Seat 6: lacilobaid folded before Flop (didn't bet)


PokerStars Hand #157066439506:  Hold'em No Limit ($0.05/$0.10 USD) - 2016/08/17 17:08:16 ET
Table 'Kraz' 6-max Seat #2 is the button
Seat 1: scrapmetal9 ($9.04 in chips)
Seat 2: Mattymar98 ($7.95 in chips)
Seat 3: tapouttazz9 ($9.98 in chips)
Seat 4: dougwid ($12.27 in chips)
Seat 6: lacilobaid ($17.24 in chips)
tapouttazz9: posts small blind $0.05
dougwid: posts big blind $0.10
imsobad402: sits out
*** HOLE CARDS ***
Dealt to tapouttazz9 [9s Kh]
lacilobaid: folds
scrapmetal9: raises $0.25 to $0.35
Mattymar98: folds
tapouttazz9: calls $0.30
dougwid: folds
*** FLOP *** [2s 9h 9c]
tapouttazz9: checks
scrapmetal9: bets $0.80
tapouttazz9: calls $0.80
*** TURN *** [2s 9h 9c] [Qd]
tapouttazz9: checks
scrapmetal9: bets $2.30
tapouttazz9: calls $2.30
*** RIVER *** [2s 9h 9c Qd] [Kc]
tapouttazz9: bets $6.53 and is all-in
scrapmetal9: calls $5.59 and is all-in
Uncalled bet ($0.94) returned to tapouttazz9
*** SHOW DOWN ***
tapouttazz9: shows [9s Kh] (a full house, Nines full of Kings)
scrapmetal9: shows [Ad Ks] (two pair, Kings and Nines)
tapouttazz9 collected $17.27 from pot
*** SUMMARY ***
Total pot $18.18 | Rake $0.91
Board [2s 9h 9c Qd Kc]
Seat 1: scrapmetal9 showed [Ad Ks] and lost with two pair, Kings and Nines
Seat 2: Mattymar98 (button) folded before Flop (didn't bet)
Seat 3: tapouttazz9 (small blind) showed [9s Kh] and won ($17.27) with a full house, Nines full of Kings
Seat 4: dougwid (big blind) folded before Flop
Seat 6: lacilobaid folded before Flop (didn't bet)


PokerStars Hand #157066439791:  Hold'em No Limit ($0.05/$0.10 USD) - 2016/08/17 17:09:25 ET
Table 'Kraz' 6-max Seat #3 is the button
Seat 2: Mattymar98 ($7.95 in chips)
Seat 3: tapouttazz9 ($18.21 in chips)
Seat 4: dougwid ($12.17 in chips)
Seat 5: imsobad402 ($8 in chips)
Seat 6: lacilobaid ($17.24 in chips)
dougwid: posts small blind $0.05
imsobad402: posts big blind $0.10
*** HOLE CARDS ***
Dealt to tapouttazz9 [8d 5d]
lacilobaid: folds
Mattymar98: folds
tapouttazz9: folds
scrapmetal9 leaves the table
dougwid: calls $0.05
lacilobaid is disconnected
imsobad402: raises $0.20 to $0.30
dougwid: calls $0.20
*** FLOP *** [3h 4d Kd]
dougwid: checks
imsobad402: bets $0.30
dougwid: calls $0.30
*** TURN *** [3h 4d Kd] [3d]
dougwid: checks
imsobad402: bets $1.14
dougwid: calls $1.14
*** RIVER *** [3h 4d Kd 3d] [2s]
dougwid: checks
imsobad402: bets $3.31
dougwid: folds
Uncalled bet ($3.31) returned to imsobad402
imsobad402 collected $3.31 from pot
imsobad402: doesn't show hand
*** SUMMARY ***
Total pot $3.48 | Rake $0.17
Board [3h 4d Kd 3d 2s]
Seat 2: Mattymar98 folded before Flop (didn't bet)
Seat 3: tapouttazz9 (button) folded before Flop (didn't bet)
Seat 4: dougwid (small blind) folded on the River
Seat 5: imsobad402 (big blind) collected ($3.31)
Seat 6: lacilobaid folded before Flop (didn't bet)


PokerStars Hand #157066725655:  Hold'em No Limit ($0.05/$0.10 USD) - 2016/08/17 17:11:08 ET
Table 'Kraz' 6-max Seat #4 is the button
Seat 2: Mattymar98 ($10 in chips)
Seat 3: tapouttazz9 ($18.21 in chips)
Seat 4: dougwid ($10.43 in chips)
Seat 5: imsobad402 ($9.57 in chips)
imsobad402: posts small blind $0.05
Mattymar98: posts big blind $0.10
*** HOLE CARDS ***
Dealt to tapouttazz9 [2d Kd]
tapouttazz9: folds
dougwid: folds
imsobad402: folds
Uncalled bet ($0.05) returned to Mattymar98
Mattymar98 collected $0.10 from pot
*** SUMMARY ***
Total pot $0.10 | Rake $0
Seat 2: Mattymar98 (big blind) collected ($0.10)
Seat 3: tapouttazz9 folded before Flop (didn't bet)
Seat 4: dougwid (button) folded before Flop (didn't bet)
Seat 5: imsobad402 (small blind) folded before Flop


PokerStars Hand #157066725794:  Hold'em No Limit ($0.05/$0.10 USD) - 2016/08/17 17:11:37 ET
Table 'Kraz' 6-max Seat #5 is the button
Seat 2: Mattymar98 ($10.05 in chips)
Seat 3: tapouttazz9 ($18.21 in chips)
Seat 4: dougwid ($10.43 in chips)
Seat 5: imsobad402 ($9.52 in chips)
Mattymar98: posts small blind $0.05
tapouttazz9: posts big blind $0.10
*** HOLE CARDS ***
Dealt to tapouttazz9 [4h Qh]
dougwid: raises $0.25 to $0.35
imsobad402: folds
Mattymar98: folds
tapouttazz9: folds
Uncalled bet ($0.25) returned to dougwid
dougwid collected $0.25 from pot
dougwid: doesn't show hand
*** SUMMARY ***
Total pot $0.25 | Rake $0
Seat 2: Mattymar98 (small blind) folded before Flop
Seat 3: tapouttazz9 (big blind) folded before Flop
Seat 4: dougwid collected ($0.25)
Seat 5: imsobad402 (button) folded before Flop (didn't bet)


PokerStars Hand #157066725878:  Hold'em No Limit ($0.05/$0.10 USD) - 2016/08/17 17:11:56 ET
Table 'Kraz' 6-max Seat #2 is the button
Seat 2: Mattymar98 ($10 in chips)
Seat 3: tapouttazz9 ($18.11 in chips)
Seat 4: dougwid ($10.58 in chips)
Seat 5: imsobad402 ($9.52 in chips)
tapouttazz9: posts small blind $0.05
dougwid: posts big blind $0.10
*** HOLE CARDS ***
Dealt to tapouttazz9 [2d 4d]
imsobad402: folds
Mattymar98: folds
tapouttazz9: folds
Uncalled bet ($0.05) returned to dougwid
dougwid collected $0.10 from pot
dougwid: doesn't show hand
*** SUMMARY ***
Total pot $0.10 | Rake $0
Seat 2: Mattymar98 (button) folded before Flop (didn't bet)
Seat 3: tapouttazz9 (small blind) folded before Flop
Seat 4: dougwid (big blind) collected ($0.10)
Seat 5: imsobad402 folded before Flop (didn't bet)


PokerStars Hand #157066725911:  Hold'em No Limit ($0.05/$0.10 USD) - 2016/08/17 17:12:04 ET
Table 'Kraz' 6-max Seat #3 is the button
Seat 2: Mattymar98 ($10 in chips)
Seat 3: tapouttazz9 ($18.06 in chips)
Seat 4: dougwid ($10.63 in chips)
Seat 5: imsobad402 ($9.52 in chips)
dougwid: posts small blind $0.05
imsobad402: posts big blind $0.10
*** HOLE CARDS ***
Dealt to tapouttazz9 [Tc 6h]
Mattymar98: folds
tapouttazz9: folds
dougwid: calls $0.05
imsobad402: checks
*** FLOP *** [Jd 2h Qc]
dougwid: checks
imsobad402: bets $0.10
dougwid: folds
Uncalled bet ($0.10) returned to imsobad402
imsobad402 collected $0.19 from pot
imsobad402: doesn't show hand
*** SUMMARY ***
Total pot $0.20 | Rake $0.01
Board [Jd 2h Qc]
Seat 2: Mattymar98 folded before Flop (didn't bet)
Seat 3: tapouttazz9 (button) folded before Flop (didn't bet)
Seat 4: dougwid (small blind) folded on the Flop
Seat 5: imsobad402 (big blind) collected ($0.19)


PokerStars Hand #157066726118:  Hold'em No Limit ($0.05/$0.10 USD) - 2016/08/17 17:12:50 ET
Table 'Kraz' 6-max Seat #4 is the button
Seat 2: Mattymar98 ($10 in chips)
Seat 3: tapouttazz9 ($18.06 in chips)
Seat 4: dougwid ($10.53 in chips)
Seat 5: imsobad402 ($9.61 in chips)
imsobad402: posts small blind $0.05
Mattymar98: posts big blind $0.10
*** HOLE CARDS ***
Dealt to tapouttazz9 [5h 8s]
tapouttazz9: folds
dougwid: raises $0.25 to $0.35
imsobad402: folds
Mattymar98: folds
Uncalled bet ($0.25) returned to dougwid
dougwid collected $0.25 from pot
dougwid: doesn't show hand
*** SUMMARY ***
Total pot $0.25 | Rake $0
Seat 2: Mattymar98 (big blind) folded before Flop
Seat 3: tapouttazz9 folded before Flop (didn't bet)
Seat 4: dougwid (button) collected ($0.25)
Seat 5: imsobad402 (small blind) folded before Flop


PokerStars Hand #157066726224:  Hold'em No Limit ($0.05/$0.10 USD) - 2016/08/17 17:13:09 ET
Table 'Kraz' 6-max Seat #5 is the button
Seat 2: Mattymar98 ($9.90 in chips)
Seat 3: tapouttazz9 ($18.06 in chips)
Seat 4: dougwid ($10.68 in chips)
Seat 5: imsobad402 ($9.56 in chips)
Mattymar98: posts small blind $0.05
tapouttazz9: posts big blind $0.10
*** HOLE CARDS ***
Dealt to tapouttazz9 [Jh 4h]
dougwid: folds
imsobad402: raises $0.20 to $0.30
Mattymar98: folds
tapouttazz9: calls $0.20
*** FLOP *** [Qd Ah Tc]
tapouttazz9: checks
imsobad402: bets $0.30
tapouttazz9: calls $0.30
*** TURN *** [Qd Ah Tc] [Kd]
tapouttazz9: checks
imsobad402: bets $0.59
tapouttazz9: calls $0.59
*** RIVER *** [Qd Ah Tc Kd] [2c]
tapouttazz9: bets $2.31
imsobad402: folds
Uncalled bet ($2.31) returned to tapouttazz9
tapouttazz9 collected $2.31 from pot
*** SUMMARY ***
Total pot $2.43 | Rake $0.12
Board [Qd Ah Tc Kd 2c]
Seat 2: Mattymar98 (small blind) folded before Flop
Seat 3: tapouttazz9 (big blind) collected ($2.31)
Seat 4: dougwid folded before Flop (didn't bet)
Seat 5: imsobad402 (button) folded on the River


PokerStars Hand #157066726526:  Hold'em No Limit ($0.05/$0.10 USD) - 2016/08/17 17:14:15 ET
Table 'Kraz' 6-max Seat #2 is the button
Seat 2: Mattymar98 ($9.85 in chips)
Seat 3: tapouttazz9 ($19.18 in chips)
Seat 4: dougwid ($10.68 in chips)
Seat 5: imsobad402 ($8.37 in chips)
tapouttazz9: posts small blind $0.05
dougwid: posts big blind $0.10
*** HOLE CARDS ***
Dealt to tapouttazz9 [9c 8h]
imsobad402: folds
JoeFrosty joins the table at seat #6
Mattymar98: raises $0.20 to $0.30
tapouttazz9: calls $0.25
dougwid: calls $0.20
*** FLOP *** [6h 2h Kh]
tapouttazz9: checks
dougwid: checks
Mattymar98: checks
*** TURN *** [6h 2h Kh] [5c]
tapouttazz9: bets $0.30
dougwid: calls $0.30
Mattymar98: folds
*** RIVER *** [6h 2h Kh 5c] [Jh]
tapouttazz9: bets $0.71
dougwid: calls $0.71
*** SHOW DOWN ***
tapouttazz9: shows [9c 8h] (a flush, King high)
dougwid: mucks hand
tapouttazz9 collected $2.77 from pot
*** SUMMARY ***
Total pot $2.92 | Rake $0.15
Board [6h 2h Kh 5c Jh]
Seat 2: Mattymar98 (button) folded on the Turn
Seat 3: tapouttazz9 (small blind) showed [9c 8h] and won ($2.77) with a flush, King high
Seat 4: dougwid (big blind) mucked [Ks Qd]
Seat 5: imsobad402 folded before Flop (didn't bet)


PokerStars Hand #157066726770:  Hold'em No Limit ($0.05/$0.10 USD) - 2016/08/17 17:15:12 ET
Table 'Kraz' 6-max Seat #3 is the button
Seat 2: Mattymar98 ($9.55 in chips)
Seat 3: tapouttazz9 ($20.64 in chips)
Seat 4: dougwid ($9.37 in chips)
Seat 5: imsobad402 ($8.37 in chips)
Seat 6: JoeFrosty ($8 in chips)
dougwid: posts small blind $0.05
imsobad402: posts big blind $0.10
JoeFrosty: posts big blind $0.10
*** HOLE CARDS ***
Dealt to tapouttazz9 [4c 9d]
JoeFrosty: checks
Mattymar98: folds
tapouttazz9: folds
dougwid: folds
imsobad402: checks
*** FLOP *** [9s Jc 5c]
imsobad402: checks
JoeFrosty: checks
*** TURN *** [9s Jc 5c] [6s]
imsobad402: bets $0.24
JoeFrosty: folds
Uncalled bet ($0.24) returned to imsobad402
imsobad402 collected $0.24 from pot
imsobad402: doesn't show hand
*** SUMMARY ***
Total pot $0.25 | Rake $0.01
Board [9s Jc 5c 6s]
Seat 2: Mattymar98 folded before Flop (didn't bet)
Seat 3: tapouttazz9 (button) folded before Flop (didn't bet)
Seat 4: dougwid (small blind) folded before Flop
Seat 5: imsobad402 (big blind) collected ($0.24)
Seat 6: JoeFrosty folded on the Turn


PokerStars Hand #157066726944:  Hold'em No Limit ($0.05/$0.10 USD) - 2016/08/17 17:15:51 ET
Table 'Kraz' 6-max Seat #4 is the button
Seat 2: Mattymar98 ($9.55 in chips)
Seat 3: tapouttazz9 ($20.64 in chips)
Seat 4: dougwid ($9.32 in chips)
Seat 5: imsobad402 ($8.51 in chips)
Seat 6: JoeFrosty ($7.90 in chips)
imsobad402: posts small blind $0.05
JoeFrosty: posts big blind $0.10
*** HOLE CARDS ***
Dealt to tapouttazz9 [Kc 4s]
Mattymar98: folds
tapouttazz9: folds
dougwid: folds
dougwid leaves the table
imsobad402: calls $0.05
JoeFrosty: checks
*** FLOP *** [Qc 8s 2d]
imsobad402: checks
JoeFrosty: checks
*** TURN *** [Qc 8s 2d] [As]
imsobad402: bets $0.10
JoeFrosty: folds
Uncalled bet ($0.10) returned to imsobad402
imsobad402 collected $0.19 from pot
imsobad402: doesn't show hand
*** SUMMARY ***
Total pot $0.20 | Rake $0.01
Board [Qc 8s 2d As]
Seat 2: Mattymar98 folded before Flop (didn't bet)
Seat 3: tapouttazz9 folded before Flop (didn't bet)
Seat 4: dougwid (button) folded before Flop (didn't bet)
Seat 5: imsobad402 (small blind) collected ($0.19)
Seat 6: JoeFrosty (big blind) folded on the Turn


PokerStars Hand #157066727091:  Hold'em No Limit ($0.05/$0.10 USD) - 2016/08/17 17:16:24 ET
Table 'Kraz' 6-max Seat #5 is the button
Seat 2: Mattymar98 ($9.55 in chips)
Seat 3: tapouttazz9 ($20.64 in chips)
Seat 5: imsobad402 ($8.60 in chips)
Seat 6: JoeFrosty ($7.80 in chips)
JoeFrosty: posts small blind $0.05
Mattymar98: posts big blind $0.10
*** HOLE CARDS ***
Dealt to tapouttazz9 [9d Ah]
tapouttazz9: raises $0.20 to $0.30
imsobad402: folds
JoeFrosty: folds
Mattymar98: calls $0.20
*** FLOP *** [Qh Qs Ks]
Mattymar98: checks
tapouttazz9: bets $0.31
Mattymar98: calls $0.31
*** TURN *** [Qh Qs Ks] [2h]
Mattymar98: checks
tapouttazz9: bets $0.60
Mattymar98: calls $0.60
*** RIVER *** [Qh Qs Ks 2h] [2c]
Mattymar98: checks
tapouttazz9: checks
*** SHOW DOWN ***
Mattymar98: shows [Kh Ad] (two pair, Kings and Queens)
tapouttazz9: mucks hand
Mattymar98 collected $2.35 from pot
*** SUMMARY ***
Total pot $2.47 | Rake $0.12
Board [Qh Qs Ks 2h 2c]
Seat 2: Mattymar98 (big blind) showed [Kh Ad] and won ($2.35) with two pair, Kings and Queens
Seat 3: tapouttazz9 mucked [9d Ah]
Seat 5: imsobad402 (button) folded before Flop (didn't bet)
Seat 6: JoeFrosty (small blind) folded before Flop


PokerStars Hand #157066727223:  Hold'em No Limit ($0.05/$0.10 USD) - 2016/08/17 17:16:56 ET
Table 'Kraz' 6-max Seat #6 is the button
Seat 2: Mattymar98 ($10.69 in chips)
Seat 3: tapouttazz9 ($19.43 in chips)
Seat 5: imsobad402 ($8.60 in chips)
Seat 6: JoeFrosty ($7.75 in chips)
Mattymar98: posts small blind $0.05
tapouttazz9: posts big blind $0.10
*** HOLE CARDS ***
Dealt to tapouttazz9 [Ts Kh]
imsobad402: raises $0.20 to $0.30
JoeFrosty: calls $0.30
Mattymar98: folds
tapouttazz9: calls $0.20
*** FLOP *** [9d 6s Qd]
tapouttazz9: checks
imsobad402: bets $0.45
JoeFrosty: calls $0.45
tapouttazz9: folds
*** TURN *** [9d 6s Qd] [4c]
imsobad402: checks
JoeFrosty: checks
*** RIVER *** [9d 6s Qd 4c] [Ad]
imsobad402: bets $0.88
JoeFrosty: folds
Uncalled bet ($0.88) returned to imsobad402
imsobad402 collected $1.76 from pot
imsobad402: doesn't show hand
*** SUMMARY ***
Total pot $1.85 | Rake $0.09
Board [9d 6s Qd 4c Ad]
Seat 2: Mattymar98 (small blind) folded before Flop
Seat 3: tapouttazz9 (big blind) folded on the Flop
Seat 5: imsobad402 collected ($1.76)
Seat 6: JoeFrosty (button) folded on the River


PokerStars Hand #157066727474:  Hold'em No Limit ($0.05/$0.10 USD) - 2016/08/17 17:17:56 ET
Table 'Kraz' 6-max Seat #2 is the button
Seat 2: Mattymar98 ($10.64 in chips)
Seat 3: tapouttazz9 ($19.13 in chips)
Seat 5: imsobad402 ($9.61 in chips)
Seat 6: JoeFrosty ($7 in chips)
tapouttazz9: posts small blind $0.05
imsobad402: posts big blind $0.10
*** HOLE CARDS ***
Dealt to tapouttazz9 [8c Qh]
JoeFrosty: folds
Mattymar98: folds
tapouttazz9: folds
Uncalled bet ($0.05) returned to imsobad402
imsobad402 collected $0.10 from pot
imsobad402: doesn't show hand
*** SUMMARY ***
Total pot $0.10 | Rake $0
Seat 2: Mattymar98 (button) folded before Flop (didn't bet)
Seat 3: tapouttazz9 (small blind) folded before Flop
Seat 5: imsobad402 (big blind) collected ($0.10)
Seat 6: JoeFrosty folded before Flop (didn't bet)


PokerStars Hand #157066727540:  Hold'em No Limit ($0.05/$0.10 USD) - 2016/08/17 17:18:13 ET
Table 'Kraz' 6-max Seat #3 is the button
Seat 2: Mattymar98 ($10.64 in chips)
Seat 3: tapouttazz9 ($19.08 in chips)
Seat 5: imsobad402 ($9.66 in chips)
Seat 6: JoeFrosty ($7 in chips)
imsobad402: posts small blind $0.05
JoeFrosty: posts big blind $0.10
*** HOLE CARDS ***
Dealt to tapouttazz9 [7d As]
Mattymar98: folds
tapouttazz9: raises $0.20 to $0.30
imsobad402: calls $0.25
JoeFrosty: folds
*** FLOP *** [4d 5h 5d]
imsobad402: checks
tapouttazz9: bets $0.33
imsobad402: calls $0.33
*** TURN *** [4d 5h 5d] [Jc]
imsobad402: checks
tapouttazz9: checks
*** RIVER *** [4d 5h 5d Jc] [4s]
imsobad402: bets $0.85
tapouttazz9: raises $1.15 to $2
imsobad402: folds
Uncalled bet ($1.15) returned to tapouttazz9
tapouttazz9 collected $2.91 from pot
*** SUMMARY ***
Total pot $3.06 | Rake $0.15
Board [4d 5h 5d Jc 4s]
Seat 2: Mattymar98 folded before Flop (didn't bet)
Seat 3: tapouttazz9 (button) collected ($2.91)
Seat 5: imsobad402 (small blind) folded on the River
Seat 6: JoeFrosty (big blind) folded before Flop


PokerStars Hand #157066727892:  Hold'em No Limit ($0.05/$0.10 USD) - 2016/08/17 17:19:37 ET
Table 'Kraz' 6-max Seat #5 is the button
Seat 2: Mattymar98 ($10.64 in chips)
Seat 3: tapouttazz9 ($20.51 in chips)
Seat 5: imsobad402 ($8.18 in chips)
Seat 6: JoeFrosty ($6.90 in chips)
JoeFrosty: posts small blind $0.05
Mattymar98: posts big blind $0.10
*** HOLE CARDS ***
Dealt to tapouttazz9 [2d 6h]
tapouttazz9: folds
imsobad402: folds
JoeFrosty: folds
Uncalled bet ($0.05) returned to Mattymar98
Mattymar98 collected $0.10 from pot
*** SUMMARY ***
Total pot $0.10 | Rake $0
Seat 2: Mattymar98 (big blind) collected ($0.10)
Seat 3: tapouttazz9 folded before Flop (didn't bet)
Seat 5: imsobad402 (button) folded before Flop (didn't bet)
Seat 6: JoeFrosty (small blind) folded before Flop


PokerStars Hand #157066727969:  Hold'em No Limit ($0.05/$0.10 USD) - 2016/08/17 17:19:52 ET
Table 'Kraz' 6-max Seat #6 is the button
Seat 2: Mattymar98 ($10.69 in chips)
Seat 3: tapouttazz9 ($20.51 in chips)
Seat 5: imsobad402 ($8.18 in chips)
Seat 6: JoeFrosty ($6.85 in chips)
Mattymar98: posts small blind $0.05
tapouttazz9: posts big blind $0.10
*** HOLE CARDS ***
Dealt to tapouttazz9 [Js Ks]
imsobad402: folds
JoeFrosty: calls $0.10
Mattymar98: calls $0.05
tapouttazz9: checks
*** FLOP *** [8d 3c Qc]
Mattymar98: checks
tapouttazz9: checks
JoeFrosty: bets $0.20
Mattymar98: folds
tapouttazz9: folds
Uncalled bet ($0.20) returned to JoeFrosty
JoeFrosty collected $0.28 from pot
JoeFrosty: doesn't show hand
*** SUMMARY ***
Total pot $0.30 | Rake $0.02
Board [8d 3c Qc]
Seat 2: Mattymar98 (small blind) folded on the Flop
Seat 3: tapouttazz9 (big blind) folded on the Flop
Seat 5: imsobad402 folded before Flop (didn't bet)
Seat 6: JoeFrosty (button) collected ($0.28)


PokerStars Hand #157066728248:  Hold'em No Limit ($0.05/$0.10 USD) - 2016/08/17 17:20:55 ET
Table 'Kraz' 6-max Seat #2 is the button
Seat 2: Mattymar98 ($10.59 in chips)
Seat 3: tapouttazz9 ($20.41 in chips)
Seat 5: imsobad402 ($8.18 in chips)
Seat 6: JoeFrosty ($7.03 in chips)
tapouttazz9: posts small blind $0.05
imsobad402: posts big blind $0.10
*** HOLE CARDS ***
Dealt to tapouttazz9 [Ts 8c]
JoeFrosty: raises $0.20 to $0.30
Mattymar98: folds
tapouttazz9: folds
imsobad402: folds
Uncalled bet ($0.20) returned to JoeFrosty
JoeFrosty collected $0.25 from pot
JoeFrosty: doesn't show hand
*** SUMMARY ***
Total pot $0.25 | Rake $0
Seat 2: Mattymar98 (button) folded before Flop (didn't bet)
Seat 3: tapouttazz9 (small blind) folded before Flop
Seat 5: imsobad402 (big blind) folded before Flop
Seat 6: JoeFrosty collected ($0.25)


PokerStars Hand #157066728299:  Hold'em No Limit ($0.05/$0.10 USD) - 2016/08/17 17:21:08 ET
Table 'Kraz' 6-max Seat #3 is the button
Seat 2: Mattymar98 ($10.59 in chips)
Seat 3: tapouttazz9 ($20.36 in chips)
Seat 5: imsobad402 ($8.08 in chips)
Seat 6: JoeFrosty ($7.18 in chips)
imsobad402: posts small blind $0.05
JoeFrosty: posts big blind $0.10
*** HOLE CARDS ***
Dealt to tapouttazz9 [2d 6d]
Mattymar98: folds
tapouttazz9: folds
imsobad402: raises $0.20 to $0.30
JoeFrosty: folds
Uncalled bet ($0.20) returned to imsobad402
imsobad402 collected $0.20 from pot
imsobad402: doesn't show hand
*** SUMMARY ***
Total pot $0.20 | Rake $0
Seat 2: Mattymar98 folded before Flop (didn't bet)
Seat 3: tapouttazz9 (button) folded before Flop (didn't bet)
Seat 5: imsobad402 (small blind) collected ($0.20)
Seat 6: JoeFrosty (big blind) folded before Flop


PokerStars Hand #157066728390:  Hold'em No Limit ($0.05/$0.10 USD) - 2016/08/17 17:21:29 ET
Table 'Kraz' 6-max Seat #5 is the button
Seat 2: Mattymar98 ($10.59 in chips)
Seat 3: tapouttazz9 ($20.36 in chips)
Seat 5: imsobad402 ($8.18 in chips)
Seat 6: JoeFrosty ($7.08 in chips)
JoeFrosty: posts small blind $0.05
Mattymar98: posts big blind $0.10
*** HOLE CARDS ***
Dealt to tapouttazz9 [3h 8c]
tapouttazz9: folds
imsobad402: folds
JoeFrosty: folds
Uncalled bet ($0.05) returned to Mattymar98
Mattymar98 collected $0.10 from pot
*** SUMMARY ***
Total pot $0.10 | Rake $0
Seat 2: Mattymar98 (big blind) collected ($0.10)
Seat 3: tapouttazz9 folded before Flop (didn't bet)
Seat 5: imsobad402 (button) folded before Flop (didn't bet)
Seat 6: JoeFrosty (small blind) folded before Flop


PokerStars Hand #157066728485:  Hold'em No Limit ($0.05/$0.10 USD) - 2016/08/17 17:21:52 ET
Table 'Kraz' 6-max Seat #6 is the button
Seat 2: Mattymar98 ($10.64 in chips)
Seat 3: tapouttazz9 ($20.36 in chips)
Seat 5: imsobad402 ($8.18 in chips)
Seat 6: JoeFrosty ($7.03 in chips)
Mattymar98: posts small blind $0.05
tapouttazz9: posts big blind $0.10
*** HOLE CARDS ***
Dealt to tapouttazz9 [Kh 4d]
imsobad402: raises $0.20 to $0.30
JoeFrosty: calls $0.30
Mattymar98: folds
tapouttazz9: folds
*** FLOP *** [8h 9s Qd]
imsobad402: checks
JoeFrosty: bets $0.30
imsobad402: calls $0.30
*** TURN *** [8h 9s Qd] [5c]
imsobad402: checks
JoeFrosty: checks
*** RIVER *** [8h 9s Qd 5c] [4c]
imsobad402: checks
JoeFrosty: checks
*** SHOW DOWN ***
imsobad402: shows [As 5s] (a pair of Fives)
JoeFrosty: shows [Jh Jc] (a pair of Jacks)
JoeFrosty collected $1.28 from pot
*** SUMMARY ***
Total pot $1.35 | Rake $0.07
Board [8h 9s Qd 5c 4c]
Seat 2: Mattymar98 (small blind) folded before Flop
Seat 3: tapouttazz9 (big blind) folded before Flop
Seat 5: imsobad402 showed [As 5s] and lost with a pair of Fives
Seat 6: JoeFrosty (button) showed [Jh Jc] and won ($1.28) with a pair of Jacks


PokerStars Hand #157066728694:  Hold'em No Limit ($0.05/$0.10 USD) - 2016/08/17 17:22:38 ET
Table 'Kraz' 6-max Seat #2 is the button
Seat 2: Mattymar98 ($10.59 in chips)
Seat 3: tapouttazz9 ($20.26 in chips)
Seat 5: imsobad402 ($7.58 in chips)
Seat 6: JoeFrosty ($7.71 in chips)
tapouttazz9: posts small blind $0.05
imsobad402: posts big blind $0.10
*** HOLE CARDS ***
Dealt to tapouttazz9 [Jh 8c]
JoeFrosty: raises $0.25 to $0.35
Mattymar98: folds
tapouttazz9: folds
imsobad402: calls $0.25
*** FLOP *** [9c 4d As]
imsobad402: checks
JoeFrosty: bets $0.40
imsobad402: folds
Uncalled bet ($0.40) returned to JoeFrosty
JoeFrosty collected $0.71 from pot
JoeFrosty: doesn't show hand
*** SUMMARY ***
Total pot $0.75 | Rake $0.04
Board [9c 4d As]
Seat 2: Mattymar98 (button) folded before Flop (didn't bet)
Seat 3: tapouttazz9 (small blind) folded before Flop
Seat 5: imsobad402 (big blind) folded on the Flop
Seat 6: JoeFrosty collected ($0.71)


PokerStars Hand #157066728791:  Hold'em No Limit ($0.05/$0.10 USD) - 2016/08/17 17:23:00 ET
Table 'Kraz' 6-max Seat #3 is the button
Seat 2: Mattymar98 ($10.59 in chips)
Seat 3: tapouttazz9 ($20.21 in chips)
Seat 5: imsobad402 ($7.23 in chips)
Seat 6: JoeFrosty ($8.07 in chips)
imsobad402: posts small blind $0.05
JoeFrosty: posts big blind $0.10
*** HOLE CARDS ***
Dealt to tapouttazz9 [Ah Ac]
Mattymar98: folds
tapouttazz9: raises $0.20 to $0.30
imsobad402: folds
JoeFrosty: calls $0.20
*** FLOP *** [As 6h 3c]
JoeFrosty: bets $0.60
tapouttazz9: calls $0.60
*** TURN *** [As 6h 3c] [Js]
JoeFrosty: bets $0.90
tapouttazz9: calls $0.90
*** RIVER *** [As 6h 3c Js] [3d]
JoeFrosty: bets $1.50
tapouttazz9: raises $16.91 to $18.41 and is all-in
JoeFrosty: folds
Uncalled bet ($16.91) returned to tapouttazz9
tapouttazz9 collected $6.32 from pot
*** SUMMARY ***
Total pot $6.65 | Rake $0.33
Board [As 6h 3c Js 3d]
Seat 2: Mattymar98 folded before Flop (didn't bet)
Seat 3: tapouttazz9 (button) collected ($6.32)
Seat 5: imsobad402 (small blind) folded before Flop
Seat 6: JoeFrosty (big blind) folded on the River


PokerStars Hand #157066729009:  Hold'em No Limit ($0.05/$0.10 USD) - 2016/08/17 17:23:50 ET
Table 'Kraz' 6-max Seat #5 is the button
Seat 2: Mattymar98 ($10.59 in chips)
Seat 3: tapouttazz9 ($23.23 in chips)
Seat 5: imsobad402 ($7.18 in chips)
Seat 6: JoeFrosty ($4.77 in chips)
JoeFrosty: posts small blind $0.05
Mattymar98: posts big blind $0.10
*** HOLE CARDS ***
Dealt to tapouttazz9 [8d Kc]
tapouttazz9: folds
imsobad402: folds
JoeFrosty: folds
Uncalled bet ($0.05) returned to Mattymar98
Mattymar98 collected $0.10 from pot
*** SUMMARY ***
Total pot $0.10 | Rake $0
Seat 2: Mattymar98 (big blind) collected ($0.10)
Seat 3: tapouttazz9 folded before Flop (didn't bet)
Seat 5: imsobad402 (button) folded before Flop (didn't bet)
Seat 6: JoeFrosty (small blind) folded before Flop


PokerStars Hand #157066729065:  Hold'em No Limit ($0.05/$0.10 USD) - 2016/08/17 17:24:01 ET
Table 'Kraz' 6-max Seat #6 is the button
Seat 2: Mattymar98 ($10.64 in chips)
Seat 3: tapouttazz9 ($23.23 in chips)
Seat 5: imsobad402 ($7.18 in chips)
Seat 6: JoeFrosty ($4.72 in chips)
Mattymar98: posts small blind $0.05
tapouttazz9: posts big blind $0.10
*** HOLE CARDS ***
Dealt to tapouttazz9 [4h 5c]
imsobad402: folds
JoeFrosty: folds
Mattymar98: folds
Uncalled bet ($0.05) returned to tapouttazz9
tapouttazz9 collected $0.10 from pot
*** SUMMARY ***
Total pot $0.10 | Rake $0
Seat 2: Mattymar98 (small blind) folded before Flop
Seat 3: tapouttazz9 (big blind) collected ($0.10)
Seat 5: imsobad402 folded before Flop (didn't bet)
Seat 6: JoeFrosty (button) folded before Flop (didn't bet)


PokerStars Hand #157066729110:  Hold'em No Limit ($0.05/$0.10 USD) - 2016/08/17 17:24:13 ET
Table 'Kraz' 6-max Seat #2 is the button
Seat 2: Mattymar98 ($10.59 in chips)
Seat 3: tapouttazz9 ($23.28 in chips)
Seat 5: imsobad402 ($7.18 in chips)
Seat 6: JoeFrosty ($4.72 in chips)
tapouttazz9: posts small blind $0.05
imsobad402: posts big blind $0.10
*** HOLE CARDS ***
Dealt to tapouttazz9 [Jd 3d]
JoeFrosty: raises $0.20 to $0.30
Mattymar98: folds
tapouttazz9: folds
imsobad402: folds
Uncalled bet ($0.20) returned to JoeFrosty
JoeFrosty collected $0.25 from pot
JoeFrosty: doesn't show hand
*** SUMMARY ***
Total pot $0.25 | Rake $0
Seat 2: Mattymar98 (button) folded before Flop (didn't bet)
Seat 3: tapouttazz9 (small blind) folded before Flop
Seat 5: imsobad402 (big blind) folded before Flop
Seat 6: JoeFrosty collected ($0.25)


PokerStars Hand #157066729225:  Hold'em No Limit ($0.05/$0.10 USD) - 2016/08/17 17:24:40 ET
Table 'Kraz' 6-max Seat #3 is the button
Seat 2: Mattymar98 ($10.59 in chips)
Seat 3: tapouttazz9 ($23.23 in chips)
Seat 5: imsobad402 ($7.08 in chips)
Seat 6: JoeFrosty ($4.87 in chips)
imsobad402: posts small blind $0.05
JoeFrosty: posts big blind $0.10
*** HOLE CARDS ***
Dealt to tapouttazz9 [9d 3c]
Mattymar98: folds
tapouttazz9: folds
imsobad402: raises $0.20 to $0.30
JoeFrosty: calls $0.20
*** FLOP *** [3h 2h Td]
imsobad402: bets $0.30
JoeFrosty: folds
Uncalled bet ($0.30) returned to imsobad402
imsobad402 collected $0.57 from pot
imsobad402: doesn't show hand
*** SUMMARY ***
Total pot $0.60 | Rake $0.03
Board [3h 2h Td]
Seat 2: Mattymar98 folded before Flop (didn't bet)
Seat 3: tapouttazz9 (button) folded before Flop (didn't bet)
Seat 5: imsobad402 (small blind) collected ($0.57)
Seat 6: JoeFrosty (big blind) folded on the Flop


PokerStars Hand #157066729348:  Hold'em No Limit ($0.05/$0.10 USD) - 2016/08/17 17:25:07 ET
Table 'Kraz' 6-max Seat #5 is the button
Seat 2: Mattymar98 ($10.59 in chips)
Seat 3: tapouttazz9 ($23.23 in chips)
Seat 5: imsobad402 ($7.35 in chips)
Seat 6: JoeFrosty ($4.57 in chips)
JoeFrosty: posts small blind $0.05
Mattymar98: posts big blind $0.10
*** HOLE CARDS ***
Dealt to tapouttazz9 [4s 9d]
tapouttazz9: folds
imsobad402: folds
JoeFrosty: raises $0.20 to $0.30
Mattymar98: folds
Uncalled bet ($0.20) returned to JoeFrosty
JoeFrosty collected $0.20 from pot
JoeFrosty: doesn't show hand
*** SUMMARY ***
Total pot $0.20 | Rake $0
Seat 2: Mattymar98 (big blind) folded before Flop
Seat 3: tapouttazz9 folded before Flop (didn't bet)
Seat 5: imsobad402 (button) folded before Flop (didn't bet)
Seat 6: JoeFrosty (small blind) collected ($0.20)


PokerStars Hand #157066729427:  Hold'em No Limit ($0.05/$0.10 USD) - 2016/08/17 17:25:27 ET
Table 'Kraz' 6-max Seat #6 is the button
Seat 2: Mattymar98 ($10.49 in chips)
Seat 3: tapouttazz9 ($23.23 in chips)
Seat 5: imsobad402 ($7.35 in chips)
Seat 6: JoeFrosty ($4.67 in chips)
Mattymar98: posts small blind $0.05
tapouttazz9: posts big blind $0.10
*** HOLE CARDS ***
Dealt to tapouttazz9 [6h Th]
imsobad402: raises $0.20 to $0.30
JoeFrosty: calls $0.30
Mattymar98: folds
tapouttazz9: folds
*** FLOP *** [Qh 8h Td]
imsobad402: bets $0.40
JoeFrosty: calls $0.40
*** TURN *** [Qh 8h Td] [8s]
imsobad402: checks
JoeFrosty: bets $0.70
imsobad402: raises $1.43 to $2.13
JoeFrosty: calls $1.43
*** RIVER *** [Qh 8h Td 8s] [3h]
imsobad402: checks
JoeFrosty: checks
*** SHOW DOWN ***
imsobad402: shows [Qc 5s] (two pair, Queens and Eights)
JoeFrosty: mucks hand
imsobad402 collected $5.52 from pot
*** SUMMARY ***
Total pot $5.81 | Rake $0.29
Board [Qh 8h Td 8s 3h]
Seat 2: Mattymar98 (small blind) folded before Flop
Seat 3: tapouttazz9 (big blind) folded before Flop
Seat 5: imsobad402 showed [Qc 5s] and won ($5.52) with two pair, Queens and Eights
Seat 6: JoeFrosty (button) mucked [Kh Ac]


PokerStars Hand #157066729686:  Hold'em No Limit ($0.05/$0.10 USD) - 2016/08/17 17:26:21 ET
Table 'Kraz' 6-max Seat #2 is the button
Seat 2: Mattymar98 ($10.44 in chips)
Seat 3: tapouttazz9 ($23.13 in chips)
Seat 5: imsobad402 ($10.04 in chips)
Seat 6: JoeFrosty ($1.84 in chips)
tapouttazz9: posts small blind $0.05
imsobad402: posts big blind $0.10
*** HOLE CARDS ***
Dealt to tapouttazz9 [8d 5d]
JoeFrosty: folds
Mattymar98: raises $0.20 to $0.30
tapouttazz9: folds
imsobad402: calls $0.20
*** FLOP *** [Qc 8c 6d]
imsobad402: checks
Mattymar98: bets $0.40
imsobad402: calls $0.40
*** TURN *** [Qc 8c 6d] [Jd]
imsobad402: checks
Mattymar98: checks
*** RIVER *** [Qc 8c 6d Jd] [5c]
imsobad402: bets $0.91
Mattymar98: folds
Uncalled bet ($0.91) returned to imsobad402
imsobad402 collected $1.38 from pot
imsobad402: doesn't show hand
*** SUMMARY ***
Total pot $1.45 | Rake $0.07
Board [Qc 8c 6d Jd 5c]
Seat 2: Mattymar98 (button) folded on the River
Seat 3: tapouttazz9 (small blind) folded before Flop
Seat 5: imsobad402 (big blind) collected ($1.38)
Seat 6: JoeFrosty folded before Flop (didn't bet)


PokerStars Hand #157066729904:  Hold'em No Limit ($0.05/$0.10 USD) - 2016/08/17 17:27:11 ET
Table 'Kraz' 6-max Seat #3 is the button
Seat 2: Mattymar98 ($9.74 in chips)
Seat 3: tapouttazz9 ($23.08 in chips)
Seat 5: imsobad402 ($10.72 in chips)
Seat 6: JoeFrosty ($1.84 in chips)
imsobad402: posts small blind $0.05
JoeFrosty: posts big blind $0.10
*** HOLE CARDS ***
Dealt to tapouttazz9 [Ks 9h]
Mattymar98: folds
tapouttazz9: raises $0.20 to $0.30
imsobad402: folds
JoeFrosty: calls $0.20
*** FLOP *** [Js Kh 7c]
JoeFrosty: checks
tapouttazz9: bets $0.20
JoeFrosty: folds
Uncalled bet ($0.20) returned to tapouttazz9
tapouttazz9 collected $0.62 from pot
*** SUMMARY ***
Total pot $0.65 | Rake $0.03
Board [Js Kh 7c]
Seat 2: Mattymar98 folded before Flop (didn't bet)
Seat 3: tapouttazz9 (button) collected ($0.62)
Seat 5: imsobad402 (small blind) folded before Flop
Seat 6: JoeFrosty (big blind) folded on the Flop


PokerStars Hand #157067652120:  Hold'em No Limit ($0.05/$0.10 USD) - 2016/08/17 17:27:37 ET
Table 'Kraz' 6-max Seat #5 is the button
Seat 2: Mattymar98 ($9.74 in chips)
Seat 3: tapouttazz9 ($23.40 in chips)
Seat 5: imsobad402 ($10.67 in chips)
Seat 6: JoeFrosty ($1.54 in chips)
JoeFrosty: posts small blind $0.05
Mattymar98: posts big blind $0.10
*** HOLE CARDS ***
Dealt to tapouttazz9 [5s 8s]
tapouttazz9: folds
imsobad402: folds
JoeFrosty: folds
Uncalled bet ($0.05) returned to Mattymar98
Mattymar98 collected $0.10 from pot
*** SUMMARY ***
Total pot $0.10 | Rake $0
Seat 2: Mattymar98 (big blind) collected ($0.10)
Seat 3: tapouttazz9 folded before Flop (didn't bet)
Seat 5: imsobad402 (button) folded before Flop (didn't bet)
Seat 6: JoeFrosty (small blind) folded before Flop


PokerStars Hand #157067652160:  Hold'em No Limit ($0.05/$0.10 USD) - 2016/08/17 17:27:44 ET
Table 'Kraz' 6-max Seat #6 is the button
Seat 2: Mattymar98 ($9.79 in chips)
Seat 3: tapouttazz9 ($23.40 in chips)
Seat 5: imsobad402 ($10.67 in chips)
Seat 6: JoeFrosty ($1.49 in chips)
Mattymar98: posts small blind $0.05
tapouttazz9: posts big blind $0.10
*** HOLE CARDS ***
Dealt to tapouttazz9 [3h Td]
imsobad402: folds
JoeFrosty: calls $0.10
Mattymar98: calls $0.05
tapouttazz9: checks
*** FLOP *** [Ad 3s 4d]
CptBarnacles joins the table at seat #4
Mattymar98: checks
tapouttazz9: checks
JoeFrosty: bets $0.20
Mattymar98: folds
tapouttazz9: folds
Uncalled bet ($0.20) returned to JoeFrosty
JoeFrosty collected $0.28 from pot
JoeFrosty: doesn't show hand
*** SUMMARY ***
Total pot $0.30 | Rake $0.02
Board [Ad 3s 4d]
Seat 2: Mattymar98 (small blind) folded on the Flop
Seat 3: tapouttazz9 (big blind) folded on the Flop
Seat 5: imsobad402 folded before Flop (didn't bet)
Seat 6: JoeFrosty (button) collected ($0.28)


PokerStars Hand #157067652441:  Hold'em No Limit ($0.05/$0.10 USD) - 2016/08/17 17:28:45 ET
Table 'Kraz' 6-max Seat #2 is the button
Seat 2: Mattymar98 ($9.69 in chips)
Seat 3: tapouttazz9 ($23.30 in chips)
Seat 4: CptBarnacles ($10 in chips)
Seat 5: imsobad402 ($10.67 in chips)
Seat 6: JoeFrosty ($1.67 in chips)
tapouttazz9: posts small blind $0.05
CptBarnacles: posts big blind $0.10
*** HOLE CARDS ***
Dealt to tapouttazz9 [Qc 3d]
imsobad402: folds
JoeFrosty: folds
Mattymar98: folds
tapouttazz9: folds
Uncalled bet ($0.05) returned to CptBarnacles
CptBarnacles collected $0.10 from pot
CptBarnacles: doesn't show hand
*** SUMMARY ***
Total pot $0.10 | Rake $0
Seat 2: Mattymar98 (button) folded before Flop (didn't bet)
Seat 3: tapouttazz9 (small blind) folded before Flop
Seat 4: CptBarnacles (big blind) collected ($0.10)
Seat 5: imsobad402 folded before Flop (didn't bet)
Seat 6: JoeFrosty folded before Flop (didn't bet)


PokerStars Hand #157067652487:  Hold'em No Limit ($0.05/$0.10 USD) - 2016/08/17 17:28:55 ET
Table 'Kraz' 6-max Seat #3 is the button
Seat 2: Mattymar98 ($9.69 in chips)
Seat 3: tapouttazz9 ($23.25 in chips)
Seat 4: CptBarnacles ($10.05 in chips)
Seat 5: imsobad402 ($10.67 in chips)
Seat 6: JoeFrosty ($1.67 in chips)
CptBarnacles: posts small blind $0.05
imsobad402: posts big blind $0.10
*** HOLE CARDS ***
Dealt to tapouttazz9 [8h 9h]
JoeFrosty: calls $0.10
Mattymar98: folds
tapouttazz9: raises $0.10 to $0.20
CptBarnacles: raises $0.60 to $0.80
imsobad402: folds
JoeFrosty: folds
tapouttazz9: calls $0.60
*** FLOP *** [3h 5s Js]
CptBarnacles: bets $1.20
tapouttazz9: folds
Uncalled bet ($1.20) returned to CptBarnacles
CptBarnacles collected $1.71 from pot
CptBarnacles: doesn't show hand
*** SUMMARY ***
Total pot $1.80 | Rake $0.09
Board [3h 5s Js]
Seat 2: Mattymar98 folded before Flop (didn't bet)
Seat 3: tapouttazz9 (button) folded on the Flop
Seat 4: CptBarnacles (small blind) collected ($1.71)
Seat 5: imsobad402 (big blind) folded before Flop
Seat 6: JoeFrosty folded before Flop


PokerStars Hand #157067652657:  Hold'em No Limit ($0.05/$0.10 USD) - 2016/08/17 17:29:30 ET
Table 'Kraz' 6-max Seat #4 is the button
Seat 2: Mattymar98 ($9.69 in chips)
Seat 3: tapouttazz9 ($22.45 in chips)
Seat 4: CptBarnacles ($10.96 in chips)
Seat 5: imsobad402 ($10.57 in chips)
Seat 6: JoeFrosty ($1.57 in chips)
imsobad402: posts small blind $0.05
JoeFrosty: posts big blind $0.10
*** HOLE CARDS ***
Dealt to tapouttazz9 [8c 6d]
Mattymar98: folds
tapouttazz9: folds
CptBarnacles: folds
imsobad402: raises $0.20 to $0.30
JoeFrosty: calls $0.20
*** FLOP *** [Th 5s Ac]
imsobad402: checks
JoeFrosty: bets $0.30
Rexxmortis88 joins the table at seat #1
imsobad402: calls $0.30
*** TURN *** [Th 5s Ac] [9s]
imsobad402: checks
JoeFrosty: checks
*** RIVER *** [Th 5s Ac 9s] [6s]
imsobad402: bets $0.57
JoeFrosty: folds
Uncalled bet ($0.57) returned to imsobad402
imsobad402 collected $1.14 from pot
imsobad402: doesn't show hand
*** SUMMARY ***
Total pot $1.20 | Rake $0.06
Board [Th 5s Ac 9s 6s]
Seat 2: Mattymar98 folded before Flop (didn't bet)
Seat 3: tapouttazz9 folded before Flop (didn't bet)
Seat 4: CptBarnacles (button) folded before Flop (didn't bet)
Seat 5: imsobad402 (small blind) collected ($1.14)
Seat 6: JoeFrosty (big blind) folded on the River


PokerStars Hand #157067652909:  Hold'em No Limit ($0.05/$0.10 USD) - 2016/08/17 17:30:24 ET
Table 'Kraz' 6-max Seat #5 is the button
Seat 1: Rexxmortis88 ($4.80 in chips)
Seat 2: Mattymar98 ($9.69 in chips)
Seat 3: tapouttazz9 ($22.45 in chips)
Seat 4: CptBarnacles ($10.96 in chips)
Seat 5: imsobad402 ($11.11 in chips)
Seat 6: JoeFrosty ($0.97 in chips)
JoeFrosty: posts small blind $0.05
Rexxmortis88: posts big blind $0.10
*** HOLE CARDS ***
Dealt to tapouttazz9 [Ks 6h]
Mattymar98: folds
tapouttazz9: folds
CptBarnacles: folds
imsobad402: raises $0.20 to $0.30
JoeFrosty: folds
Rexxmortis88: calls $0.20
*** FLOP *** [2h 7c 9h]
Rexxmortis88: bets $0.20
imsobad402: folds
Uncalled bet ($0.20) returned to Rexxmortis88
Rexxmortis88 collected $0.62 from pot
Rexxmortis88: doesn't show hand
*** SUMMARY ***
Total pot $0.65 | Rake $0.03
Board [2h 7c 9h]
Seat 1: Rexxmortis88 (big blind) collected ($0.62)
Seat 2: Mattymar98 folded before Flop (didn't bet)
Seat 3: tapouttazz9 folded before Flop (didn't bet)
Seat 4: CptBarnacles folded before Flop (didn't bet)
Seat 5: imsobad402 (button) folded on the Flop
Seat 6: JoeFrosty (small blind) folded before Flop


PokerStars Hand #157067653108:  Hold'em No Limit ($0.05/$0.10 USD) - 2016/08/17 17:31:04 ET
Table 'Kraz' 6-max Seat #6 is the button
Seat 1: Rexxmortis88 ($5.12 in chips)
Seat 2: Mattymar98 ($9.69 in chips)
Seat 3: tapouttazz9 ($22.45 in chips)
Seat 4: CptBarnacles ($10.96 in chips)
Seat 5: imsobad402 ($10.81 in chips)
Seat 6: JoeFrosty ($0.92 in chips)
Rexxmortis88: posts small blind $0.05
Mattymar98: posts big blind $0.10
*** HOLE CARDS ***
Dealt to tapouttazz9 [5c 8h]
tapouttazz9: folds
CptBarnacles: folds
imsobad402: raises $0.20 to $0.30
JoeFrosty: folds
Rexxmortis88: folds
Mattymar98: folds
Uncalled bet ($0.20) returned to imsobad402
imsobad402 collected $0.25 from pot
imsobad402: doesn't show hand
*** SUMMARY ***
Total pot $0.25 | Rake $0
Seat 1: Rexxmortis88 (small blind) folded before Flop
Seat 2: Mattymar98 (big blind) folded before Flop
Seat 3: tapouttazz9 folded before Flop (didn't bet)
Seat 4: CptBarnacles folded before Flop (didn't bet)
Seat 5: imsobad402 collected ($0.25)
Seat 6: JoeFrosty (button) folded before Flop (didn't bet)


PokerStars Hand #157067653191:  Hold'em No Limit ($0.05/$0.10 USD) - 2016/08/17 17:31:22 ET
Table 'Kraz' 6-max Seat #1 is the button
Seat 1: Rexxmortis88 ($5.07 in chips)
Seat 2: Mattymar98 ($9.59 in chips)
Seat 3: tapouttazz9 ($22.45 in chips)
Seat 4: CptBarnacles ($10.96 in chips)
Seat 5: imsobad402 ($10.96 in chips)
Seat 6: JoeFrosty ($0.92 in chips)
Mattymar98: posts small blind $0.05
tapouttazz9: posts big blind $0.10
*** HOLE CARDS ***
Dealt to tapouttazz9 [2h 3s]
CptBarnacles: folds
imsobad402: raises $0.20 to $0.30
JoeFrosty: calls $0.30
Rexxmortis88: folds
Mattymar98: folds
tapouttazz9: folds
*** FLOP *** [9s Ah Jh]
imsobad402: checks
JoeFrosty: checks
*** TURN *** [9s Ah Jh] [2d]
imsobad402: bets $0.20
JoeFrosty: calls $0.20
*** RIVER *** [9s Ah Jh 2d] [Jc]
imsobad402: bets $0.54
JoeFrosty: calls $0.42 and is all-in
Uncalled bet ($0.12) returned to imsobad402
*** SHOW DOWN ***
imsobad402: shows [Js Ac] (a full house, Jacks full of Aces)
JoeFrosty: mucks hand
imsobad402 collected $1.89 from pot
*** SUMMARY ***
Total pot $1.99 | Rake $0.10
Board [9s Ah Jh 2d Jc]
Seat 1: Rexxmortis88 (button) folded before Flop (didn't bet)
Seat 2: Mattymar98 (small blind) folded before Flop
Seat 3: tapouttazz9 (big blind) folded before Flop
Seat 4: CptBarnacles folded before Flop (didn't bet)
Seat 5: imsobad402 showed [Js Ac] and won ($1.89) with a full house, Jacks full of Aces
Seat 6: JoeFrosty mucked [3c 3h]


PokerStars Hand #157067653431:  Hold'em No Limit ($0.05/$0.10 USD) - 2016/08/17 17:32:10 ET
Table 'Kraz' 6-max Seat #2 is the button
Seat 1: Rexxmortis88 ($5.07 in chips)
Seat 2: Mattymar98 ($9.54 in chips)
Seat 3: tapouttazz9 ($22.35 in chips)
Seat 4: CptBarnacles ($10.96 in chips)
Seat 5: imsobad402 ($11.93 in chips)
tapouttazz9: posts small blind $0.05
CptBarnacles: posts big blind $0.10
*** HOLE CARDS ***
Dealt to tapouttazz9 [4d 3c]
imsobad402: folds
Rexxmortis88: folds
Mattymar98: raises $0.20 to $0.30
tapouttazz9: folds
CptBarnacles: folds
Uncalled bet ($0.20) returned to Mattymar98
Mattymar98 collected $0.25 from pot
*** SUMMARY ***
Total pot $0.25 | Rake $0
Seat 1: Rexxmortis88 folded before Flop (didn't bet)
Seat 2: Mattymar98 (button) collected ($0.25)
Seat 3: tapouttazz9 (small blind) folded before Flop
Seat 4: CptBarnacles (big blind) folded before Flop
Seat 5: imsobad402 folded before Flop (didn't bet)


PokerStars Hand #157067653524:  Hold'em No Limit ($0.05/$0.10 USD) - 2016/08/17 17:32:27 ET
Table 'Kraz' 6-max Seat #3 is the button
Seat 1: Rexxmortis88 ($5.07 in chips)
Seat 2: Mattymar98 ($9.69 in chips)
Seat 3: tapouttazz9 ($22.30 in chips)
Seat 4: CptBarnacles ($10.86 in chips)
Seat 5: imsobad402 ($11.93 in chips)
Seat 6: JoeFrosty ($10 in chips)
CptBarnacles: posts small blind $0.05
imsobad402: posts big blind $0.10
*** HOLE CARDS ***
Dealt to tapouttazz9 [Qs Kh]
JoeFrosty: raises $0.20 to $0.30
Rexxmortis88: calls $0.30
Mattymar98: folds
tapouttazz9: calls $0.30
CptBarnacles: folds
imsobad402: folds
*** FLOP *** [3c Ks 9d]
JoeFrosty: bets $0.50
Rexxmortis88: calls $0.50
tapouttazz9: raises $0.60 to $1.10
JoeFrosty: folds
Rexxmortis88: calls $0.60
*** TURN *** [3c Ks 9d] [Ad]
Rexxmortis88: checks
tapouttazz9: bets $1.78
Rexxmortis88: folds
Uncalled bet ($1.78) returned to tapouttazz9
tapouttazz9 collected $3.56 from pot
*** SUMMARY ***
Total pot $3.75 | Rake $0.19
Board [3c Ks 9d Ad]
Seat 1: Rexxmortis88 folded on the Turn
Seat 2: Mattymar98 folded before Flop (didn't bet)
Seat 3: tapouttazz9 (button) collected ($3.56)
Seat 4: CptBarnacles (small blind) folded before Flop
Seat 5: imsobad402 (big blind) folded before Flop
Seat 6: JoeFrosty folded on the Flop


PokerStars Hand #157067653732:  Hold'em No Limit ($0.05/$0.10 USD) - 2016/08/17 17:33:15 ET
Table 'Kraz' 6-max Seat #4 is the button
Seat 1: Rexxmortis88 ($3.67 in chips)
Seat 2: Mattymar98 ($9.69 in chips)
Seat 3: tapouttazz9 ($24.46 in chips)
Seat 4: CptBarnacles ($10.81 in chips)
Seat 5: imsobad402 ($11.83 in chips)
Seat 6: JoeFrosty ($9.20 in chips)
imsobad402: posts small blind $0.05
JoeFrosty: posts big blind $0.10
*** HOLE CARDS ***
Dealt to tapouttazz9 [6s Qs]
Rexxmortis88: folds
Mattymar98: folds
tapouttazz9: folds
CptBarnacles: raises $0.15 to $0.25
imsobad402: folds
JoeFrosty: calls $0.15
*** FLOP *** [4d 9s 4h]
JoeFrosty: checks
CptBarnacles: checks
*** TURN *** [4d 9s 4h] [7c]
JoeFrosty: checks
CptBarnacles: bets $0.34
JoeFrosty: calls $0.34
*** RIVER *** [4d 9s 4h 7c] [Ad]
JoeFrosty: checks
CptBarnacles: bets $0.80
JoeFrosty: folds
Uncalled bet ($0.80) returned to CptBarnacles
CptBarnacles collected $1.17 from pot
CptBarnacles: doesn't show hand
*** SUMMARY ***
Total pot $1.23 | Rake $0.06
Board [4d 9s 4h 7c Ad]
Seat 1: Rexxmortis88 folded before Flop (didn't bet)
Seat 2: Mattymar98 folded before Flop (didn't bet)
Seat 3: tapouttazz9 folded before Flop (didn't bet)
Seat 4: CptBarnacles (button) collected ($1.17)
Seat 5: imsobad402 (small blind) folded before Flop
Seat 6: JoeFrosty (big blind) folded on the River


PokerStars Hand #157067654006:  Hold'em No Limit ($0.05/$0.10 USD) - 2016/08/17 17:34:15 ET
Table 'Kraz' 6-max Seat #5 is the button
Seat 1: Rexxmortis88 ($3.67 in chips)
Seat 2: Mattymar98 ($9.69 in chips)
Seat 3: tapouttazz9 ($24.46 in chips)
Seat 4: CptBarnacles ($11.39 in chips)
Seat 5: imsobad402 ($11.78 in chips)
Seat 6: JoeFrosty ($8.61 in chips)
JoeFrosty: posts small blind $0.05
Rexxmortis88: posts big blind $0.10
*** HOLE CARDS ***
Dealt to tapouttazz9 [4h 4c]
Mattymar98: folds
tapouttazz9: raises $0.10 to $0.20
CptBarnacles: folds
imsobad402: calls $0.20
JoeFrosty: calls $0.15
Rexxmortis88: folds
*** FLOP *** [9c 6h Td]
JoeFrosty: checks
tapouttazz9: checks
imsobad402: checks
*** TURN *** [9c 6h Td] [6c]
JoeFrosty: checks
tapouttazz9: checks
imsobad402: bets $0.33
JoeFrosty: folds
tapouttazz9: calls $0.33
*** RIVER *** [9c 6h Td 6c] [3h]
tapouttazz9: checks
imsobad402: checks
*** SHOW DOWN ***
tapouttazz9: shows [4h 4c] (two pair, Sixes and Fours)
imsobad402: mucks hand
tapouttazz9 collected $1.29 from pot
*** SUMMARY ***
Total pot $1.36 | Rake $0.07
Board [9c 6h Td 6c 3h]
Seat 1: Rexxmortis88 (big blind) folded before Flop
Seat 2: Mattymar98 folded before Flop (didn't bet)
Seat 3: tapouttazz9 showed [4h 4c] and won ($1.29) with two pair, Sixes and Fours
Seat 4: CptBarnacles folded before Flop (didn't bet)
Seat 5: imsobad402 (button) mucked [As Jd]
Seat 6: JoeFrosty (small blind) folded on the Turn


PokerStars Hand #157067654181:  Hold'em No Limit ($0.05/$0.10 USD) - 2016/08/17 17:34:52 ET
Table 'Kraz' 6-max Seat #6 is the button
Seat 1: Rexxmortis88 ($3.57 in chips)
Seat 2: Mattymar98 ($9.69 in chips)
Seat 3: tapouttazz9 ($25.22 in chips)
Seat 4: CptBarnacles ($11.39 in chips)
Seat 5: imsobad402 ($11.25 in chips)
Seat 6: JoeFrosty ($8.41 in chips)
Rexxmortis88: posts small blind $0.05
Mattymar98: posts big blind $0.10
*** HOLE CARDS ***
Dealt to tapouttazz9 [5d 2s]
tapouttazz9: folds
CptBarnacles: folds
imsobad402: raises $0.20 to $0.30
JoeFrosty: folds
Rexxmortis88: calls $0.25
Mattymar98: folds
*** FLOP *** [2c Jh Ac]
Rexxmortis88: checks
imsobad402: bets $0.33
Rexxmortis88: calls $0.33
*** TURN *** [2c Jh Ac] [5c]
Rexxmortis88: checks
imsobad402: checks
*** RIVER *** [2c Jh Ac 5c] [9d]
Rexxmortis88: bets $0.64
imsobad402: folds
Uncalled bet ($0.64) returned to Rexxmortis88
Rexxmortis88 collected $1.29 from pot
Rexxmortis88: doesn't show hand
*** SUMMARY ***
Total pot $1.36 | Rake $0.07
Board [2c Jh Ac 5c 9d]
Seat 1: Rexxmortis88 (small blind) collected ($1.29)
Seat 2: Mattymar98 (big blind) folded before Flop
Seat 3: tapouttazz9 folded before Flop (didn't bet)
Seat 4: CptBarnacles folded before Flop (didn't bet)
Seat 5: imsobad402 folded on the River
Seat 6: JoeFrosty (button) folded before Flop (didn't bet)


PokerStars Hand #157067654449:  Hold'em No Limit ($0.05/$0.10 USD) - 2016/08/17 17:35:45 ET
Table 'Kraz' 6-max Seat #1 is the button
Seat 1: Rexxmortis88 ($4.23 in chips)
Seat 2: Mattymar98 ($9.59 in chips)
Seat 3: tapouttazz9 ($25.22 in chips)
Seat 4: CptBarnacles ($11.39 in chips)
Seat 5: imsobad402 ($10.62 in chips)
Seat 6: JoeFrosty ($8.41 in chips)
Mattymar98: posts small blind $0.05
tapouttazz9: posts big blind $0.10
*** HOLE CARDS ***
Dealt to tapouttazz9 [4h 5c]
CptBarnacles: folds
imsobad402: calls $0.10
JoeFrosty: folds
Rexxmortis88: folds
Mattymar98: folds
tapouttazz9: checks
*** FLOP *** [5d Tc Jc]
tapouttazz9: checks
imsobad402: bets $0.10
tapouttazz9: calls $0.10
*** TURN *** [5d Tc Jc] [Ks]
tapouttazz9: checks
imsobad402: checks
*** RIVER *** [5d Tc Jc Ks] [Ad]
tapouttazz9: bets $0.21
imsobad402: folds
Uncalled bet ($0.21) returned to tapouttazz9
tapouttazz9 collected $0.43 from pot
*** SUMMARY ***
Total pot $0.45 | Rake $0.02
Board [5d Tc Jc Ks Ad]
Seat 1: Rexxmortis88 (button) folded before Flop (didn't bet)
Seat 2: Mattymar98 (small blind) folded before Flop
Seat 3: tapouttazz9 (big blind) collected ($0.43)
Seat 4: CptBarnacles folded before Flop (didn't bet)
Seat 5: imsobad402 folded on the River
Seat 6: JoeFrosty folded before Flop (didn't bet)


PokerStars Hand #157067654695:  Hold'em No Limit ($0.05/$0.10 USD) - 2016/08/17 17:36:36 ET
Table 'Kraz' 6-max Seat #2 is the button
Seat 1: Rexxmortis88 ($4.23 in chips)
Seat 2: Mattymar98 ($9.54 in chips)
Seat 3: tapouttazz9 ($25.45 in chips)
Seat 4: CptBarnacles ($11.39 in chips)
Seat 5: imsobad402 ($10.42 in chips)
Seat 6: JoeFrosty ($8.41 in chips)
tapouttazz9: posts small blind $0.05
CptBarnacles: posts big blind $0.10
*** HOLE CARDS ***
Dealt to tapouttazz9 [Ks Ah]
imsobad402: folds
JoeFrosty: folds
Rexxmortis88: folds
Mattymar98: folds
tapouttazz9: raises $0.10 to $0.20
CptBarnacles: folds
Uncalled bet ($0.10) returned to tapouttazz9
tapouttazz9 collected $0.20 from pot
*** SUMMARY ***
Total pot $0.20 | Rake $0
Seat 1: Rexxmortis88 folded before Flop (didn't bet)
Seat 2: Mattymar98 (button) folded before Flop (didn't bet)
Seat 3: tapouttazz9 (small blind) collected ($0.20)
Seat 4: CptBarnacles (big blind) folded before Flop
Seat 5: imsobad402 folded before Flop (didn't bet)
Seat 6: JoeFrosty folded before Flop (didn't bet)


PokerStars Hand #157067654774:  Hold'em No Limit ($0.05/$0.10 USD) - 2016/08/17 17:36:51 ET
Table 'Kraz' 6-max Seat #3 is the button
Seat 1: Rexxmortis88 ($4.23 in chips)
Seat 2: Mattymar98 ($9.54 in chips)
Seat 3: tapouttazz9 ($25.55 in chips)
Seat 4: CptBarnacles ($11.29 in chips)
Seat 5: imsobad402 ($10.42 in chips)
Seat 6: JoeFrosty ($8.41 in chips)
CptBarnacles: posts small blind $0.05
imsobad402: posts big blind $0.10
*** HOLE CARDS ***
Dealt to tapouttazz9 [5d 2h]
JoeFrosty: calls $0.10
Rexxmortis88: folds
Mattymar98: folds
tapouttazz9: folds
CptBarnacles: folds
imsobad402: checks
*** FLOP *** [6s Td 8d]
imsobad402: bets $0.20
JoeFrosty: calls $0.20
*** TURN *** [6s Td 8d] [7h]
imsobad402: checks
JoeFrosty: bets $0.30
imsobad402: calls $0.30
*** RIVER *** [6s Td 8d 7h] [Ts]
imsobad402: bets $1.20
JoeFrosty: folds
Uncalled bet ($1.20) returned to imsobad402
imsobad402 collected $1.19 from pot
imsobad402: doesn't show hand
*** SUMMARY ***
Total pot $1.25 | Rake $0.06
Board [6s Td 8d 7h Ts]
Seat 1: Rexxmortis88 folded before Flop (didn't bet)
Seat 2: Mattymar98 folded before Flop (didn't bet)
Seat 3: tapouttazz9 (button) folded before Flop (didn't bet)
Seat 4: CptBarnacles (small blind) folded before Flop
Seat 5: imsobad402 (big blind) collected ($1.19)
Seat 6: JoeFrosty folded on the River


PokerStars Hand #157067654941:  Hold'em No Limit ($0.05/$0.10 USD) - 2016/08/17 17:37:23 ET
Table 'Kraz' 6-max Seat #4 is the button
Seat 1: Rexxmortis88 ($4.23 in chips)
Seat 2: Mattymar98 ($9.54 in chips)
Seat 3: tapouttazz9 ($25.55 in chips)
Seat 4: CptBarnacles ($11.24 in chips)
Seat 5: imsobad402 ($11.01 in chips)
Seat 6: JoeFrosty ($7.81 in chips)
imsobad402: posts small blind $0.05
JoeFrosty: posts big blind $0.10
*** HOLE CARDS ***
Dealt to tapouttazz9 [Ah 7s]
Rexxmortis88: raises $0.30 to $0.40
Mattymar98: folds
tapouttazz9: folds
CptBarnacles: folds
imsobad402: folds
JoeFrosty: folds
Uncalled bet ($0.30) returned to Rexxmortis88
Rexxmortis88 collected $0.25 from pot
Rexxmortis88: doesn't show hand
*** SUMMARY ***
Total pot $0.25 | Rake $0
Seat 1: Rexxmortis88 collected ($0.25)
Seat 2: Mattymar98 folded before Flop (didn't bet)
Seat 3: tapouttazz9 folded before Flop (didn't bet)
Seat 4: CptBarnacles (button) folded before Flop (didn't bet)
Seat 5: imsobad402 (small blind) folded before Flop
Seat 6: JoeFrosty (big blind) folded before Flop


PokerStars Hand #157067655017:  Hold'em No Limit ($0.05/$0.10 USD) - 2016/08/17 17:37:39 ET
Table 'Kraz' 6-max Seat #5 is the button
Seat 1: Rexxmortis88 ($4.38 in chips)
Seat 2: Mattymar98 ($9.54 in chips)
Seat 3: tapouttazz9 ($25.55 in chips)
Seat 4: CptBarnacles ($11.24 in chips)
Seat 5: imsobad402 ($10.96 in chips)
Seat 6: JoeFrosty ($7.71 in chips)
JoeFrosty: posts small blind $0.05
Rexxmortis88: posts big blind $0.10
*** HOLE CARDS ***
Dealt to tapouttazz9 [5s Qh]
Mattymar98: folds
tapouttazz9: folds
CptBarnacles: folds
imsobad402: folds
JoeFrosty: folds
Uncalled bet ($0.05) returned to Rexxmortis88
Rexxmortis88 collected $0.10 from pot
Rexxmortis88: doesn't show hand
*** SUMMARY ***
Total pot $0.10 | Rake $0
Seat 1: Rexxmortis88 (big blind) collected ($0.10)
Seat 2: Mattymar98 folded before Flop (didn't bet)
Seat 3: tapouttazz9 folded before Flop (didn't bet)
Seat 4: CptBarnacles folded before Flop (didn't bet)
Seat 5: imsobad402 (button) folded before Flop (didn't bet)
Seat 6: JoeFrosty (small blind) folded before Flop


PokerStars Hand #157067655095:  Hold'em No Limit ($0.05/$0.10 USD) - 2016/08/17 17:37:55 ET
Table 'Kraz' 6-max Seat #6 is the button
Seat 1: Rexxmortis88 ($4.43 in chips)
Seat 2: Mattymar98 ($9.54 in chips)
Seat 3: tapouttazz9 ($25.55 in chips)
Seat 4: CptBarnacles ($11.24 in chips)
Seat 5: imsobad402 ($10.96 in chips)
Seat 6: JoeFrosty ($7.66 in chips)
Rexxmortis88: posts small blind $0.05
Mattymar98: posts big blind $0.10
*** HOLE CARDS ***
Dealt to tapouttazz9 [7s 5c]
tapouttazz9: folds
CptBarnacles: raises $0.15 to $0.25
imsobad402: folds
JoeFrosty: raises $7.41 to $7.66 and is all-in
Rexxmortis88: folds
Mattymar98: folds
CptBarnacles: folds
Uncalled bet ($7.41) returned to JoeFrosty
JoeFrosty collected $0.65 from pot
JoeFrosty: doesn't show hand
*** SUMMARY ***
Total pot $0.65 | Rake $0
Seat 1: Rexxmortis88 (small blind) folded before Flop
Seat 2: Mattymar98 (big blind) folded before Flop
Seat 3: tapouttazz9 folded before Flop (didn't bet)
Seat 4: CptBarnacles folded before Flop
Seat 5: imsobad402 folded before Flop (didn't bet)
Seat 6: JoeFrosty (button) collected ($0.65)


PokerStars Hand #157067655205:  Hold'em No Limit ($0.05/$0.10 USD) - 2016/08/17 17:38:16 ET
Table 'Kraz' 6-max Seat #1 is the button
Seat 1: Rexxmortis88 ($4.38 in chips)
Seat 2: Mattymar98 ($9.44 in chips)
Seat 3: tapouttazz9 ($25.55 in chips)
Seat 4: CptBarnacles ($10.99 in chips)
Seat 5: imsobad402 ($10.96 in chips)
Seat 6: JoeFrosty ($8.06 in chips)
Mattymar98: posts small blind $0.05
tapouttazz9: posts big blind $0.10
*** HOLE CARDS ***
Dealt to tapouttazz9 [7h 2s]
CptBarnacles: folds
imsobad402: folds
JoeFrosty: calls $0.10
Rexxmortis88: folds
Mattymar98: calls $0.05
tapouttazz9: checks
*** FLOP *** [Kd 3h 8s]
Mattymar98: checks
tapouttazz9: checks
JoeFrosty: bets $0.20
Mattymar98: folds
tapouttazz9: folds
Uncalled bet ($0.20) returned to JoeFrosty
JoeFrosty collected $0.28 from pot
JoeFrosty: doesn't show hand
*** SUMMARY ***
Total pot $0.30 | Rake $0.02
Board [Kd 3h 8s]
Seat 1: Rexxmortis88 (button) folded before Flop (didn't bet)
Seat 2: Mattymar98 (small blind) folded on the Flop
Seat 3: tapouttazz9 (big blind) folded on the Flop
Seat 4: CptBarnacles folded before Flop (didn't bet)
Seat 5: imsobad402 folded before Flop (didn't bet)
Seat 6: JoeFrosty collected ($0.28)


PokerStars Hand #157067655396:  Hold'em No Limit ($0.05/$0.10 USD) - 2016/08/17 17:38:58 ET
Table 'Kraz' 6-max Seat #2 is the button
Seat 1: Rexxmortis88 ($4.38 in chips)
Seat 2: Mattymar98 ($9.34 in chips)
Seat 3: tapouttazz9 ($25.45 in chips)
Seat 4: CptBarnacles ($10.99 in chips)
Seat 5: imsobad402 ($10.96 in chips)
Seat 6: JoeFrosty ($8.24 in chips)
tapouttazz9: posts small blind $0.05
CptBarnacles: posts big blind $0.10
*** HOLE CARDS ***
Dealt to tapouttazz9 [6s 9s]
imsobad402: folds
JoeFrosty: folds
Rexxmortis88: folds
Mattymar98: folds
tapouttazz9: folds
Uncalled bet ($0.05) returned to CptBarnacles
CptBarnacles collected $0.10 from pot
CptBarnacles: doesn't show hand
*** SUMMARY ***
Total pot $0.10 | Rake $0
Seat 1: Rexxmortis88 folded before Flop (didn't bet)
Seat 2: Mattymar98 (button) folded before Flop (didn't bet)
Seat 3: tapouttazz9 (small blind) folded before Flop
Seat 4: CptBarnacles (big blind) collected ($0.10)
Seat 5: imsobad402 folded before Flop (didn't bet)
Seat 6: JoeFrosty folded before Flop (didn't bet)


PokerStars Hand #157067655431:  Hold'em No Limit ($0.05/$0.10 USD) - 2016/08/17 17:39:05 ET
Table 'Kraz' 6-max Seat #3 is the button
Seat 1: Rexxmortis88 ($4.38 in chips)
Seat 2: Mattymar98 ($9.34 in chips)
Seat 3: tapouttazz9 ($25.40 in chips)
Seat 4: CptBarnacles ($11.04 in chips)
Seat 5: imsobad402 ($10.96 in chips)
Seat 6: JoeFrosty ($8.24 in chips)
CptBarnacles: posts small blind $0.05
imsobad402: posts big blind $0.10
*** HOLE CARDS ***
Dealt to tapouttazz9 [4d As]
JoeFrosty: folds
Rexxmortis88: folds
Mattymar98: folds
tapouttazz9: raises $0.20 to $0.30
CptBarnacles: folds
imsobad402: calls $0.20
*** FLOP *** [3h Kd Ks]
imsobad402: checks
tapouttazz9: bets $0.62
imsobad402: raises $0.62 to $1.24
tapouttazz9: folds
Uncalled bet ($0.62) returned to imsobad402
imsobad402 collected $1.80 from pot
imsobad402: doesn't show hand
*** SUMMARY ***
Total pot $1.89 | Rake $0.09
Board [3h Kd Ks]
Seat 1: Rexxmortis88 folded before Flop (didn't bet)
Seat 2: Mattymar98 folded before Flop (didn't bet)
Seat 3: tapouttazz9 (button) folded on the Flop
Seat 4: CptBarnacles (small blind) folded before Flop
Seat 5: imsobad402 (big blind) collected ($1.80)
Seat 6: JoeFrosty folded before Flop (didn't bet)


PokerStars Hand #157067655575:  Hold'em No Limit ($0.05/$0.10 USD) - 2016/08/17 17:39:39 ET
Table 'Kraz' 6-max Seat #4 is the button
Seat 1: Rexxmortis88 ($4.38 in chips)
Seat 2: Mattymar98 ($9.34 in chips)
Seat 3: tapouttazz9 ($24.48 in chips)
Seat 4: CptBarnacles ($10.99 in chips)
Seat 5: imsobad402 ($11.84 in chips)
Seat 6: JoeFrosty ($8.24 in chips)
imsobad402: posts small blind $0.05
JoeFrosty: posts big blind $0.10
*** HOLE CARDS ***
Dealt to tapouttazz9 [Ad 5d]
Rexxmortis88: folds
Mattymar98: folds
tapouttazz9: raises $0.20 to $0.30
CptBarnacles: folds
imsobad402: folds
JoeFrosty: calls $0.20
*** FLOP *** [As 2h Kh]
JoeFrosty: bets $0.30
tapouttazz9: calls $0.30
*** TURN *** [As 2h Kh] [Jc]
JoeFrosty: bets $1.20
tapouttazz9: calls $1.20
*** RIVER *** [As 2h Kh Jc] [Tc]
JoeFrosty: bets $1.70
tapouttazz9: calls $1.70
*** SHOW DOWN ***
JoeFrosty: shows [Qs Ts] (a straight, Ten to Ace)
tapouttazz9: mucks hand
JoeFrosty collected $6.70 from pot
JoeFrosty is disconnected
*** SUMMARY ***
Total pot $7.05 | Rake $0.35
Board [As 2h Kh Jc Tc]
Seat 1: Rexxmortis88 folded before Flop (didn't bet)
Seat 2: Mattymar98 folded before Flop (didn't bet)
Seat 3: tapouttazz9 mucked [Ad 5d]
Seat 4: CptBarnacles (button) folded before Flop (didn't bet)
Seat 5: imsobad402 (small blind) folded before Flop
Seat 6: JoeFrosty (big blind) showed [Qs Ts] and won ($6.70) with a straight, Ten to Ace


PokerStars Hand #157067655788:  Hold'em No Limit ($0.05/$0.10 USD) - 2016/08/17 17:40:25 ET
Table 'Kraz' 6-max Seat #5 is the button
Seat 1: Rexxmortis88 ($4.38 in chips)
Seat 2: Mattymar98 ($9.34 in chips)
Seat 3: tapouttazz9 ($20.98 in chips)
Seat 4: CptBarnacles ($10.99 in chips)
Seat 5: imsobad402 ($11.79 in chips)
Rexxmortis88: posts small blind $0.05
Mattymar98: posts big blind $0.10
*** HOLE CARDS ***
Dealt to tapouttazz9 [6d Kh]
tapouttazz9: folds
CptBarnacles: folds
imsobad402: raises $0.20 to $0.30
Rexxmortis88: folds
Mattymar98: folds
Uncalled bet ($0.20) returned to imsobad402
imsobad402 collected $0.25 from pot
imsobad402: doesn't show hand
*** SUMMARY ***
Total pot $0.25 | Rake $0
Seat 1: Rexxmortis88 (small blind) folded before Flop
Seat 2: Mattymar98 (big blind) folded before Flop
Seat 3: tapouttazz9 folded before Flop (didn't bet)
Seat 4: CptBarnacles folded before Flop (didn't bet)
Seat 5: imsobad402 (button) collected ($0.25)


PokerStars Hand #157067655846:  Hold'em No Limit ($0.05/$0.10 USD) - 2016/08/17 17:40:38 ET
Table 'Kraz' 6-max Seat #1 is the button
Seat 1: Rexxmortis88 ($4.33 in chips)
Seat 2: Mattymar98 ($9.24 in chips)
Seat 3: tapouttazz9 ($20.98 in chips)
Seat 4: CptBarnacles ($10.99 in chips)
Seat 5: imsobad402 ($11.94 in chips)
Mattymar98: posts small blind $0.05
tapouttazz9: posts big blind $0.10
*** HOLE CARDS ***
Dealt to tapouttazz9 [Jh 6c]
CptBarnacles: raises $0.15 to $0.25
imsobad402: calls $0.25
Rexxmortis88: folds
Mattymar98: folds
tapouttazz9: folds
*** FLOP *** [2d 4c 4d]
CptBarnacles: checks
Rexxmortis88 leaves the table
imsobad402: checks
*** TURN *** [2d 4c 4d] [Qc]
CptBarnacles: bets $0.40
imsobad402: calls $0.40
*** RIVER *** [2d 4c 4d Qc] [3s]
CptBarnacles: bets $0.60
imsobad402: calls $0.60
*** SHOW DOWN ***
CptBarnacles: shows [Jc Jd] (two pair, Jacks and Fours)
imsobad402: shows [Qh 9h] (two pair, Queens and Fours)
imsobad402 collected $2.52 from pot
*** SUMMARY ***
Total pot $2.65 | Rake $0.13
Board [2d 4c 4d Qc 3s]
Seat 1: Rexxmortis88 (button) folded before Flop (didn't bet)
Seat 2: Mattymar98 (small blind) folded before Flop
Seat 3: tapouttazz9 (big blind) folded before Flop
Seat 4: CptBarnacles showed [Jc Jd] and lost with two pair, Jacks and Fours
Seat 5: imsobad402 showed [Qh 9h] and won ($2.52) with two pair, Queens and Fours


PokerStars Hand #157067656327:  Hold'em No Limit ($0.05/$0.10 USD) - 2016/08/17 17:42:19 ET
Table 'Kraz' 6-max Seat #5 is the button
Seat 2: Mattymar98 ($9.73 in chips)
Seat 3: tapouttazz9 ($20.88 in chips)
Seat 4: CptBarnacles ($10 in chips)
Seat 5: imsobad402 ($12.66 in chips)
Mattymar98: posts small blind $0.05
tapouttazz9: posts big blind $0.10
*** HOLE CARDS ***
Dealt to tapouttazz9 [4d 8d]
CptBarnacles: folds
imsobad402: raises $0.20 to $0.30
Mattymar98: folds
tapouttazz9: folds
Uncalled bet ($0.20) returned to imsobad402
imsobad402 collected $0.25 from pot
imsobad402: doesn't show hand
*** SUMMARY ***
Total pot $0.25 | Rake $0
Seat 2: Mattymar98 (small blind) folded before Flop
Seat 3: tapouttazz9 (big blind) folded before Flop
Seat 4: CptBarnacles folded before Flop (didn't bet)
Seat 5: imsobad402 (button) collected ($0.25)


PokerStars Hand #157067656409:  Hold'em No Limit ($0.05/$0.10 USD) - 2016/08/17 17:42:35 ET
Table 'Kraz' 6-max Seat #2 is the button
Seat 2: Mattymar98 ($9.68 in chips)
Seat 3: tapouttazz9 ($20.78 in chips)
Seat 5: imsobad402 ($12.81 in chips)
tapouttazz9: posts small blind $0.05
CptBarnacles: is sitting out
CptBarnacles leaves the table
imsobad402: posts big blind $0.10
*** HOLE CARDS ***
Dealt to tapouttazz9 [Qc 9h]
Mattymar98: raises $0.20 to $0.30
tapouttazz9: folds
imsobad402: folds
Uncalled bet ($0.20) returned to Mattymar98
Mattymar98 collected $0.25 from pot
*** SUMMARY ***
Total pot $0.25 | Rake $0
Seat 2: Mattymar98 (button) collected ($0.25)
Seat 3: tapouttazz9 (small blind) folded before Flop
Seat 5: imsobad402 (big blind) folded before Flop


PokerStars Hand #157067656454:  Hold'em No Limit ($0.05/$0.10 USD) - 2016/08/17 17:42:44 ET
Table 'Kraz' 6-max Seat #3 is the button
Seat 2: Mattymar98 ($9.83 in chips)
Seat 3: tapouttazz9 ($20.73 in chips)
Seat 5: imsobad402 ($12.71 in chips)
imsobad402: posts small blind $0.05
Mattymar98: posts big blind $0.10
*** HOLE CARDS ***
Dealt to tapouttazz9 [Ac 7d]
tapouttazz9: folds
imsobad402: calls $0.05
Mattymar98: checks
*** FLOP *** [Jh 6s 5h]
imsobad402: checks
Mattymar98: checks
*** TURN *** [Jh 6s 5h] [5c]
imsobad402: bets $0.10
Mattymar98: folds
Uncalled bet ($0.10) returned to imsobad402
imsobad402 collected $0.19 from pot
imsobad402: doesn't show hand
*** SUMMARY ***
Total pot $0.20 | Rake $0.01
Board [Jh 6s 5h 5c]
Seat 2: Mattymar98 (big blind) folded on the Turn
Seat 3: tapouttazz9 (button) folded before Flop (didn't bet)
Seat 5: imsobad402 (small blind) collected ($0.19)


PokerStars Hand #157067656615:  Hold'em No Limit ($0.05/$0.10 USD) - 2016/08/17 17:43:13 ET
Table 'Kraz' 6-max Seat #5 is the button
Seat 2: Mattymar98 ($9.73 in chips)
Seat 3: tapouttazz9 ($20.73 in chips)
Seat 5: imsobad402 ($12.80 in chips)
Mattymar98: posts small blind $0.05
tapouttazz9: posts big blind $0.10
*** HOLE CARDS ***
Dealt to tapouttazz9 [5s 8s]
imsobad402: folds
imsobad402 leaves the table
Mattymar98: folds
Uncalled bet ($0.05) returned to tapouttazz9
tapouttazz9 collected $0.10 from pot
*** SUMMARY ***
Total pot $0.10 | Rake $0
Seat 2: Mattymar98 (small blind) folded before Flop
Seat 3: tapouttazz9 (big blind) collected ($0.10)
Seat 5: imsobad402 (button) folded before Flop (didn't bet)


PokerStars Hand #157069518379:  Hold'em No Limit ($0.05/$0.10 USD) - 2016/08/17 18:08:44 ET
Table 'Orion' 6-max Seat #5 is the button
Seat 1: tapouttazz9 ($10 in chips)
Seat 2: BigPhil1959 ($6.32 in chips)
Seat 3: millertime42 ($14.24 in chips)
Seat 4: HogPhallus ($8.37 in chips)
Seat 5: righty01 ($9.60 in chips)
Seat 6: havea69vette ($11.05 in chips)
havea69vette: posts small blind $0.05
tapouttazz9: posts big blind $0.10
*** HOLE CARDS ***
Dealt to tapouttazz9 [5h 3h]
BigPhil1959: calls $0.10
millertime42: folds
HogPhallus: folds
righty01: folds
havea69vette: folds
tapouttazz9: checks
*** FLOP *** [2c 6c Jc]
tapouttazz9: checks
BigPhil1959: bets $0.12
tapouttazz9: folds
Uncalled bet ($0.12) returned to BigPhil1959
BigPhil1959 collected $0.24 from pot
BigPhil1959: doesn't show hand
*** SUMMARY ***
Total pot $0.25 | Rake $0.01
Board [2c 6c Jc]
Seat 1: tapouttazz9 (big blind) folded on the Flop
Seat 2: BigPhil1959 collected ($0.24)
Seat 3: millertime42 folded before Flop (didn't bet)
Seat 4: HogPhallus folded before Flop (didn't bet)
Seat 5: righty01 (button) folded before Flop (didn't bet)
Seat 6: havea69vette (small blind) folded before Flop


PokerStars Hand #157069518480:  Hold'em No Limit ($0.05/$0.10 USD) - 2016/08/17 18:09:04 ET
Table 'Orion' 6-max Seat #6 is the button
Seat 1: tapouttazz9 ($9.90 in chips)
Seat 2: BigPhil1959 ($6.46 in chips)
Seat 3: millertime42 ($14.24 in chips)
Seat 4: HogPhallus ($8.37 in chips)
Seat 5: righty01 ($9.60 in chips)
Seat 6: havea69vette ($11 in chips)
tapouttazz9: posts small blind $0.05
BigPhil1959: posts big blind $0.10
*** HOLE CARDS ***
Dealt to tapouttazz9 [6c Ad]
millertime42: folds
HogPhallus: folds
righty01: folds
millertime42 leaves the table
havea69vette: raises $0.25 to $0.35
CavalierZero joins the table at seat #3
tapouttazz9: folds
BigPhil1959: folds
Uncalled bet ($0.25) returned to havea69vette
havea69vette collected $0.25 from pot
havea69vette: doesn't show hand
*** SUMMARY ***
Total pot $0.25 | Rake $0
Seat 1: tapouttazz9 (small blind) folded before Flop
Seat 2: BigPhil1959 (big blind) folded before Flop
Seat 3: millertime42 folded before Flop (didn't bet)
Seat 4: HogPhallus folded before Flop (didn't bet)
Seat 5: righty01 folded before Flop (didn't bet)
Seat 6: havea69vette (button) collected ($0.25)


PokerStars Hand #157069518547:  Hold'em No Limit ($0.05/$0.10 USD) - 2016/08/17 18:09:19 ET
Table 'Orion' 6-max Seat #1 is the button
Seat 1: tapouttazz9 ($9.85 in chips)
Seat 2: BigPhil1959 ($6.36 in chips)
Seat 3: CavalierZero ($10 in chips)
Seat 4: HogPhallus ($8.37 in chips)
Seat 5: righty01 ($9.60 in chips)
Seat 6: havea69vette ($11.15 in chips)
BigPhil1959: posts small blind $0.05
CavalierZero: posts big blind $0.10
*** HOLE CARDS ***
Dealt to tapouttazz9 [Td Qc]
HogPhallus: folds
righty01: folds
havea69vette: folds
tapouttazz9: raises $0.20 to $0.30
BigPhil1959: folds
CavalierZero: calls $0.20
*** FLOP *** [7h Kh 9c]
BigPhil1959 leaves the table
CavalierZero: bets $0.45
tapouttazz9: calls $0.45
*** TURN *** [7h Kh 9c] [3c]
runbich joins the table at seat #2
CavalierZero: checks
tapouttazz9: bets $0.73
CavalierZero: calls $0.73
*** RIVER *** [7h Kh 9c 3c] [Jd]
CavalierZero: checks
tapouttazz9: bets $3.20
CavalierZero: folds
Uncalled bet ($3.20) returned to tapouttazz9
tapouttazz9 collected $2.86 from pot
*** SUMMARY ***
Total pot $3.01 | Rake $0.15
Board [7h Kh 9c 3c Jd]
Seat 1: tapouttazz9 (button) collected ($2.86)
Seat 2: BigPhil1959 (small blind) folded before Flop
Seat 3: CavalierZero (big blind) folded on the River
Seat 4: HogPhallus folded before Flop (didn't bet)
Seat 5: righty01 folded before Flop (didn't bet)
Seat 6: havea69vette folded before Flop (didn't bet)


PokerStars Hand #157069518746:  Hold'em No Limit ($0.05/$0.10 USD) - 2016/08/17 18:10:02 ET
Table 'Orion' 6-max Seat #3 is the button
Seat 1: tapouttazz9 ($11.23 in chips)
Seat 3: CavalierZero ($8.52 in chips)
Seat 4: HogPhallus ($8.37 in chips)
Seat 5: righty01 ($9.60 in chips)
Seat 6: havea69vette ($11.15 in chips)
HogPhallus: posts small blind $0.05
righty01: posts big blind $0.10
runbich: sits out
*** HOLE CARDS ***
Dealt to tapouttazz9 [Ad 7d]
havea69vette: folds
tapouttazz9: raises $0.10 to $0.20
CavalierZero: calls $0.20
HogPhallus: folds
righty01: calls $0.10
*** FLOP *** [Qd 8c Ah]
righty01: checks
tapouttazz9: checks
CavalierZero: checks
*** TURN *** [Qd 8c Ah] [Th]
righty01: checks
tapouttazz9: checks
CavalierZero: bets $0.50
righty01: folds
tapouttazz9: calls $0.50
*** RIVER *** [Qd 8c Ah Th] [4h]
tapouttazz9: checks
CavalierZero: checks
*** SHOW DOWN ***
tapouttazz9: shows [Ad 7d] (a pair of Aces)
CavalierZero: shows [Js 9c] (a straight, Eight to Queen)
CavalierZero collected $1.57 from pot
*** SUMMARY ***
Total pot $1.65 | Rake $0.08
Board [Qd 8c Ah Th 4h]
Seat 1: tapouttazz9 showed [Ad 7d] and lost with a pair of Aces
Seat 3: CavalierZero (button) showed [Js 9c] and won ($1.57) with a straight, Eight to Queen
Seat 4: HogPhallus (small blind) folded before Flop
Seat 5: righty01 (big blind) folded on the Turn
Seat 6: havea69vette folded before Flop (didn't bet)


PokerStars Hand #157069518924:  Hold'em No Limit ($0.05/$0.10 USD) - 2016/08/17 18:10:39 ET
Table 'Orion' 6-max Seat #4 is the button
Seat 1: tapouttazz9 ($10.53 in chips)
Seat 3: CavalierZero ($9.39 in chips)
Seat 4: HogPhallus ($8.32 in chips)
Seat 5: righty01 ($9.40 in chips)
Seat 6: havea69vette ($11.15 in chips)
righty01: posts small blind $0.05
havea69vette: posts big blind $0.10
runbich: sits out
*** HOLE CARDS ***
Dealt to tapouttazz9 [Qs 9s]
tapouttazz9: folds
CavalierZero: folds
HogPhallus: folds
righty01: calls $0.05
havea69vette: checks
*** FLOP *** [7c 2d Ac]
righty01: bets $0.20
havea69vette: calls $0.20
*** TURN *** [7c 2d Ac] [As]
righty01: bets $0.28
havea69vette: raises $0.56 to $0.84
righty01: calls $0.56
*** RIVER *** [7c 2d Ac As] [2c]
righty01: bets $2.30
havea69vette: folds
Uncalled bet ($2.30) returned to righty01
righty01 collected $2.17 from pot
righty01: doesn't show hand
*** SUMMARY ***
Total pot $2.28 | Rake $0.11
Board [7c 2d Ac As 2c]
Seat 1: tapouttazz9 folded before Flop (didn't bet)
Seat 3: CavalierZero folded before Flop (didn't bet)
Seat 4: HogPhallus (button) folded before Flop (didn't bet)
Seat 5: righty01 (small blind) collected ($2.17)
Seat 6: havea69vette (big blind) folded on the River


PokerStars Hand #157069519119:  Hold'em No Limit ($0.05/$0.10 USD) - 2016/08/17 18:11:20 ET
Table 'Orion' 6-max Seat #5 is the button
Seat 1: tapouttazz9 ($10.53 in chips)
Seat 3: CavalierZero ($9.39 in chips)
Seat 4: HogPhallus ($8.32 in chips)
Seat 5: righty01 ($10.43 in chips)
Seat 6: havea69vette ($10.01 in chips)
havea69vette: posts small blind $0.05
tapouttazz9: posts big blind $0.10
runbich: sits out
*** HOLE CARDS ***
Dealt to tapouttazz9 [4s 9h]
CavalierZero: calls $0.10
HogPhallus: calls $0.10
righty01: calls $0.10
havea69vette: folds
tapouttazz9: checks
*** FLOP *** [2d 9s Ts]
tapouttazz9: checks
CavalierZero: bets $0.20
HogPhallus: folds
righty01: calls $0.20
tapouttazz9: folds
*** TURN *** [2d 9s Ts] [3d]
CavalierZero: bets $0.55
righty01: calls $0.55
*** RIVER *** [2d 9s Ts 3d] [8h]
CavalierZero: checks
righty01: checks
*** SHOW DOWN ***
CavalierZero: shows [Jd 8d] (a pair of Eights)
righty01: shows [8c Jh] (a pair of Eights)
CavalierZero collected $0.93 from pot
righty01 collected $0.92 from pot
*** SUMMARY ***
Total pot $1.95 | Rake $0.10
Board [2d 9s Ts 3d 8h]
Seat 1: tapouttazz9 (big blind) folded on the Flop
Seat 3: CavalierZero showed [Jd 8d] and won ($0.93) with a pair of Eights
Seat 4: HogPhallus folded on the Flop
Seat 5: righty01 (button) showed [8c Jh] and won ($0.92) with a pair of Eights
Seat 6: havea69vette (small blind) folded before Flop


PokerStars Hand #157069519412:  Hold'em No Limit ($0.05/$0.10 USD) - 2016/08/17 18:12:21 ET
Table 'Orion' 6-max Seat #6 is the button
Seat 1: tapouttazz9 ($10.43 in chips)
Seat 2: runbich ($8 in chips)
Seat 3: CavalierZero ($9.47 in chips)
Seat 4: HogPhallus ($8.22 in chips)
Seat 5: righty01 ($10.50 in chips)
Seat 6: havea69vette ($10 in chips)
tapouttazz9: posts small blind $0.05
runbich: posts big blind $0.10
*** HOLE CARDS ***
Dealt to tapouttazz9 [7d 8s]
CavalierZero: calls $0.10
HogPhallus has timed out
HogPhallus: folds
righty01: folds
havea69vette: raises $0.35 to $0.45
tapouttazz9: folds
runbich: folds
CavalierZero: folds
Uncalled bet ($0.35) returned to havea69vette
havea69vette collected $0.35 from pot
havea69vette: doesn't show hand
*** SUMMARY ***
Total pot $0.35 | Rake $0
Seat 1: tapouttazz9 (small blind) folded before Flop
Seat 2: runbich (big blind) folded before Flop
Seat 3: CavalierZero folded before Flop
Seat 4: HogPhallus folded before Flop (didn't bet)
Seat 5: righty01 folded before Flop (didn't bet)
Seat 6: havea69vette (button) collected ($0.35)


PokerStars Hand #157069519596:  Hold'em No Limit ($0.05/$0.10 USD) - 2016/08/17 18:13:00 ET
Table 'Orion' 6-max Seat #1 is the button
Seat 1: tapouttazz9 ($10.38 in chips)
Seat 2: runbich ($7.90 in chips)
Seat 3: CavalierZero ($9.37 in chips)
Seat 4: HogPhallus ($8.22 in chips)
Seat 5: righty01 ($10.50 in chips)
Seat 6: havea69vette ($10.25 in chips)
runbich: posts small blind $0.05
CavalierZero: posts big blind $0.10
*** HOLE CARDS ***
Dealt to tapouttazz9 [2c 7c]
HogPhallus: folds
righty01: folds
havea69vette: raises $0.25 to $0.35
tapouttazz9: folds
runbich: folds
CavalierZero: folds
Uncalled bet ($0.25) returned to havea69vette
havea69vette collected $0.25 from pot
havea69vette: doesn't show hand
*** SUMMARY ***
Total pot $0.25 | Rake $0
Seat 1: tapouttazz9 (button) folded before Flop (didn't bet)
Seat 2: runbich (small blind) folded before Flop
Seat 3: CavalierZero (big blind) folded before Flop
Seat 4: HogPhallus folded before Flop (didn't bet)
Seat 5: righty01 folded before Flop (didn't bet)
Seat 6: havea69vette collected ($0.25)


PokerStars Hand #157069519668:  Hold'em No Limit ($0.05/$0.10 USD) - 2016/08/17 18:13:15 ET
Table 'Orion' 6-max Seat #2 is the button
Seat 1: tapouttazz9 ($10.38 in chips)
Seat 2: runbich ($7.85 in chips)
Seat 3: CavalierZero ($9.27 in chips)
Seat 4: HogPhallus ($8.22 in chips)
Seat 5: righty01 ($10.50 in chips)
Seat 6: havea69vette ($10.40 in chips)
CavalierZero: posts small blind $0.05
HogPhallus: posts big blind $0.10
*** HOLE CARDS ***
Dealt to tapouttazz9 [9s Jc]
righty01: folds
havea69vette: folds
tapouttazz9: folds
runbich: raises $0.10 to $0.20
CavalierZero: calls $0.15
HogPhallus: raises $0.10 to $0.30
runbich: calls $0.10
CavalierZero: calls $0.10
*** FLOP *** [Kd Ah Qs]
CavalierZero: checks
HogPhallus: bets $0.86
runbich: folds
CavalierZero: folds
Uncalled bet ($0.86) returned to HogPhallus
HogPhallus collected $0.86 from pot
*** SUMMARY ***
Total pot $0.90 | Rake $0.04
Board [Kd Ah Qs]
Seat 1: tapouttazz9 folded before Flop (didn't bet)
Seat 2: runbich (button) folded on the Flop
Seat 3: CavalierZero (small blind) folded on the Flop
Seat 4: HogPhallus (big blind) collected ($0.86)
Seat 5: righty01 folded before Flop (didn't bet)
Seat 6: havea69vette folded before Flop (didn't bet)


PokerStars Hand #157069519858:  Hold'em No Limit ($0.05/$0.10 USD) - 2016/08/17 18:13:55 ET
Table 'Orion' 6-max Seat #3 is the button
Seat 1: tapouttazz9 ($10.38 in chips)
Seat 2: runbich ($7.55 in chips)
Seat 3: CavalierZero ($8.97 in chips)
Seat 4: HogPhallus ($8.78 in chips)
Seat 5: righty01 ($10.50 in chips)
Seat 6: havea69vette ($10.40 in chips)
HogPhallus: posts small blind $0.05
righty01: posts big blind $0.10
*** HOLE CARDS ***
Dealt to tapouttazz9 [7s Ac]
havea69vette: folds
tapouttazz9: folds
runbich: folds
CavalierZero: folds
HogPhallus: calls $0.05
righty01: checks
*** FLOP *** [Kh 9s 4h]
HogPhallus: checks
righty01: checks
*** TURN *** [Kh 9s 4h] [2c]
HogPhallus: checks
righty01: checks
*** RIVER *** [Kh 9s 4h 2c] [8h]
HogPhallus: checks
righty01: checks
*** SHOW DOWN ***
HogPhallus: shows [3d 2d] (a pair of Deuces)
righty01: mucks hand
HogPhallus collected $0.19 from pot
*** SUMMARY ***
Total pot $0.20 | Rake $0.01
Board [Kh 9s 4h 2c 8h]
Seat 1: tapouttazz9 folded before Flop (didn't bet)
Seat 2: runbich folded before Flop (didn't bet)
Seat 3: CavalierZero (button) folded before Flop (didn't bet)
Seat 4: HogPhallus (small blind) showed [3d 2d] and won ($0.19) with a pair of Deuces
Seat 5: righty01 (big blind) mucked [3c 7h]
Seat 6: havea69vette folded before Flop (didn't bet)


PokerStars Hand #157070298702:  Hold'em No Limit ($0.05/$0.10 USD) - 2016/08/17 18:15:09 ET
Table 'Orion' 6-max Seat #4 is the button
Seat 1: tapouttazz9 ($10.38 in chips)
Seat 2: runbich ($7.55 in chips)
Seat 3: CavalierZero ($8.97 in chips)
Seat 4: HogPhallus ($8.87 in chips)
Seat 5: righty01 ($10.40 in chips)
Seat 6: havea69vette ($10.40 in chips)
righty01: posts small blind $0.05
havea69vette: posts big blind $0.10
*** HOLE CARDS ***
Dealt to tapouttazz9 [5c 9h]
tapouttazz9: folds
runbich: folds
CavalierZero: folds
HogPhallus: raises $0.25 to $0.35
righty01: calls $0.30
havea69vette: calls $0.25
*** FLOP *** [4d Ks 9d]
righty01: checks
havea69vette: checks
HogPhallus: bets $0.10
righty01: folds
havea69vette: folds
Uncalled bet ($0.10) returned to HogPhallus
HogPhallus collected $1 from pot
*** SUMMARY ***
Total pot $1.05 | Rake $0.05
Board [4d Ks 9d]
Seat 1: tapouttazz9 folded before Flop (didn't bet)
Seat 2: runbich folded before Flop (didn't bet)
Seat 3: CavalierZero folded before Flop (didn't bet)
Seat 4: HogPhallus (button) collected ($1)
Seat 5: righty01 (small blind) folded on the Flop
Seat 6: havea69vette (big blind) folded on the Flop


PokerStars Hand #157070298849:  Hold'em No Limit ($0.05/$0.10 USD) - 2016/08/17 18:15:44 ET
Table 'Orion' 6-max Seat #5 is the button
Seat 1: tapouttazz9 ($10.38 in chips)
Seat 2: runbich ($7.55 in chips)
Seat 3: CavalierZero ($8.97 in chips)
Seat 4: HogPhallus ($9.52 in chips)
Seat 5: righty01 ($10.05 in chips)
Seat 6: havea69vette ($10.05 in chips)
havea69vette: posts small blind $0.05
tapouttazz9: posts big blind $0.10
*** HOLE CARDS ***
Dealt to tapouttazz9 [Qc 8d]
runbich: folds
CavalierZero: calls $0.10
HogPhallus: calls $0.10
righty01: folds
havea69vette: folds
tapouttazz9: checks
*** FLOP *** [Tc 9h Th]
tapouttazz9: checks
CavalierZero: checks
HogPhallus: bets $0.10
tapouttazz9: calls $0.10
CavalierZero: folds
*** TURN *** [Tc 9h Th] [Qd]
tapouttazz9: checks
HogPhallus: checks
*** RIVER *** [Tc 9h Th Qd] [Jc]
tapouttazz9: bets $0.26
HogPhallus: raises $1.04 to $1.30
tapouttazz9: folds [Qc 8d]
Uncalled bet ($1.04) returned to HogPhallus
HogPhallus collected $1.02 from pot
*** SUMMARY ***
Total pot $1.07 | Rake $0.05
Board [Tc 9h Th Qd Jc]
Seat 1: tapouttazz9 (big blind) folded on the River
Seat 2: runbich folded before Flop (didn't bet)
Seat 3: CavalierZero folded on the Flop
Seat 4: HogPhallus collected ($1.02)
Seat 5: righty01 (button) folded before Flop (didn't bet)
Seat 6: havea69vette (small blind) folded before Flop


PokerStars Hand #157070299308:  Hold'em No Limit ($0.05/$0.10 USD) - 2016/08/17 18:17:19 ET
Table 'Orion' 6-max Seat #6 is the button
Seat 1: tapouttazz9 ($9.92 in chips)
Seat 2: runbich ($7.55 in chips)
Seat 3: CavalierZero ($10 in chips)
Seat 4: HogPhallus ($10.08 in chips)
Seat 5: righty01 ($10.05 in chips)
Seat 6: havea69vette ($10 in chips)
tapouttazz9: posts small blind $0.05
runbich: posts big blind $0.10
*** HOLE CARDS ***
Dealt to tapouttazz9 [4s 3s]
CavalierZero: calls $0.10
HogPhallus: folds
righty01: folds
havea69vette: raises $0.35 to $0.45
tapouttazz9 said, "think i just saved money there"
tapouttazz9: folds
runbich: folds
HogPhallus leaves the table
CavalierZero: calls $0.35
*** FLOP *** [9s 8d 6s]
CavalierZero: checks
havea69vette: bets $0.50
CavalierZero: calls $0.50
*** TURN *** [9s 8d 6s] [9d]
CavalierZero: checks
havea69vette: bets $0.97
CavalierZero: raises $1.94 to $2.91
havea69vette: folds
Uncalled bet ($1.94) returned to CavalierZero
CavalierZero collected $3.79 from pot
*** SUMMARY ***
Total pot $3.99 | Rake $0.20
Board [9s 8d 6s 9d]
Seat 1: tapouttazz9 (small blind) folded before Flop
Seat 2: runbich (big blind) folded before Flop
Seat 3: CavalierZero collected ($3.79)
Seat 4: HogPhallus folded before Flop (didn't bet)
Seat 5: righty01 folded before Flop (didn't bet)
Seat 6: havea69vette (button) folded on the Turn


PokerStars Hand #157070299503:  Hold'em No Limit ($0.05/$0.10 USD) - 2016/08/17 18:18:00 ET
Table 'Orion' 6-max Seat #1 is the button
Seat 1: tapouttazz9 ($9.87 in chips)
Seat 2: runbich ($7.45 in chips)
Seat 3: CavalierZero ($11.87 in chips)
Seat 5: righty01 ($10.05 in chips)
Seat 6: havea69vette ($10 in chips)
runbich: posts small blind $0.05
CavalierZero: posts big blind $0.10
*** HOLE CARDS ***
Dealt to tapouttazz9 [Qc As]
righty01: folds
havea69vette: folds
tapouttazz9: raises $0.20 to $0.30
runbich: folds
CavalierZero: folds
Uncalled bet ($0.20) returned to tapouttazz9
tapouttazz9 collected $0.25 from pot
*** SUMMARY ***
Total pot $0.25 | Rake $0
Seat 1: tapouttazz9 (button) collected ($0.25)
Seat 2: runbich (small blind) folded before Flop
Seat 3: CavalierZero (big blind) folded before Flop
Seat 5: righty01 folded before Flop (didn't bet)
Seat 6: havea69vette folded before Flop (didn't bet)


PokerStars Hand #157070299569:  Hold'em No Limit ($0.05/$0.10 USD) - 2016/08/17 18:18:13 ET
Table 'Orion' 6-max Seat #2 is the button
Seat 1: tapouttazz9 ($10.02 in chips)
Seat 2: runbich ($7.40 in chips)
Seat 3: CavalierZero ($11.77 in chips)
Seat 5: righty01 ($10.05 in chips)
Seat 6: havea69vette ($10 in chips)
CavalierZero: posts small blind $0.05
righty01: posts big blind $0.10
*** HOLE CARDS ***
Dealt to tapouttazz9 [Js 3s]
havea69vette: folds
tapouttazz9: folds
runbich: folds
CavalierZero: folds
Uncalled bet ($0.05) returned to righty01
righty01 collected $0.10 from pot
righty01: doesn't show hand
*** SUMMARY ***
Total pot $0.10 | Rake $0
Seat 1: tapouttazz9 folded before Flop (didn't bet)
Seat 2: runbich (button) folded before Flop (didn't bet)
Seat 3: CavalierZero (small blind) folded before Flop
Seat 5: righty01 (big blind) collected ($0.10)
Seat 6: havea69vette folded before Flop (didn't bet)


PokerStars Hand #157070299624:  Hold'em No Limit ($0.05/$0.10 USD) - 2016/08/17 18:18:22 ET
Table 'Orion' 6-max Seat #3 is the button
Seat 1: tapouttazz9 ($10.02 in chips)
Seat 2: runbich ($7.40 in chips)
Seat 3: CavalierZero ($11.72 in chips)
Seat 5: righty01 ($10.10 in chips)
Seat 6: havea69vette ($10 in chips)
righty01: posts small blind $0.05
havea69vette: posts big blind $0.10
*** HOLE CARDS ***
Dealt to tapouttazz9 [Ah 7d]
tapouttazz9: folds
runbich: folds
CavalierZero: folds
righty01: calls $0.05
havea69vette: checks
*** FLOP *** [As 3c Kc]
righty01: checks
havea69vette: bets $0.19
righty01: folds
Uncalled bet ($0.19) returned to havea69vette
havea69vette collected $0.19 from pot
havea69vette: doesn't show hand
*** SUMMARY ***
Total pot $0.20 | Rake $0.01
Board [As 3c Kc]
Seat 1: tapouttazz9 folded before Flop (didn't bet)
Seat 2: runbich folded before Flop (didn't bet)
Seat 3: CavalierZero (button) folded before Flop (didn't bet)
Seat 5: righty01 (small blind) folded on the Flop
Seat 6: havea69vette (big blind) collected ($0.19)


PokerStars Hand #157070299734:  Hold'em No Limit ($0.05/$0.10 USD) - 2016/08/17 18:18:45 ET
Table 'Orion' 6-max Seat #5 is the button
Seat 1: tapouttazz9 ($10.02 in chips)
Seat 2: runbich ($7.40 in chips)
Seat 3: CavalierZero ($11.72 in chips)
Seat 5: righty01 ($10 in chips)
Seat 6: havea69vette ($10.09 in chips)
havea69vette: posts small blind $0.05
tapouttazz9: posts big blind $0.10
*** HOLE CARDS ***
Dealt to tapouttazz9 [7s 7h]
runbich: folds
CavalierZero: folds
righty01: calls $0.10
havea69vette: folds
tapouttazz9: checks
*** FLOP *** [4c As Qs]
tapouttazz9: checks
righty01: checks
*** TURN *** [4c As Qs] [Td]
tapouttazz9: checks
righty01: bets $0.40
tapouttazz9: folds
Uncalled bet ($0.40) returned to righty01
righty01 collected $0.24 from pot
righty01: doesn't show hand
*** SUMMARY ***
Total pot $0.25 | Rake $0.01
Board [4c As Qs Td]
Seat 1: tapouttazz9 (big blind) folded on the Turn
Seat 2: runbich folded before Flop (didn't bet)
Seat 3: CavalierZero folded before Flop (didn't bet)
Seat 5: righty01 (button) collected ($0.24)
Seat 6: havea69vette (small blind) folded before Flop


PokerStars Hand #157070299857:  Hold'em No Limit ($0.05/$0.10 USD) - 2016/08/17 18:19:10 ET
Table 'Orion' 6-max Seat #6 is the button
Seat 1: tapouttazz9 ($9.92 in chips)
Seat 2: runbich ($7.40 in chips)
Seat 5: righty01 ($10.14 in chips)
Seat 6: havea69vette ($10.04 in chips)
tapouttazz9: posts small blind $0.05
runbich: posts big blind $0.10
*** HOLE CARDS ***
Dealt to tapouttazz9 [4c 3d]
righty01: folds
havea69vette: raises $0.25 to $0.35
tapouttazz9: folds
CavalierZero leaves the table
runbich: raises $0.95 to $1.30
havea69vette: calls $0.95
*** FLOP *** [4h 8c 8d]
runbich: checks
havea69vette: bets $1.26
runbich: raises $1.94 to $3.20
havea69vette: calls $1.94
*** TURN *** [4h 8c 8d] [7c]
runbich: checks
havea69vette: bets $5.54 and is all-in
Ishfaqa1 joins the table at seat #4
runbich: folds
Uncalled bet ($5.54) returned to havea69vette
havea69vette collected $8.60 from pot
havea69vette: doesn't show hand
*** SUMMARY ***
Total pot $9.05 | Rake $0.45
Board [4h 8c 8d 7c]
Seat 1: tapouttazz9 (small blind) folded before Flop
Seat 2: runbich (big blind) folded on the Turn
Seat 5: righty01 folded before Flop (didn't bet)
Seat 6: havea69vette (button) collected ($8.60)


PokerStars Hand #157070595154:  Hold'em No Limit ($0.05/$0.10 USD) - 2016/08/17 18:21:13 ET
Table 'Orion' 6-max Seat #1 is the button
Seat 1: tapouttazz9 ($9.87 in chips)
Seat 2: runbich ($2.90 in chips)
Seat 4: Ishfaqa1 ($10 in chips)
Seat 5: righty01 ($10.14 in chips)
Seat 6: havea69vette ($14.14 in chips)
runbich: posts small blind $0.05
Ishfaqa1: posts big blind $0.10
*** HOLE CARDS ***
Dealt to tapouttazz9 [2c 3d]
righty01: calls $0.10
havea69vette: raises $0.35 to $0.45
tapouttazz9: folds
runbich: folds
Ishfaqa1: raises $1 to $1.45
righty01: folds
havea69vette: folds
Uncalled bet ($1) returned to Ishfaqa1
Ishfaqa1 collected $1.05 from pot
Ishfaqa1: doesn't show hand
*** SUMMARY ***
Total pot $1.05 | Rake $0
Seat 1: tapouttazz9 (button) folded before Flop (didn't bet)
Seat 2: runbich (small blind) folded before Flop
Seat 4: Ishfaqa1 (big blind) collected ($1.05)
Seat 5: righty01 folded before Flop
Seat 6: havea69vette folded before Flop


PokerStars Hand #157070595277:  Hold'em No Limit ($0.05/$0.10 USD) - 2016/08/17 18:21:39 ET
Table 'Orion' 6-max Seat #2 is the button
Seat 1: tapouttazz9 ($9.87 in chips)
Seat 2: runbich ($7.85 in chips)
Seat 4: Ishfaqa1 ($10.60 in chips)
Seat 5: righty01 ($10.04 in chips)
Seat 6: havea69vette ($13.69 in chips)
Ishfaqa1: posts small blind $0.05
righty01: posts big blind $0.10
*** HOLE CARDS ***
Dealt to tapouttazz9 [Jd Jh]
havea69vette: folds
tapouttazz9: raises $0.20 to $0.30
runbich: folds
Ishfaqa1: folds
righty01: calls $0.20
*** FLOP *** [3c 6s 7h]
righty01: checks
tapouttazz9: bets $0.31
righty01: folds
Uncalled bet ($0.31) returned to tapouttazz9
tapouttazz9 collected $0.62 from pot
*** SUMMARY ***
Total pot $0.65 | Rake $0.03
Board [3c 6s 7h]
Seat 1: tapouttazz9 collected ($0.62)
Seat 2: runbich (button) folded before Flop (didn't bet)
Seat 4: Ishfaqa1 (small blind) folded before Flop
Seat 5: righty01 (big blind) folded on the Flop
Seat 6: havea69vette folded before Flop (didn't bet)


PokerStars Hand #157070595476:  Hold'em No Limit ($0.05/$0.10 USD) - 2016/08/17 18:22:17 ET
Table 'Orion' 6-max Seat #4 is the button
Seat 1: tapouttazz9 ($10.19 in chips)
Seat 2: runbich ($7.85 in chips)
Seat 4: Ishfaqa1 ($10.55 in chips)
Seat 5: righty01 ($9.74 in chips)
Seat 6: havea69vette ($13.69 in chips)
righty01: posts small blind $0.05
havea69vette: posts big blind $0.10
*** HOLE CARDS ***
Dealt to tapouttazz9 [3h 8c]
tapouttazz9: folds
runbich: folds
Ishfaqa1: folds
righty01: folds
Uncalled bet ($0.05) returned to havea69vette
havea69vette collected $0.10 from pot
havea69vette: doesn't show hand
*** SUMMARY ***
Total pot $0.10 | Rake $0
Seat 1: tapouttazz9 folded before Flop (didn't bet)
Seat 2: runbich folded before Flop (didn't bet)
Seat 4: Ishfaqa1 (button) folded before Flop (didn't bet)
Seat 5: righty01 (small blind) folded before Flop
Seat 6: havea69vette (big blind) collected ($0.10)


PokerStars Hand #157070595581:  Hold'em No Limit ($0.05/$0.10 USD) - 2016/08/17 18:22:43 ET
Table 'Orion' 6-max Seat #5 is the button
Seat 1: tapouttazz9 ($10.19 in chips)
Seat 2: runbich ($7.85 in chips)
Seat 4: Ishfaqa1 ($10.55 in chips)
Seat 5: righty01 ($9.69 in chips)
Seat 6: havea69vette ($13.74 in chips)
havea69vette: posts small blind $0.05
tapouttazz9: posts big blind $0.10
*** HOLE CARDS ***
Dealt to tapouttazz9 [Kd 9d]
runbich: folds
Ishfaqa1: folds
righty01: folds
havea69vette: folds
Uncalled bet ($0.05) returned to tapouttazz9
tapouttazz9 collected $0.10 from pot
*** SUMMARY ***
Total pot $0.10 | Rake $0
Seat 1: tapouttazz9 (big blind) collected ($0.10)
Seat 2: runbich folded before Flop (didn't bet)
Seat 4: Ishfaqa1 folded before Flop (didn't bet)
Seat 5: righty01 (button) folded before Flop (didn't bet)
Seat 6: havea69vette (small blind) folded before Flop


PokerStars Hand #157070595633:  Hold'em No Limit ($0.05/$0.10 USD) - 2016/08/17 18:22:54 ET
Table 'Orion' 6-max Seat #6 is the button
Seat 1: tapouttazz9 ($10.24 in chips)
Seat 4: Ishfaqa1 ($10.55 in chips)
Seat 5: righty01 ($9.69 in chips)
Seat 6: havea69vette ($13.69 in chips)
tapouttazz9: posts small blind $0.05
runbich: is sitting out
Ishfaqa1: posts big blind $0.10
*** HOLE CARDS ***
Dealt to tapouttazz9 [6s Qd]
righty01: folds
havea69vette: folds
tapouttazz9: folds
Uncalled bet ($0.05) returned to Ishfaqa1
Ishfaqa1 collected $0.10 from pot
Ishfaqa1: doesn't show hand
*** SUMMARY ***
Total pot $0.10 | Rake $0
Seat 1: tapouttazz9 (small blind) folded before Flop
Seat 4: Ishfaqa1 (big blind) collected ($0.10)
Seat 5: righty01 folded before Flop (didn't bet)
Seat 6: havea69vette (button) folded before Flop (didn't bet)


PokerStars Hand #157070595669:  Hold'em No Limit ($0.05/$0.10 USD) - 2016/08/17 18:23:01 ET
Table 'Orion' 6-max Seat #1 is the button
Seat 1: tapouttazz9 ($10.19 in chips)
Seat 4: Ishfaqa1 ($10.60 in chips)
Seat 6: havea69vette ($13.69 in chips)
runbich will be allowed to play after the button
Ishfaqa1: posts small blind $0.05
righty01: is sitting out
havea69vette: posts big blind $0.10
*** HOLE CARDS ***
Dealt to tapouttazz9 [4c 4d]
tapouttazz9: raises $0.20 to $0.30
righty01 leaves the table
Ishfaqa1: folds
havea69vette: calls $0.20
*** FLOP *** [3s 6d Kd]
havea69vette: checks
tapouttazz9: checks
*** TURN *** [3s 6d Kd] [Tc]
havea69vette: bets $0.62
tapouttazz9: calls $0.62
*** RIVER *** [3s 6d Kd Tc] [6c]
havea69vette: bets $0.90
tapouttazz9: calls $0.90
*** SHOW DOWN ***
havea69vette: shows [Qd Kh] (two pair, Kings and Sixes)
tapouttazz9: mucks hand
havea69vette collected $3.51 from pot
*** SUMMARY ***
Total pot $3.69 | Rake $0.18
Board [3s 6d Kd Tc 6c]
Seat 1: tapouttazz9 (button) mucked [4c 4d]
Seat 4: Ishfaqa1 (small blind) folded before Flop
Seat 6: havea69vette (big blind) showed [Qd Kh] and won ($3.51) with two pair, Kings and Sixes


PokerStars Hand #157070595814:  Hold'em No Limit ($0.05/$0.10 USD) - 2016/08/17 18:23:36 ET
Table 'Orion' 6-max Seat #4 is the button
Seat 1: tapouttazz9 ($8.37 in chips)
Seat 4: Ishfaqa1 ($10.55 in chips)
Seat 6: havea69vette ($15.38 in chips)
havea69vette: posts small blind $0.05
tapouttazz9: posts big blind $0.10
runbich: sits out
*** HOLE CARDS ***
Dealt to tapouttazz9 [7s 7h]
Ishfaqa1: folds
havea69vette: folds
Uncalled bet ($0.05) returned to tapouttazz9
tapouttazz9 collected $0.10 from pot
*** SUMMARY ***
Total pot $0.10 | Rake $0
Seat 1: tapouttazz9 (big blind) collected ($0.10)
Seat 4: Ishfaqa1 (button) folded before Flop (didn't bet)
Seat 6: havea69vette (small blind) folded before Flop


PokerStars Hand #157070595846:  Hold'em No Limit ($0.05/$0.10 USD) - 2016/08/17 18:23:43 ET
Table 'Orion' 6-max Seat #6 is the button
Seat 1: tapouttazz9 ($8.42 in chips)
Seat 2: runbich ($7.85 in chips)
Seat 4: Ishfaqa1 ($10.55 in chips)
Seat 6: havea69vette ($15.33 in chips)
tapouttazz9: posts small blind $0.05
runbich: posts big blind $0.10
*** HOLE CARDS ***
Dealt to tapouttazz9 [Jd Ac]
Ishfaqa1: folds
havea69vette: raises $0.25 to $0.35
tapouttazz9: calls $0.30
runbich: folds
*** FLOP *** [Td 9s 3s]
tapouttazz9: checks
havea69vette: checks
*** TURN *** [Td 9s 3s] [6d]
tapouttazz9: checks
havea69vette: checks
*** RIVER *** [Td 9s 3s 6d] [8d]
tapouttazz9: checks
havea69vette: checks
*** SHOW DOWN ***
tapouttazz9: shows [Jd Ac] (high card Ace)
havea69vette: mucks hand
tapouttazz9 collected $0.76 from pot
*** SUMMARY ***
Total pot $0.80 | Rake $0.04
Board [Td 9s 3s 6d 8d]
Seat 1: tapouttazz9 (small blind) showed [Jd Ac] and won ($0.76) with high card Ace
Seat 2: runbich (big blind) folded before Flop
Seat 4: Ishfaqa1 folded before Flop (didn't bet)
Seat 6: havea69vette (button) mucked [5c Ah]


PokerStars Hand #157070595999:  Hold'em No Limit ($0.05/$0.10 USD) - 2016/08/17 18:24:19 ET
Table 'Orion' 6-max Seat #1 is the button
Seat 1: tapouttazz9 ($10 in chips)
Seat 2: runbich ($7.75 in chips)
Seat 4: Ishfaqa1 ($10.55 in chips)
Seat 6: havea69vette ($14.98 in chips)
runbich: posts small blind $0.05
Ishfaqa1: posts big blind $0.10
*** HOLE CARDS ***
Dealt to tapouttazz9 [Kh 3d]
havea69vette: folds
tapouttazz9: folds
runbich: folds
Uncalled bet ($0.05) returned to Ishfaqa1
Ishfaqa1 collected $0.10 from pot
Ishfaqa1: doesn't show hand
*** SUMMARY ***
Total pot $0.10 | Rake $0
Seat 1: tapouttazz9 (button) folded before Flop (didn't bet)
Seat 2: runbich (small blind) folded before Flop
Seat 4: Ishfaqa1 (big blind) collected ($0.10)
Seat 6: havea69vette folded before Flop (didn't bet)


PokerStars Hand #157070596077:  Hold'em No Limit ($0.05/$0.10 USD) - 2016/08/17 18:24:37 ET
Table 'Orion' 6-max Seat #2 is the button
Seat 1: tapouttazz9 ($10 in chips)
Seat 2: runbich ($7.70 in chips)
Seat 4: Ishfaqa1 ($10.60 in chips)
Seat 6: havea69vette ($14.98 in chips)
Ishfaqa1: posts small blind $0.05
havea69vette: posts big blind $0.10
*** HOLE CARDS ***
Dealt to tapouttazz9 [Qc Ks]
tapouttazz9: raises $0.20 to $0.30
runbich: raises $0.60 to $0.90
Ishfaqa1: folds
havea69vette: folds
tapouttazz9: folds
Uncalled bet ($0.60) returned to runbich
runbich collected $0.75 from pot
runbich: doesn't show hand
*** SUMMARY ***
Total pot $0.75 | Rake $0
Seat 1: tapouttazz9 folded before Flop
Seat 2: runbich (button) collected ($0.75)
Seat 4: Ishfaqa1 (small blind) folded before Flop
Seat 6: havea69vette (big blind) folded before Flop


PokerStars Hand #157070596191:  Hold'em No Limit ($0.05/$0.10 USD) - 2016/08/17 18:24:58 ET
Table 'Orion' 6-max Seat #4 is the button
Seat 1: tapouttazz9 ($9.70 in chips)
Seat 2: runbich ($8.15 in chips)
Seat 4: Ishfaqa1 ($10.55 in chips)
Seat 6: havea69vette ($14.88 in chips)
havea69vette: posts small blind $0.05
tapouttazz9: posts big blind $0.10
*** HOLE CARDS ***
Dealt to tapouttazz9 [2c 7s]
runbich: folds
runbich leaves the table
Ishfaqa1: folds
havea69vette: raises $0.20 to $0.30
tapouttazz9: folds
Uncalled bet ($0.20) returned to havea69vette
havea69vette collected $0.20 from pot
havea69vette: doesn't show hand
*** SUMMARY ***
Total pot $0.20 | Rake $0
Seat 1: tapouttazz9 (big blind) folded before Flop
Seat 2: runbich folded before Flop (didn't bet)
Seat 4: Ishfaqa1 (button) folded before Flop (didn't bet)
Seat 6: havea69vette (small blind) collected ($0.20)


PokerStars Hand #157070596231:  Hold'em No Limit ($0.05/$0.10 USD) - 2016/08/17 18:25:09 ET
Table 'Orion' 6-max Seat #6 is the button
Seat 1: tapouttazz9 ($9.60 in chips)
Seat 4: Ishfaqa1 ($10.55 in chips)
Seat 6: havea69vette ($14.98 in chips)
tapouttazz9: posts small blind $0.05
Ishfaqa1: posts big blind $0.10
*** HOLE CARDS ***
Dealt to tapouttazz9 [4h 5s]
havea69vette: raises $0.25 to $0.35
tapouttazz9: folds
Ishfaqa1: folds
Uncalled bet ($0.25) returned to havea69vette
havea69vette collected $0.25 from pot
havea69vette: doesn't show hand
*** SUMMARY ***
Total pot $0.25 | Rake $0
Seat 1: tapouttazz9 (small blind) folded before Flop
Seat 4: Ishfaqa1 (big blind) folded before Flop
Seat 6: havea69vette (button) collected ($0.25)


PokerStars Hand #157070596286:  Hold'em No Limit ($0.05/$0.10 USD) - 2016/08/17 18:25:21 ET
Table 'Orion' 6-max Seat #1 is the button
Seat 1: tapouttazz9 ($9.55 in chips)
Seat 4: Ishfaqa1 ($10.45 in chips)
Seat 6: havea69vette ($15.13 in chips)
Ishfaqa1: posts small blind $0.05
havea69vette: posts big blind $0.10
*** HOLE CARDS ***
Dealt to tapouttazz9 [8h 5d]
tapouttazz9: folds
Ishfaqa1: folds
Uncalled bet ($0.05) returned to havea69vette
havea69vette collected $0.10 from pot
havea69vette: doesn't show hand
*** SUMMARY ***
Total pot $0.10 | Rake $0
Seat 1: tapouttazz9 (button) folded before Flop (didn't bet)
Seat 4: Ishfaqa1 (small blind) folded before Flop
Seat 6: havea69vette (big blind) collected ($0.10)


PokerStars Hand #157070596324:  Hold'em No Limit ($0.05/$0.10 USD) - 2016/08/17 18:25:26 ET
Table 'Orion' 6-max Seat #4 is the button
Seat 1: tapouttazz9 ($9.55 in chips)
Seat 4: Ishfaqa1 ($10.40 in chips)
Seat 6: havea69vette ($15.18 in chips)
havea69vette: posts small blind $0.05
tapouttazz9: posts big blind $0.10
*** HOLE CARDS ***
Dealt to tapouttazz9 [8s 8c]
Ishfaqa1: folds
havea69vette: folds
Uncalled bet ($0.05) returned to tapouttazz9
tapouttazz9 collected $0.10 from pot
*** SUMMARY ***
Total pot $0.10 | Rake $0
Seat 1: tapouttazz9 (big blind) collected ($0.10)
Seat 4: Ishfaqa1 (button) folded before Flop (didn't bet)
Seat 6: havea69vette (small blind) folded before Flop


PokerStars Hand #157070596361:  Hold'em No Limit ($0.05/$0.10 USD) - 2016/08/17 18:25:33 ET
Table 'Orion' 6-max Seat #6 is the button
Seat 1: tapouttazz9 ($9.60 in chips)
Seat 4: Ishfaqa1 ($10.40 in chips)
Seat 6: havea69vette ($15.13 in chips)
tapouttazz9: posts small blind $0.05
Ishfaqa1: posts big blind $0.10
*** HOLE CARDS ***
Dealt to tapouttazz9 [As Jd]
havea69vette: folds
tapouttazz9: raises $0.10 to $0.20
Ishfaqa1: folds
Uncalled bet ($0.10) returned to tapouttazz9
tapouttazz9 collected $0.20 from pot
*** SUMMARY ***
Total pot $0.20 | Rake $0
Seat 1: tapouttazz9 (small blind) collected ($0.20)
Seat 4: Ishfaqa1 (big blind) folded before Flop
Seat 6: havea69vette (button) folded before Flop (didn't bet)


PokerStars Hand #157070596418:  Hold'em No Limit ($0.05/$0.10 USD) - 2016/08/17 18:25:46 ET
Table 'Orion' 6-max Seat #4 is the button
Seat 1: tapouttazz9 ($9.70 in chips)
Seat 4: Ishfaqa1 ($10.30 in chips)
Ishfaqa1: posts small blind $0.05
tapouttazz9: posts big blind $0.10
*** HOLE CARDS ***
Dealt to tapouttazz9 [Tc Kh]
Ishfaqa1: raises $0.15 to $0.25
tapouttazz9: calls $0.15
*** FLOP *** [Ks 4h 7s]
tapouttazz9: checks
Ishfaqa1: bets $0.25
PureLuck 4ok joins the table at seat #3
tapouttazz9: calls $0.25
*** TURN *** [Ks 4h 7s] [7c]
tapouttazz9: checks
Ishfaqa1: bets $0.65
tapouttazz9: calls $0.65
*** RIVER *** [Ks 4h 7s 7c] [Jd]
tapouttazz9: bets $1.09
Ishfaqa1: folds
Uncalled bet ($1.09) returned to tapouttazz9
tapouttazz9 collected $2.18 from pot
bobbychaz28 joins the table at seat #5
*** SUMMARY ***
Total pot $2.30 | Rake $0.12
Board [Ks 4h 7s 7c Jd]
Seat 1: tapouttazz9 (big blind) collected ($2.18)
Seat 4: Ishfaqa1 (button) (small blind) folded on the River


PokerStars Hand #157070596589:  Hold'em No Limit ($0.05/$0.10 USD) - 2016/08/17 18:26:21 ET
Table 'Orion' 6-max Seat #4 is the button
Seat 1: tapouttazz9 ($10.73 in chips)
Seat 3: PureLuck 4ok ($10 in chips)
Seat 4: Ishfaqa1 ($10 in chips)
bobbychaz28 will be allowed to play after the button
tapouttazz9: posts small blind $0.05
PureLuck 4ok: posts big blind $0.10
*** HOLE CARDS ***
Dealt to tapouttazz9 [Kc 6s]
Ishfaqa1: raises $0.15 to $0.25
tapouttazz9: folds
PureLuck 4ok: folds
Uncalled bet ($0.15) returned to Ishfaqa1
Ishfaqa1 collected $0.25 from pot
Ishfaqa1: doesn't show hand
*** SUMMARY ***
Total pot $0.25 | Rake $0
Seat 1: tapouttazz9 (small blind) folded before Flop
Seat 3: PureLuck 4ok (big blind) folded before Flop
Seat 4: Ishfaqa1 (button) collected ($0.25)


PokerStars Hand #157070596671:  Hold'em No Limit ($0.05/$0.10 USD) - 2016/08/17 18:26:36 ET
Table 'Orion' 6-max Seat #1 is the button
Seat 1: tapouttazz9 ($10.68 in chips)
Seat 3: PureLuck 4ok ($9.90 in chips)
Seat 4: Ishfaqa1 ($10.15 in chips)
Seat 5: bobbychaz28 ($5 in chips)
PureLuck 4ok: posts small blind $0.05
Ishfaqa1: posts big blind $0.10
bobbychaz28: posts big blind $0.10
*** HOLE CARDS ***
Dealt to tapouttazz9 [Qd 9s]
bobbychaz28: checks
tapouttazz9: raises $0.20 to $0.30
dime856 joins the table at seat #2
PureLuck 4ok: folds
Ishfaqa1: folds
bobbychaz28: calls $0.20
*** FLOP *** [Ah 9d 3d]
bobbychaz28: checks
tapouttazz9: bets $0.35
bobbychaz28: folds
Uncalled bet ($0.35) returned to tapouttazz9
tapouttazz9 collected $0.71 from pot
*** SUMMARY ***
Total pot $0.75 | Rake $0.04
Board [Ah 9d 3d]
Seat 1: tapouttazz9 (button) collected ($0.71)
Seat 3: PureLuck 4ok (small blind) folded before Flop
Seat 4: Ishfaqa1 (big blind) folded before Flop
Seat 5: bobbychaz28 folded on the Flop


PokerStars Hand #157070596750:  Hold'em No Limit ($0.05/$0.10 USD) - 2016/08/17 18:26:54 ET
Table 'Orion' 6-max Seat #3 is the button
Seat 1: tapouttazz9 ($11.09 in chips)
Seat 3: PureLuck 4ok ($9.85 in chips)
Seat 4: Ishfaqa1 ($10.05 in chips)
Seat 5: bobbychaz28 ($4.70 in chips)
Ishfaqa1: posts small blind $0.05
bobbychaz28: posts big blind $0.10
dime856: sits out
*** HOLE CARDS ***
Dealt to tapouttazz9 [5s Qh]
tapouttazz9: folds
PureLuck 4ok: calls $0.10
Ishfaqa1: raises $0.30 to $0.40
bobbychaz28: calls $0.30
PureLuck 4ok: calls $0.30
*** FLOP *** [9h 7s 4s]
Ishfaqa1: bets $0.70
bobbychaz28: calls $0.70
PureLuck 4ok: calls $0.70
*** TURN *** [9h 7s 4s] [4h]
Ishfaqa1: bets $2.10
bobbychaz28: raises $1.50 to $3.60 and is all-in
PureLuck 4ok: calls $3.60
Ishfaqa1: calls $1.50
*** RIVER *** [9h 7s 4s 4h] [7h]
Ishfaqa1: bets $5.35 and is all-in
PureLuck 4ok: folds
Uncalled bet ($5.35) returned to Ishfaqa1
*** SHOW DOWN ***
Ishfaqa1: shows [Td Ts] (two pair, Tens and Sevens)
bobbychaz28: shows [4c 8c] (a full house, Fours full of Sevens)
bobbychaz28 collected $13.40 from pot
*** SUMMARY ***
Total pot $14.10 | Rake $0.70
Board [9h 7s 4s 4h 7h]
Seat 1: tapouttazz9 folded before Flop (didn't bet)
Seat 3: PureLuck 4ok (button) folded on the River
Seat 4: Ishfaqa1 (small blind) showed [Td Ts] and lost with two pair, Tens and Sevens
Seat 5: bobbychaz28 (big blind) showed [4c 8c] and won ($13.40) with a full house, Fours full of Sevens


PokerStars Hand #157070597096:  Hold'em No Limit ($0.05/$0.10 USD) - 2016/08/17 18:28:07 ET
Table 'Orion' 6-max Seat #4 is the button
Seat 1: tapouttazz9 ($11.09 in chips)
Seat 2: dime856 ($10 in chips)
Seat 3: PureLuck 4ok ($5.15 in chips)
Seat 4: Ishfaqa1 ($10 in chips)
Seat 5: bobbychaz28 ($13.40 in chips)
bobbychaz28: posts small blind $0.05
tapouttazz9: posts big blind $0.10
dime856: posts big blind $0.10
*** HOLE CARDS ***
Dealt to tapouttazz9 [8d Ks]
dime856: checks
PureLuck 4ok: folds
Ishfaqa1: folds
bobbychaz28: calls $0.05
tapouttazz9: checks
*** FLOP *** [Js 3d 3s]
bobbychaz28: checks
tapouttazz9: checks
dime856: checks
*** TURN *** [Js 3d 3s] [5d]
bobbychaz28: checks
tapouttazz9: checks
dime856: checks
*** RIVER *** [Js 3d 3s 5d] [5h]
bobbychaz28: bets $0.10
tapouttazz9: folds
dime856: folds
Uncalled bet ($0.10) returned to bobbychaz28
bobbychaz28 collected $0.28 from pot
bobbychaz28: doesn't show hand
*** SUMMARY ***
Total pot $0.30 | Rake $0.02
Board [Js 3d 3s 5d 5h]
Seat 1: tapouttazz9 (big blind) folded on the River
Seat 2: dime856 folded on the River
Seat 3: PureLuck 4ok folded before Flop (didn't bet)
Seat 4: Ishfaqa1 (button) folded before Flop (didn't bet)
Seat 5: bobbychaz28 (small blind) collected ($0.28)


PokerStars Hand #157070597258:  Hold'em No Limit ($0.05/$0.10 USD) - 2016/08/17 18:28:41 ET
Table 'Orion' 6-max Seat #5 is the button
Seat 1: tapouttazz9 ($10.99 in chips)
Seat 2: dime856 ($9.90 in chips)
Seat 3: PureLuck 4ok ($5.15 in chips)
Seat 4: Ishfaqa1 ($10 in chips)
Seat 5: bobbychaz28 ($13.58 in chips)
tapouttazz9: posts small blind $0.05
dime856: posts big blind $0.10
*** HOLE CARDS ***
Dealt to tapouttazz9 [Jd 6d]
PureLuck 4ok: folds
Ishfaqa1: folds
bobbychaz28: calls $0.10
tapouttazz9: folds
dime856: raises $0.20 to $0.30
bobbychaz28: calls $0.20
*** FLOP *** [8s Qs 3s]
dime856: bets $0.31
bobbychaz28: folds
Uncalled bet ($0.31) returned to dime856
dime856 collected $0.62 from pot
dime856: doesn't show hand
*** SUMMARY ***
Total pot $0.65 | Rake $0.03
Board [8s Qs 3s]
Seat 1: tapouttazz9 (small blind) folded before Flop
Seat 2: dime856 (big blind) collected ($0.62)
Seat 3: PureLuck 4ok folded before Flop (didn't bet)
Seat 4: Ishfaqa1 folded before Flop (didn't bet)
Seat 5: bobbychaz28 (button) folded on the Flop


PokerStars Hand #157070597368:  Hold'em No Limit ($0.05/$0.10 USD) - 2016/08/17 18:29:04 ET
Table 'Orion' 6-max Seat #1 is the button
Seat 1: tapouttazz9 ($10.94 in chips)
Seat 2: dime856 ($10.22 in chips)
Seat 3: PureLuck 4ok ($5.15 in chips)
Seat 4: Ishfaqa1 ($10 in chips)
Seat 5: bobbychaz28 ($13.28 in chips)
dime856: posts small blind $0.05
PureLuck 4ok: posts big blind $0.10
*** HOLE CARDS ***
Dealt to tapouttazz9 [7d 3c]
Ishfaqa1: folds
bobbychaz28: raises $0.10 to $0.20
tapouttazz9: folds
dime856: folds
PureLuck 4ok: calls $0.10
*** FLOP *** [6c Ad 8c]
PureLuck 4ok: checks
bobbychaz28: bets $0.40
PureLuck 4ok: folds
Uncalled bet ($0.40) returned to bobbychaz28
bobbychaz28 collected $0.43 from pot
bobbychaz28: doesn't show hand
*** SUMMARY ***
Total pot $0.45 | Rake $0.02
Board [6c Ad 8c]
Seat 1: tapouttazz9 (button) folded before Flop (didn't bet)
Seat 2: dime856 (small blind) folded before Flop
Seat 3: PureLuck 4ok (big blind) folded on the Flop
Seat 4: Ishfaqa1 folded before Flop (didn't bet)
Seat 5: bobbychaz28 collected ($0.43)


PokerStars Hand #157070597551:  Hold'em No Limit ($0.05/$0.10 USD) - 2016/08/17 18:29:44 ET
Table 'Orion' 6-max Seat #2 is the button
Seat 1: tapouttazz9 ($10.94 in chips)
Seat 2: dime856 ($10.17 in chips)
Seat 3: PureLuck 4ok ($4.95 in chips)
Seat 4: Ishfaqa1 ($10 in chips)
Seat 5: bobbychaz28 ($13.51 in chips)
PureLuck 4ok: posts small blind $0.05
Ishfaqa1: posts big blind $0.10
*** HOLE CARDS ***
Dealt to tapouttazz9 [Ac 6d]
bobbychaz28: folds
tapouttazz9: folds
dime856: raises $0.20 to $0.30
PureLuck 4ok: folds
Ishfaqa1: folds
Uncalled bet ($0.20) returned to dime856
dime856 collected $0.25 from pot
dime856: doesn't show hand
*** SUMMARY ***
Total pot $0.25 | Rake $0
Seat 1: tapouttazz9 folded before Flop (didn't bet)
Seat 2: dime856 (button) collected ($0.25)
Seat 3: PureLuck 4ok (small blind) folded before Flop
Seat 4: Ishfaqa1 (big blind) folded before Flop
Seat 5: bobbychaz28 folded before Flop (didn't bet)


PokerStars Hand #157070597616:  Hold'em No Limit ($0.05/$0.10 USD) - 2016/08/17 18:29:58 ET
Table 'Orion' 6-max Seat #3 is the button
Seat 1: tapouttazz9 ($10.94 in chips)
Seat 2: dime856 ($10.32 in chips)
Seat 3: PureLuck 4ok ($4.90 in chips)
Seat 4: Ishfaqa1 ($10 in chips)
Seat 5: bobbychaz28 ($13.51 in chips)
Ishfaqa1: posts small blind $0.05
bobbychaz28: posts big blind $0.10
*** HOLE CARDS ***
Dealt to tapouttazz9 [6c Ks]
tapouttazz9: folds
dime856: folds
PureLuck 4ok: folds
Ishfaqa1: folds
Uncalled bet ($0.05) returned to bobbychaz28
bobbychaz28 collected $0.10 from pot
bobbychaz28: doesn't show hand
*** SUMMARY ***
Total pot $0.10 | Rake $0
Seat 1: tapouttazz9 folded before Flop (didn't bet)
Seat 2: dime856 folded before Flop (didn't bet)
Seat 3: PureLuck 4ok (button) folded before Flop (didn't bet)
Seat 4: Ishfaqa1 (small blind) folded before Flop
Seat 5: bobbychaz28 (big blind) collected ($0.10)


PokerStars Hand #157070597653:  Hold'em No Limit ($0.05/$0.10 USD) - 2016/08/17 18:30:04 ET
Table 'Orion' 6-max Seat #4 is the button
Seat 1: tapouttazz9 ($10.94 in chips)
Seat 2: dime856 ($10.32 in chips)
Seat 3: PureLuck 4ok ($4.90 in chips)
Seat 4: Ishfaqa1 ($10 in chips)
Seat 5: bobbychaz28 ($13.56 in chips)
bobbychaz28: posts small blind $0.05
tapouttazz9: posts big blind $0.10
*** HOLE CARDS ***
Dealt to tapouttazz9 [6c Td]
dime856: folds
PureLuck 4ok: calls $0.10
Ishfaqa1: folds
bobbychaz28: raises $0.10 to $0.20
tapouttazz9: folds
PureLuck 4ok: calls $0.10
*** FLOP *** [4h Kh 2s]
bobbychaz28: checks
PureLuck 4ok: checks
*** TURN *** [4h Kh 2s] [9s]
bobbychaz28: bets $0.20
PureLuck 4ok: calls $0.20
*** RIVER *** [4h Kh 2s 9s] [Qh]
Ishfaqa1 leaves the table
bobbychaz28: bets $0.60
PureLuck 4ok: calls $0.60
*** SHOW DOWN ***
bobbychaz28: shows [Tc 7d] (high card King)
PureLuck 4ok: shows [Ts Qs] (a pair of Queens)
PureLuck 4ok collected $2 from pot
*** SUMMARY ***
Total pot $2.10 | Rake $0.10
Board [4h Kh 2s 9s Qh]
Seat 1: tapouttazz9 (big blind) folded before Flop
Seat 2: dime856 folded before Flop (didn't bet)
Seat 3: PureLuck 4ok showed [Ts Qs] and won ($2) with a pair of Queens
Seat 4: Ishfaqa1 (button) folded before Flop (didn't bet)
Seat 5: bobbychaz28 (small blind) showed [Tc 7d] and lost with high card King


PokerStars Hand #157070597914:  Hold'em No Limit ($0.05/$0.10 USD) - 2016/08/17 18:31:01 ET
Table 'Orion' 6-max Seat #1 is the button
Seat 1: tapouttazz9 ($10.84 in chips)
Seat 2: dime856 ($10.32 in chips)
Seat 3: PureLuck 4ok ($5.90 in chips)
dime856: posts small blind $0.05
PureLuck 4ok: posts big blind $0.10
*** HOLE CARDS ***
Dealt to tapouttazz9 [8d Jd]
tapouttazz9: folds
dime856: calls $0.05
PureLuck 4ok: checks
*** FLOP *** [6s Ts Tc]
dime856: checks
PureLuck 4ok: checks
*** TURN *** [6s Ts Tc] [Kc]
dime856: checks
PureLuck 4ok: checks
*** RIVER *** [6s Ts Tc Kc] [Ac]
dime856: checks
PureLuck 4ok: checks
*** SHOW DOWN ***
dime856: shows [Qh 4d] (a pair of Tens)
PureLuck 4ok: mucks hand
dime856 collected $0.19 from pot
*** SUMMARY ***
Total pot $0.20 | Rake $0.01
Board [6s Ts Tc Kc Ac]
Seat 1: tapouttazz9 (button) folded before Flop (didn't bet)
Seat 2: dime856 (small blind) showed [Qh 4d] and won ($0.19) with a pair of Tens
Seat 3: PureLuck 4ok (big blind) mucked [4s 2d]


PokerStars Hand #157070598063:  Hold'em No Limit ($0.05/$0.10 USD) - 2016/08/17 18:31:30 ET
Table 'Orion' 6-max Seat #2 is the button
Seat 1: tapouttazz9 ($10.84 in chips)
Seat 2: dime856 ($10.41 in chips)
Seat 3: PureLuck 4ok ($5.80 in chips)
PureLuck 4ok: posts small blind $0.05
tapouttazz9: posts big blind $0.10
*** HOLE CARDS ***
Dealt to tapouttazz9 [2c Jd]
dime856: folds
PureLuck 4ok: folds
Uncalled bet ($0.05) returned to tapouttazz9
tapouttazz9 collected $0.10 from pot
*** SUMMARY ***
Total pot $0.10 | Rake $0
Seat 1: tapouttazz9 (big blind) collected ($0.10)
Seat 2: dime856 (button) folded before Flop (didn't bet)
Seat 3: PureLuck 4ok (small blind) folded before Flop


PokerStars Hand #157070598116:  Hold'em No Limit ($0.05/$0.10 USD) - 2016/08/17 18:31:40 ET
Table 'Orion' 6-max Seat #3 is the button
Seat 1: tapouttazz9 ($10.89 in chips)
Seat 2: dime856 ($10.41 in chips)
Seat 3: PureLuck 4ok ($5.75 in chips)
tapouttazz9: posts small blind $0.05
dime856: posts big blind $0.10
*** HOLE CARDS ***
Dealt to tapouttazz9 [7s 6d]
PureLuck 4ok: calls $0.10
tapouttazz9: folds
dime856: raises $0.20 to $0.30
PureLuck 4ok: calls $0.20
*** FLOP *** [9h 6c 9c]
dime856: bets $0.31
PureLuck 4ok: folds
Uncalled bet ($0.31) returned to dime856
lacilobaid joins the table at seat #4
dime856 collected $0.62 from pot
dime856: doesn't show hand
*** SUMMARY ***
Total pot $0.65 | Rake $0.03
Board [9h 6c 9c]
Seat 1: tapouttazz9 (small blind) folded before Flop
Seat 2: dime856 (big blind) collected ($0.62)
Seat 3: PureLuck 4ok (button) folded on the Flop


PokerStars Hand #157070598240:  Hold'em No Limit ($0.05/$0.10 USD) - 2016/08/17 18:32:05 ET
Table 'Orion' 6-max Seat #1 is the button
Seat 1: tapouttazz9 ($10.84 in chips)
Seat 2: dime856 ($10.73 in chips)
Seat 3: PureLuck 4ok ($5.45 in chips)
dime856: posts small blind $0.05
PureLuck 4ok: posts big blind $0.10
lacilobaid: sits out
*** HOLE CARDS ***
Dealt to tapouttazz9 [Jd Qd]
tapouttazz9: raises $0.20 to $0.30
dime856: folds
PureLuck 4ok: folds
Uncalled bet ($0.20) returned to tapouttazz9
tapouttazz9 collected $0.25 from pot
*** SUMMARY ***
Total pot $0.25 | Rake $0
Seat 1: tapouttazz9 (button) collected ($0.25)
Seat 2: dime856 (small blind) folded before Flop
Seat 3: PureLuck 4ok (big blind) folded before Flop


PokerStars Hand #157070598299:  Hold'em No Limit ($0.05/$0.10 USD) - 2016/08/17 18:32:16 ET
Table 'Orion' 6-max Seat #2 is the button
Seat 1: tapouttazz9 ($10.99 in chips)
Seat 2: dime856 ($10.68 in chips)
Seat 3: PureLuck 4ok ($5.35 in chips)
Seat 4: lacilobaid ($10 in chips)
PureLuck 4ok: posts small blind $0.05
lacilobaid: posts big blind $0.10
*** HOLE CARDS ***
Dealt to tapouttazz9 [Ac Ah]
tapouttazz9: raises $0.20 to $0.30
dime856: folds
PureLuck 4ok: folds
lacilobaid: folds
Uncalled bet ($0.20) returned to tapouttazz9
tapouttazz9 collected $0.25 from pot
*** SUMMARY ***
Total pot $0.25 | Rake $0
Seat 1: tapouttazz9 collected ($0.25)
Seat 2: dime856 (button) folded before Flop (didn't bet)
Seat 3: PureLuck 4ok (small blind) folded before Flop
Seat 4: lacilobaid (big blind) folded before Flop


PokerStars Hand #157070598358:  Hold'em No Limit ($0.05/$0.10 USD) - 2016/08/17 18:32:27 ET
Table 'Orion' 6-max Seat #3 is the button
Seat 1: tapouttazz9 ($11.14 in chips)
Seat 2: dime856 ($10.68 in chips)
Seat 3: PureLuck 4ok ($5.30 in chips)
Seat 4: lacilobaid ($9.90 in chips)
lacilobaid: posts small blind $0.05
tapouttazz9: posts big blind $0.10
*** HOLE CARDS ***
Dealt to tapouttazz9 [9h Ts]
dime856: folds
PureLuck 4ok: calls $0.10
lacilobaid: folds
tapouttazz9: checks
*** FLOP *** [7s 7d Jd]
tapouttazz9: checks
PureLuck 4ok: bets $0.24
tapouttazz9: calls $0.24
*** TURN *** [7s 7d Jd] [4c]
tapouttazz9: checks
PureLuck 4ok: bets $0.69
tapouttazz9: folds
Uncalled bet ($0.69) returned to PureLuck 4ok
PureLuck 4ok collected $0.69 from pot
PureLuck 4ok: doesn't show hand
*** SUMMARY ***
Total pot $0.73 | Rake $0.04
Board [7s 7d Jd 4c]
Seat 1: tapouttazz9 (big blind) folded on the Turn
Seat 2: dime856 folded before Flop (didn't bet)
Seat 3: PureLuck 4ok (button) collected ($0.69)
Seat 4: lacilobaid (small blind) folded before Flop


PokerStars Hand #157070598580:  Hold'em No Limit ($0.05/$0.10 USD) - 2016/08/17 18:33:11 ET
Table 'Orion' 6-max Seat #4 is the button
Seat 1: tapouttazz9 ($10.80 in chips)
Seat 2: dime856 ($10.68 in chips)
Seat 3: PureLuck 4ok ($5.65 in chips)
Seat 4: lacilobaid ($9.85 in chips)
tapouttazz9: posts small blind $0.05
dime856: posts big blind $0.10
*** HOLE CARDS ***
Dealt to tapouttazz9 [5c 2s]
PureLuck 4ok: folds
lacilobaid: folds
tapouttazz9: folds
Uncalled bet ($0.05) returned to dime856
dime856 collected $0.10 from pot
dime856: doesn't show hand
*** SUMMARY ***
Total pot $0.10 | Rake $0
Seat 1: tapouttazz9 (small blind) folded before Flop
Seat 2: dime856 (big blind) collected ($0.10)
Seat 3: PureLuck 4ok folded before Flop (didn't bet)
Seat 4: lacilobaid (button) folded before Flop (didn't bet)


PokerStars Hand #157070598625:  Hold'em No Limit ($0.05/$0.10 USD) - 2016/08/17 18:33:20 ET
Table 'Orion' 6-max Seat #1 is the button
Seat 1: tapouttazz9 ($10.75 in chips)
Seat 2: dime856 ($10.73 in chips)
Seat 3: PureLuck 4ok ($5.65 in chips)
Seat 4: lacilobaid ($9.85 in chips)
dime856: posts small blind $0.05
PureLuck 4ok: posts big blind $0.10
*** HOLE CARDS ***
Dealt to tapouttazz9 [9s Js]
lacilobaid: folds
tapouttazz9: raises $0.10 to $0.20
dime856: folds
PureLuck 4ok: calls $0.10
*** FLOP *** [3s 4d 9h]
PureLuck 4ok: checks
tapouttazz9: checks
*** TURN *** [3s 4d 9h] [As]
bobbychaz28 is disconnected
PureLuck 4ok: checks
tapouttazz9: checks
*** RIVER *** [3s 4d 9h As] [5s]
PureLuck 4ok: bets $0.50
tapouttazz9: calls $0.50
*** SHOW DOWN ***
PureLuck 4ok: shows [9c 9d] (three of a kind, Nines)
tapouttazz9: shows [9s Js] (a flush, Ace high)
tapouttazz9 collected $1.38 from pot
*** SUMMARY ***
Total pot $1.45 | Rake $0.07
Board [3s 4d 9h As 5s]
Seat 1: tapouttazz9 (button) showed [9s Js] and won ($1.38) with a flush, Ace high
Seat 2: dime856 (small blind) folded before Flop
Seat 3: PureLuck 4ok (big blind) showed [9c 9d] and lost with three of a kind, Nines
Seat 4: lacilobaid folded before Flop (didn't bet)


PokerStars Hand #157070598852:  Hold'em No Limit ($0.05/$0.10 USD) - 2016/08/17 18:34:04 ET
Table 'Orion' 6-max Seat #2 is the button
Seat 1: tapouttazz9 ($11.43 in chips)
Seat 2: dime856 ($10.68 in chips)
Seat 3: PureLuck 4ok ($4.95 in chips)
PureLuck 4ok: posts small blind $0.05
tapouttazz9: posts big blind $0.10
*** HOLE CARDS ***
Dealt to tapouttazz9 [Ac Ah]
dime856: folds
PureLuck 4ok: folds
Uncalled bet ($0.05) returned to tapouttazz9
tapouttazz9 collected $0.10 from pot
*** SUMMARY ***
Total pot $0.10 | Rake $0
Seat 1: tapouttazz9 (big blind) collected ($0.10)
Seat 2: dime856 (button) folded before Flop (didn't bet)
Seat 3: PureLuck 4ok (small blind) folded before Flop


PokerStars Hand #157070598879:  Hold'em No Limit ($0.05/$0.10 USD) - 2016/08/17 18:34:11 ET
Table 'Orion' 6-max Seat #3 is the button
Seat 1: tapouttazz9 ($11.48 in chips)
Seat 2: dime856 ($10.68 in chips)
Seat 3: PureLuck 4ok ($4.90 in chips)
tapouttazz9: posts small blind $0.05
dime856: posts big blind $0.10
*** HOLE CARDS ***
Dealt to tapouttazz9 [Kc Ah]
PureLuck 4ok: folds
tapouttazz9: raises $0.20 to $0.30
dime856: calls $0.20
*** FLOP *** [Jd 9d Kh]
tapouttazz9: bets $0.28
dime856: calls $0.28
*** TURN *** [Jd 9d Kh] [7d]
tapouttazz9: bets $0.55
dime856: folds
Uncalled bet ($0.55) returned to tapouttazz9
tapouttazz9 collected $1.10 from pot
*** SUMMARY ***
Total pot $1.16 | Rake $0.06
Board [Jd 9d Kh 7d]
Seat 1: tapouttazz9 (small blind) collected ($1.10)
Seat 2: dime856 (big blind) folded on the Turn
Seat 3: PureLuck 4ok (button) folded before Flop (didn't bet)


PokerStars Hand #157131534578:  Hold'em No Limit ($0.05/$0.10 USD) - 2016/08/19 15:51:31 ET
Table 'Xanthippe' 6-max Seat #5 is the button
Seat 1: pf226 ($8 in chips)
Seat 3: TeamGolden44 ($18.74 in chips)
Seat 5: Jcuervo3825 ($7.85 in chips)
Seat 6: @japhypoker ($21.74 in chips)
@japhypoker: posts small blind $0.05
pf226: posts big blind $0.10
tapouttazz9: sits out
pokerfreak77: sits out
*** HOLE CARDS ***
TeamGolden44: raises $0.20 to $0.30
Jcuervo3825: folds
@japhypoker: raises $0.60 to $0.90
pf226: folds
TeamGolden44: calls $0.60
*** FLOP *** [2d Th 8d]
@japhypoker: bets $0.90
TeamGolden44: folds
Uncalled bet ($0.90) returned to @japhypoker
@japhypoker collected $1.80 from pot
*** SUMMARY ***
Total pot $1.90 | Rake $0.10
Board [2d Th 8d]
Seat 1: pf226 (big blind) folded before Flop
Seat 3: TeamGolden44 folded on the Flop
Seat 5: Jcuervo3825 (button) folded before Flop (didn't bet)
Seat 6: @japhypoker (small blind) collected ($1.80)


PokerStars Hand #157131534710:  Hold'em No Limit ($0.05/$0.10 USD) - 2016/08/19 15:52:03 ET
Table 'Xanthippe' 6-max Seat #6 is the button
Seat 1: pf226 ($7.90 in chips)
Seat 2: tapouttazz9 ($10 in chips)
Seat 3: TeamGolden44 ($17.84 in chips)
Seat 5: Jcuervo3825 ($7.85 in chips)
Seat 6: @japhypoker ($22.64 in chips)
pf226: posts small blind $0.05
tapouttazz9: posts big blind $0.10
pokerfreak77: sits out
*** HOLE CARDS ***
Dealt to tapouttazz9 [Th Qd]
TeamGolden44: folds
@japhypoker said, "why did he just gift you that $9 or whatever..."
Jcuervo3825 has timed out
Jcuervo3825: folds
@japhypoker: folds
pf226: folds
Uncalled bet ($0.05) returned to tapouttazz9
tapouttazz9 collected $0.10 from pot
*** SUMMARY ***
Total pot $0.10 | Rake $0
Seat 1: pf226 (small blind) folded before Flop
Seat 2: tapouttazz9 (big blind) collected ($0.10)
Seat 3: TeamGolden44 folded before Flop (didn't bet)
Seat 5: Jcuervo3825 folded before Flop (didn't bet)
Seat 6: @japhypoker (button) folded before Flop (didn't bet)


PokerStars Hand #157131534851:  Hold'em No Limit ($0.05/$0.10 USD) - 2016/08/19 15:52:40 ET
Table 'Xanthippe' 6-max Seat #1 is the button
Seat 1: pf226 ($7.85 in chips)
Seat 2: tapouttazz9 ($10.05 in chips)
Seat 3: TeamGolden44 ($17.84 in chips)
Seat 5: Jcuervo3825 ($7.85 in chips)
Seat 6: @japhypoker ($22.64 in chips)
tapouttazz9: posts small blind $0.05
TeamGolden44: posts big blind $0.10
pokerfreak77: sits out
*** HOLE CARDS ***
Dealt to tapouttazz9 [6c 6d]
Jcuervo3825: folds
@japhypoker: folds
pf226: raises $0.20 to $0.30
tapouttazz9: calls $0.25
TeamGolden44: folds
*** FLOP *** [Jh 9s Ah]
tapouttazz9: checks
pf226: bets $0.45
tapouttazz9: calls $0.45
*** TURN *** [Jh 9s Ah] [9d]
tapouttazz9: checks
pf226: checks
*** RIVER *** [Jh 9s Ah 9d] [8s]
tapouttazz9: bets $0.76
pf226: calls $0.76
*** SHOW DOWN ***
tapouttazz9: shows [6c 6d] (two pair, Nines and Sixes)
pf226: shows [Ac Td] (two pair, Aces and Nines)
pf226 collected $2.96 from pot
*** SUMMARY ***
Total pot $3.12 | Rake $0.16
Board [Jh 9s Ah 9d 8s]
Seat 1: pf226 (button) showed [Ac Td] and won ($2.96) with two pair, Aces and Nines
Seat 2: tapouttazz9 (small blind) showed [6c 6d] and lost with two pair, Nines and Sixes
Seat 3: TeamGolden44 (big blind) folded before Flop
Seat 5: Jcuervo3825 folded before Flop (didn't bet)
Seat 6: @japhypoker folded before Flop (didn't bet)


PokerStars Hand #157131535034:  Hold'em No Limit ($0.05/$0.10 USD) - 2016/08/19 15:53:28 ET
Table 'Xanthippe' 6-max Seat #2 is the button
Seat 1: pf226 ($9.30 in chips)
Seat 2: tapouttazz9 ($8.54 in chips)
Seat 3: TeamGolden44 ($17.74 in chips)
Seat 4: pokerfreak77 ($10 in chips)
Seat 5: Jcuervo3825 ($7.85 in chips)
Seat 6: @japhypoker ($22.64 in chips)
TeamGolden44: posts small blind $0.05
pokerfreak77: posts big blind $0.10
*** HOLE CARDS ***
Dealt to tapouttazz9 [6d Qd]
Jcuervo3825: folds
@japhypoker: folds
pf226: folds
tapouttazz9: folds
TeamGolden44: raises $0.20 to $0.30
pokerfreak77: raises $0.60 to $0.90
TeamGolden44: calls $0.60
*** FLOP *** [5d Kd Ks]
TeamGolden44: checks
pokerfreak77: bets $0.80
TeamGolden44: raises $3.31 to $4.11
pokerfreak77: raises $4.99 to $9.10 and is all-in
TeamGolden44: calls $4.99
*** TURN *** [5d Kd Ks] [Ad]
*** RIVER *** [5d Kd Ks Ad] [4c]
*** SHOW DOWN ***
TeamGolden44: shows [4s 5s] (two pair, Kings and Fives)
pokerfreak77: shows [Qh Kc] (three of a kind, Kings)
pokerfreak77 collected $19 from pot
*** SUMMARY ***
Total pot $20 | Rake $1
Board [5d Kd Ks Ad 4c]
Seat 1: pf226 folded before Flop (didn't bet)
Seat 2: tapouttazz9 (button) folded before Flop (didn't bet)
Seat 3: TeamGolden44 (small blind) showed [4s 5s] and lost with two pair, Kings and Fives
Seat 4: pokerfreak77 (big blind) showed [Qh Kc] and won ($19) with three of a kind, Kings
Seat 5: Jcuervo3825 folded before Flop (didn't bet)
Seat 6: @japhypoker folded before Flop (didn't bet)


PokerStars Hand #157131535238:  Hold'em No Limit ($0.05/$0.10 USD) - 2016/08/19 15:54:18 ET
Table 'Xanthippe' 6-max Seat #3 is the button
Seat 1: pf226 ($9.30 in chips)
Seat 2: tapouttazz9 ($10 in chips)
Seat 3: TeamGolden44 ($7.74 in chips)
Seat 4: pokerfreak77 ($19 in chips)
Seat 5: Jcuervo3825 ($7.85 in chips)
Seat 6: @japhypoker ($22.64 in chips)
pokerfreak77: posts small blind $0.05
Jcuervo3825: posts big blind $0.10
*** HOLE CARDS ***
Dealt to tapouttazz9 [Qs 2c]
@japhypoker said, "???"
@japhypoker: folds
pf226: raises $0.20 to $0.30
tapouttazz9: folds
TeamGolden44: raises $0.75 to $1.05
pokerfreak77: folds
Jcuervo3825: folds
pf226: raises $1.35 to $2.40
TeamGolden44: raises $5.34 to $7.74 and is all-in
pf226: calls $5.34
*** FLOP *** [7c 6h Kc]
*** TURN *** [7c 6h Kc] [2s]
*** RIVER *** [7c 6h Kc 2s] [Ac]
*** SHOW DOWN ***
pf226: shows [Kd Ks] (three of a kind, Kings)
TeamGolden44: mucks hand
pf226 collected $14.85 from pot
*** SUMMARY ***
Total pot $15.63 | Rake $0.78
Board [7c 6h Kc 2s Ac]
Seat 1: pf226 showed [Kd Ks] and won ($14.85) with three of a kind, Kings
Seat 2: tapouttazz9 folded before Flop (didn't bet)
Seat 3: TeamGolden44 (button) mucked [Kh As]
Seat 4: pokerfreak77 (small blind) folded before Flop
Seat 5: Jcuervo3825 (big blind) folded before Flop
Seat 6: @japhypoker folded before Flop (didn't bet)


PokerStars Hand #157131535459:  Hold'em No Limit ($0.05/$0.10 USD) - 2016/08/19 15:55:12 ET
Table 'Xanthippe' 6-max Seat #4 is the button
Seat 1: pf226 ($16.41 in chips)
Seat 2: tapouttazz9 ($10 in chips)
Seat 4: pokerfreak77 ($18.95 in chips)
Seat 5: Jcuervo3825 ($7.75 in chips)
Seat 6: @japhypoker ($22.64 in chips)
Jcuervo3825: posts small blind $0.05
@japhypoker: posts big blind $0.10
*** HOLE CARDS ***
Dealt to tapouttazz9 [8d 3h]
pf226: folds
tapouttazz9: folds
pokerfreak77: raises $0.20 to $0.30
@japhypoker said, "easy come easy go"
Jcuervo3825: calls $0.25
@japhypoker: folds
*** FLOP *** [2h Ts Qh]
Jcuervo3825: checks
pokerfreak77: bets $0.50
Jcuervo3825: folds
Uncalled bet ($0.50) returned to pokerfreak77
pokerfreak77 collected $0.66 from pot
pokerfreak77: doesn't show hand
*** SUMMARY ***
Total pot $0.70 | Rake $0.04
Board [2h Ts Qh]
Seat 1: pf226 folded before Flop (didn't bet)
Seat 2: tapouttazz9 folded before Flop (didn't bet)
Seat 4: pokerfreak77 (button) collected ($0.66)
Seat 5: Jcuervo3825 (small blind) folded on the Flop
Seat 6: @japhypoker (big blind) folded before Flop


PokerStars Hand #157131535607:  Hold'em No Limit ($0.05/$0.10 USD) - 2016/08/19 15:55:52 ET
Table 'Xanthippe' 6-max Seat #5 is the button
Seat 1: pf226 ($16.41 in chips)
Seat 2: tapouttazz9 ($10 in chips)
Seat 3: TeamGolden44 ($10 in chips)
Seat 4: pokerfreak77 ($19.31 in chips)
Seat 5: Jcuervo3825 ($9.75 in chips)
Seat 6: @japhypoker ($22.54 in chips)
@japhypoker: posts small blind $0.05
pf226: posts big blind $0.10
*** HOLE CARDS ***
Dealt to tapouttazz9 [3d 6s]
tapouttazz9: folds
TeamGolden44: folds
pokerfreak77: raises $0.20 to $0.30
Jcuervo3825: folds
@japhypoker: calls $0.25
pf226: folds
*** FLOP *** [Ah Th Kd]
@japhypoker: checks
pokerfreak77: bets $0.30
@japhypoker: folds
Uncalled bet ($0.30) returned to pokerfreak77
pokerfreak77 collected $0.66 from pot
pokerfreak77: doesn't show hand
*** SUMMARY ***
Total pot $0.70 | Rake $0.04
Board [Ah Th Kd]
Seat 1: pf226 (big blind) folded before Flop
Seat 2: tapouttazz9 folded before Flop (didn't bet)
Seat 3: TeamGolden44 folded before Flop (didn't bet)
Seat 4: pokerfreak77 collected ($0.66)
Seat 5: Jcuervo3825 (button) folded before Flop (didn't bet)
Seat 6: @japhypoker (small blind) folded on the Flop


PokerStars Hand #157131535755:  Hold'em No Limit ($0.05/$0.10 USD) - 2016/08/19 15:56:29 ET
Table 'Xanthippe' 6-max Seat #6 is the button
Seat 1: pf226 ($16.31 in chips)
Seat 2: tapouttazz9 ($10 in chips)
Seat 3: TeamGolden44 ($10 in chips)
Seat 4: pokerfreak77 ($19.67 in chips)
Seat 5: Jcuervo3825 ($9.75 in chips)
Seat 6: @japhypoker ($22.24 in chips)
pf226: posts small blind $0.05
tapouttazz9: posts big blind $0.10
*** HOLE CARDS ***
Dealt to tapouttazz9 [Qc 8c]
TeamGolden44: folds
pokerfreak77: folds
Jcuervo3825: folds
@japhypoker: folds
pf226: raises $0.20 to $0.30
tapouttazz9: calls $0.20
*** FLOP *** [9h Td Ks]
pf226: checks
tapouttazz9: checks
*** TURN *** [9h Td Ks] [2h]
pf226: checks
tapouttazz9: checks
*** RIVER *** [9h Td Ks 2h] [8h]
pf226: checks
tapouttazz9: bets $0.20
pf226: calls $0.20
*** SHOW DOWN ***
tapouttazz9: shows [Qc 8c] (a pair of Eights)
pf226: shows [As 9c] (a pair of Nines)
pf226 collected $0.95 from pot
*** SUMMARY ***
Total pot $1 | Rake $0.05
Board [9h Td Ks 2h 8h]
Seat 1: pf226 (small blind) showed [As 9c] and won ($0.95) with a pair of Nines
Seat 2: tapouttazz9 (big blind) showed [Qc 8c] and lost with a pair of Eights
Seat 3: TeamGolden44 folded before Flop (didn't bet)
Seat 4: pokerfreak77 folded before Flop (didn't bet)
Seat 5: Jcuervo3825 folded before Flop (didn't bet)
Seat 6: @japhypoker (button) folded before Flop (didn't bet)


PokerStars Hand #157131535847:  Hold'em No Limit ($0.05/$0.10 USD) - 2016/08/19 15:56:51 ET
Table 'Xanthippe' 6-max Seat #1 is the button
Seat 1: pf226 ($16.76 in chips)
Seat 2: tapouttazz9 ($9.50 in chips)
Seat 3: TeamGolden44 ($10 in chips)
Seat 4: pokerfreak77 ($19.67 in chips)
Seat 5: Jcuervo3825 ($9.75 in chips)
Seat 6: @japhypoker ($22.24 in chips)
tapouttazz9: posts small blind $0.05
TeamGolden44: posts big blind $0.10
*** HOLE CARDS ***
Dealt to tapouttazz9 [Kd Tc]
pokerfreak77: folds
Jcuervo3825: folds
@japhypoker: folds
pf226: folds
tapouttazz9: folds
Uncalled bet ($0.05) returned to TeamGolden44
TeamGolden44 collected $0.10 from pot
TeamGolden44: doesn't show hand
*** SUMMARY ***
Total pot $0.10 | Rake $0
Seat 1: pf226 (button) folded before Flop (didn't bet)
Seat 2: tapouttazz9 (small blind) folded before Flop
Seat 3: TeamGolden44 (big blind) collected ($0.10)
Seat 4: pokerfreak77 folded before Flop (didn't bet)
Seat 5: Jcuervo3825 folded before Flop (didn't bet)
Seat 6: @japhypoker folded before Flop (didn't bet)


PokerStars Hand #157131535956:  Hold'em No Limit ($0.05/$0.10 USD) - 2016/08/19 15:57:21 ET
Table 'Xanthippe' 6-max Seat #2 is the button
Seat 1: pf226 ($16.76 in chips)
Seat 2: tapouttazz9 ($9.45 in chips)
Seat 3: TeamGolden44 ($10.05 in chips)
Seat 4: pokerfreak77 ($19.67 in chips)
Seat 5: Jcuervo3825 ($9.75 in chips)
Seat 6: @japhypoker ($22.24 in chips)
TeamGolden44: posts small blind $0.05
pokerfreak77: posts big blind $0.10
*** HOLE CARDS ***
Dealt to tapouttazz9 [7s Ad]
Jcuervo3825: folds
@japhypoker: raises $0.15 to $0.25
pf226: folds
tapouttazz9: folds
TeamGolden44: raises $0.60 to $0.85
pokerfreak77: folds
@japhypoker: calls $0.60
*** FLOP *** [9s Jd 8c]
TeamGolden44: checks
@japhypoker: checks
*** TURN *** [9s Jd 8c] [7h]
TeamGolden44: bets $1.71
@japhypoker: folds
Uncalled bet ($1.71) returned to TeamGolden44
TeamGolden44 collected $1.71 from pot
TeamGolden44: doesn't show hand
*** SUMMARY ***
Total pot $1.80 | Rake $0.09
Board [9s Jd 8c 7h]
Seat 1: pf226 folded before Flop (didn't bet)
Seat 2: tapouttazz9 (button) folded before Flop (didn't bet)
Seat 3: TeamGolden44 (small blind) collected ($1.71)
Seat 4: pokerfreak77 (big blind) folded before Flop
Seat 5: Jcuervo3825 folded before Flop (didn't bet)
Seat 6: @japhypoker folded on the Turn


PokerStars Hand #157131536140:  Hold'em No Limit ($0.05/$0.10 USD) - 2016/08/19 15:58:10 ET
Table 'Xanthippe' 6-max Seat #3 is the button
Seat 1: pf226 ($16.76 in chips)
Seat 2: tapouttazz9 ($9.45 in chips)
Seat 3: TeamGolden44 ($10.91 in chips)
Seat 4: pokerfreak77 ($19.57 in chips)
Seat 5: Jcuervo3825 ($9.75 in chips)
Seat 6: @japhypoker ($21.39 in chips)
pokerfreak77: posts small blind $0.05
Jcuervo3825: posts big blind $0.10
*** HOLE CARDS ***
Dealt to tapouttazz9 [Td 8d]
@japhypoker: folds
pf226: raises $0.20 to $0.30
tapouttazz9: folds
TeamGolden44: folds
pokerfreak77: folds
Jcuervo3825: folds
Uncalled bet ($0.20) returned to pf226
pf226 collected $0.25 from pot
pf226: doesn't show hand
*** SUMMARY ***
Total pot $0.25 | Rake $0
Seat 1: pf226 collected ($0.25)
Seat 2: tapouttazz9 folded before Flop (didn't bet)
Seat 3: TeamGolden44 (button) folded before Flop (didn't bet)
Seat 4: pokerfreak77 (small blind) folded before Flop
Seat 5: Jcuervo3825 (big blind) folded before Flop
Seat 6: @japhypoker folded before Flop (didn't bet)


PokerStars Hand #157131536207:  Hold'em No Limit ($0.05/$0.10 USD) - 2016/08/19 15:58:29 ET
Table 'Xanthippe' 6-max Seat #4 is the button
Seat 1: pf226 ($16.91 in chips)
Seat 2: tapouttazz9 ($9.45 in chips)
Seat 3: TeamGolden44 ($10.91 in chips)
Seat 4: pokerfreak77 ($19.52 in chips)
Seat 5: Jcuervo3825 ($9.65 in chips)
Seat 6: @japhypoker ($21.39 in chips)
Jcuervo3825: posts small blind $0.05
@japhypoker: posts big blind $0.10
*** HOLE CARDS ***
Dealt to tapouttazz9 [9h 7h]
pf226: folds
tapouttazz9: folds
TeamGolden44: folds
pokerfreak77: folds
Jcuervo3825: folds
Uncalled bet ($0.05) returned to @japhypoker
@japhypoker collected $0.10 from pot
@japhypoker: doesn't show hand
*** SUMMARY ***
Total pot $0.10 | Rake $0
Seat 1: pf226 folded before Flop (didn't bet)
Seat 2: tapouttazz9 folded before Flop (didn't bet)
Seat 3: TeamGolden44 folded before Flop (didn't bet)
Seat 4: pokerfreak77 (button) folded before Flop (didn't bet)
Seat 5: Jcuervo3825 (small blind) folded before Flop
Seat 6: @japhypoker (big blind) collected ($0.10)


PokerStars Hand #157131536303:  Hold'em No Limit ($0.05/$0.10 USD) - 2016/08/19 15:58:53 ET
Table 'Xanthippe' 6-max Seat #5 is the button
Seat 1: pf226 ($16.91 in chips)
Seat 2: tapouttazz9 ($9.45 in chips)
Seat 3: TeamGolden44 ($10.91 in chips)
Seat 4: pokerfreak77 ($19.52 in chips)
Seat 5: Jcuervo3825 ($9.60 in chips)
Seat 6: @japhypoker ($21.44 in chips)
@japhypoker: posts small blind $0.05
pf226: posts big blind $0.10
*** HOLE CARDS ***
Dealt to tapouttazz9 [Qh Jh]
tapouttazz9: raises $0.20 to $0.30
TeamGolden44: folds
pokerfreak77: folds
Jcuervo3825: folds
@japhypoker: calls $0.25
pf226: raises $1 to $1.30
tapouttazz9: folds
@japhypoker: folds
Uncalled bet ($1) returned to pf226
pf226 collected $0.90 from pot
pf226: doesn't show hand
*** SUMMARY ***
Total pot $0.90 | Rake $0
Seat 1: pf226 (big blind) collected ($0.90)
Seat 2: tapouttazz9 folded before Flop
Seat 3: TeamGolden44 folded before Flop (didn't bet)
Seat 4: pokerfreak77 folded before Flop (didn't bet)
Seat 5: Jcuervo3825 (button) folded before Flop (didn't bet)
Seat 6: @japhypoker (small blind) folded before Flop


PokerStars Hand #157131536454:  Hold'em No Limit ($0.05/$0.10 USD) - 2016/08/19 15:59:31 ET
Table 'Xanthippe' 6-max Seat #6 is the button
Seat 1: pf226 ($17.51 in chips)
Seat 2: tapouttazz9 ($9.15 in chips)
Seat 3: TeamGolden44 ($10.91 in chips)
Seat 4: pokerfreak77 ($19.52 in chips)
Seat 5: Jcuervo3825 ($9.60 in chips)
Seat 6: @japhypoker ($21.14 in chips)
pf226: posts small blind $0.05
tapouttazz9: posts big blind $0.10
*** HOLE CARDS ***
Dealt to tapouttazz9 [5c 7h]
TeamGolden44: folds
pokerfreak77: folds
Jcuervo3825: raises $0.15 to $0.25
@japhypoker: folds
pf226: folds
tapouttazz9: folds
Uncalled bet ($0.15) returned to Jcuervo3825
Jcuervo3825 collected $0.25 from pot
*** SUMMARY ***
Total pot $0.25 | Rake $0
Seat 1: pf226 (small blind) folded before Flop
Seat 2: tapouttazz9 (big blind) folded before Flop
Seat 3: TeamGolden44 folded before Flop (didn't bet)
Seat 4: pokerfreak77 folded before Flop (didn't bet)
Seat 5: Jcuervo3825 collected ($0.25)
Seat 6: @japhypoker (button) folded before Flop (didn't bet)


PokerStars Hand #157131536557:  Hold'em No Limit ($0.05/$0.10 USD) - 2016/08/19 15:59:53 ET
Table 'Xanthippe' 6-max Seat #1 is the button
Seat 1: pf226 ($17.46 in chips)
Seat 2: tapouttazz9 ($9.05 in chips)
Seat 3: TeamGolden44 ($10.91 in chips)
Seat 4: pokerfreak77 ($19.52 in chips)
Seat 5: Jcuervo3825 ($9.75 in chips)
Seat 6: @japhypoker ($21.14 in chips)
tapouttazz9: posts small blind $0.05
TeamGolden44: posts big blind $0.10
*** HOLE CARDS ***
Dealt to tapouttazz9 [Kc Js]
pokerfreak77: calls $0.10
Jcuervo3825: folds
@japhypoker: folds
pf226: calls $0.10
tapouttazz9: raises $0.10 to $0.20
TeamGolden44: calls $0.10
pokerfreak77: calls $0.10
pf226: calls $0.10
*** FLOP *** [2s 5d 6h]
tapouttazz9: checks
TeamGolden44: bets $0.38
pokerfreak77: calls $0.38
pf226: folds
tapouttazz9: folds
*** TURN *** [2s 5d 6h] [7d]
TeamGolden44: checks
pokerfreak77: checks
*** RIVER *** [2s 5d 6h 7d] [8s]
TeamGolden44: bets $0.74
pokerfreak77: folds
Uncalled bet ($0.74) returned to TeamGolden44
TeamGolden44 collected $1.48 from pot
TeamGolden44: doesn't show hand
*** SUMMARY ***
Total pot $1.56 | Rake $0.08
Board [2s 5d 6h 7d 8s]
Seat 1: pf226 (button) folded on the Flop
Seat 2: tapouttazz9 (small blind) folded on the Flop
Seat 3: TeamGolden44 (big blind) collected ($1.48)
Seat 4: pokerfreak77 folded on the River
Seat 5: Jcuervo3825 folded before Flop (didn't bet)
Seat 6: @japhypoker folded before Flop (didn't bet)


PokerStars Hand #157131536950:  Hold'em No Limit ($0.05/$0.10 USD) - 2016/08/19 16:01:23 ET
Table 'Xanthippe' 6-max Seat #2 is the button
Seat 1: pf226 ($17.26 in chips)
Seat 2: tapouttazz9 ($8.85 in chips)
Seat 3: TeamGolden44 ($11.81 in chips)
Seat 4: pokerfreak77 ($18.94 in chips)
Seat 5: Jcuervo3825 ($9.75 in chips)
Seat 6: @japhypoker ($21.14 in chips)
TeamGolden44: posts small blind $0.05
pokerfreak77: posts big blind $0.10
*** HOLE CARDS ***
Dealt to tapouttazz9 [Jd 9h]
Jcuervo3825: folds
@japhypoker: raises $0.15 to $0.25
pf226: folds
tapouttazz9: folds
TeamGolden44: folds
pokerfreak77: folds
Uncalled bet ($0.15) returned to @japhypoker
@japhypoker collected $0.25 from pot
@japhypoker: doesn't show hand
*** SUMMARY ***
Total pot $0.25 | Rake $0
Seat 1: pf226 folded before Flop (didn't bet)
Seat 2: tapouttazz9 (button) folded before Flop (didn't bet)
Seat 3: TeamGolden44 (small blind) folded before Flop
Seat 4: pokerfreak77 (big blind) folded before Flop
Seat 5: Jcuervo3825 folded before Flop (didn't bet)
Seat 6: @japhypoker collected ($0.25)


PokerStars Hand #157131537169:  Hold'em No Limit ($0.05/$0.10 USD) - 2016/08/19 16:02:13 ET
Table 'Xanthippe' 6-max Seat #3 is the button
Seat 1: pf226 ($17.26 in chips)
Seat 2: tapouttazz9 ($8.85 in chips)
Seat 3: TeamGolden44 ($11.76 in chips)
Seat 4: pokerfreak77 ($18.84 in chips)
Seat 5: Jcuervo3825 ($9.75 in chips)
Seat 6: @japhypoker ($21.29 in chips)
pokerfreak77: posts small blind $0.05
Jcuervo3825: posts big blind $0.10
*** HOLE CARDS ***
Dealt to tapouttazz9 [As 4d]
@japhypoker: raises $0.15 to $0.25
pf226: folds
tapouttazz9: folds
TeamGolden44: calls $0.25
pokerfreak77: folds
Jcuervo3825: folds
*** FLOP *** [4c 8d 9d]
@japhypoker: bets $0.30
TeamGolden44: calls $0.30
*** TURN *** [4c 8d 9d] [2c]
@japhypoker: bets $0.60
TeamGolden44: calls $0.60
*** RIVER *** [4c 8d 9d 2c] [Th]
@japhypoker: bets $1
TeamGolden44: calls $1
*** SHOW DOWN ***
@japhypoker: shows [Ah Qc] (high card Ace)
TeamGolden44: shows [3s 3d] (a pair of Threes)
TeamGolden44 collected $4.23 from pot
*** SUMMARY ***
Total pot $4.45 | Rake $0.22
Board [4c 8d 9d 2c Th]
Seat 1: pf226 folded before Flop (didn't bet)
Seat 2: tapouttazz9 folded before Flop (didn't bet)
Seat 3: TeamGolden44 (button) showed [3s 3d] and won ($4.23) with a pair of Threes
Seat 4: pokerfreak77 (small blind) folded before Flop
Seat 5: Jcuervo3825 (big blind) folded before Flop
Seat 6: @japhypoker showed [Ah Qc] and lost with high card Ace


PokerStars Hand #157131537433:  Hold'em No Limit ($0.05/$0.10 USD) - 2016/08/19 16:03:14 ET
Table 'Xanthippe' 6-max Seat #4 is the button
Seat 1: pf226 ($17.26 in chips)
Seat 2: tapouttazz9 ($8.85 in chips)
Seat 3: TeamGolden44 ($13.84 in chips)
Seat 4: pokerfreak77 ($18.79 in chips)
Seat 5: Jcuervo3825 ($9.65 in chips)
Seat 6: @japhypoker ($19.14 in chips)
Jcuervo3825: posts small blind $0.05
@japhypoker: posts big blind $0.10
*** HOLE CARDS ***
Dealt to tapouttazz9 [6s Kh]
pf226: folds
pf226 leaves the table
tapouttazz9: folds
TeamGolden44: raises $0.20 to $0.30
pokerfreak77: calls $0.30
Jcuervo3825: folds
@japhypoker: calls $0.20
*** FLOP *** [9h 3c Th]
@japhypoker: checks
TeamGolden44: checks
pokerfreak77: checks
*** TURN *** [9h 3c Th] [Tc]
@japhypoker: checks
TeamGolden44: bets $0.90
pokerfreak77: folds
@japhypoker: folds
Uncalled bet ($0.90) returned to TeamGolden44
TeamGolden44 collected $0.90 from pot
TeamGolden44: doesn't show hand
*** SUMMARY ***
Total pot $0.95 | Rake $0.05
Board [9h 3c Th Tc]
Seat 1: pf226 folded before Flop (didn't bet)
Seat 2: tapouttazz9 folded before Flop (didn't bet)
Seat 3: TeamGolden44 collected ($0.90)
Seat 4: pokerfreak77 (button) folded on the Turn
Seat 5: Jcuervo3825 (small blind) folded before Flop
Seat 6: @japhypoker (big blind) folded on the Turn


PokerStars Hand #157131537634:  Hold'em No Limit ($0.05/$0.10 USD) - 2016/08/19 16:04:03 ET
Table 'Xanthippe' 6-max Seat #5 is the button
Seat 2: tapouttazz9 ($8.85 in chips)
Seat 3: TeamGolden44 ($14.44 in chips)
Seat 4: pokerfreak77 ($18.49 in chips)
Seat 5: Jcuervo3825 ($9.60 in chips)
Seat 6: @japhypoker ($18.84 in chips)
@japhypoker: posts small blind $0.05
tapouttazz9: posts big blind $0.10
*** HOLE CARDS ***
Dealt to tapouttazz9 [Ad 9h]
TeamGolden44: folds
pokerfreak77: folds
Jcuervo3825: folds
@japhypoker: folds
Uncalled bet ($0.05) returned to tapouttazz9
tapouttazz9 collected $0.10 from pot
*** SUMMARY ***
Total pot $0.10 | Rake $0
Seat 2: tapouttazz9 (big blind) collected ($0.10)
Seat 3: TeamGolden44 folded before Flop (didn't bet)
Seat 4: pokerfreak77 folded before Flop (didn't bet)
Seat 5: Jcuervo3825 (button) folded before Flop (didn't bet)
Seat 6: @japhypoker (small blind) folded before Flop


PokerStars Hand #157131537711:  Hold'em No Limit ($0.05/$0.10 USD) - 2016/08/19 16:04:22 ET
Table 'Xanthippe' 6-max Seat #6 is the button
Seat 2: tapouttazz9 ($8.90 in chips)
Seat 3: TeamGolden44 ($14.44 in chips)
Seat 4: pokerfreak77 ($18.49 in chips)
Seat 5: Jcuervo3825 ($9.60 in chips)
Seat 6: @japhypoker ($18.79 in chips)
tapouttazz9: posts small blind $0.05
TeamGolden44: posts big blind $0.10
*** HOLE CARDS ***
Dealt to tapouttazz9 [Jc 2d]
pokerfreak77: folds
Jcuervo3825: folds
@japhypoker: calls $0.10
tapouttazz9: folds
TeamGolden44: raises $0.25 to $0.35
@japhypoker: folds
Uncalled bet ($0.25) returned to TeamGolden44
TeamGolden44 collected $0.25 from pot
TeamGolden44: doesn't show hand
*** SUMMARY ***
Total pot $0.25 | Rake $0
Seat 2: tapouttazz9 (small blind) folded before Flop
Seat 3: TeamGolden44 (big blind) collected ($0.25)
Seat 4: pokerfreak77 folded before Flop (didn't bet)
Seat 5: Jcuervo3825 folded before Flop (didn't bet)
Seat 6: @japhypoker (button) folded before Flop


PokerStars Hand #157131537843:  Hold'em No Limit ($0.05/$0.10 USD) - 2016/08/19 16:04:53 ET
Table 'Xanthippe' 6-max Seat #2 is the button
Seat 2: tapouttazz9 ($8.85 in chips)
Seat 3: TeamGolden44 ($14.59 in chips)
Seat 4: pokerfreak77 ($18.49 in chips)
Seat 5: Jcuervo3825 ($9.60 in chips)
Seat 6: @japhypoker ($18.69 in chips)
TeamGolden44: posts small blind $0.05
pokerfreak77: posts big blind $0.10
*** HOLE CARDS ***
Dealt to tapouttazz9 [3d 4h]
Jcuervo3825: folds
@japhypoker: raises $0.15 to $0.25
tapouttazz9: folds
TeamGolden44: folds
pokerfreak77: folds
Uncalled bet ($0.15) returned to @japhypoker
@japhypoker collected $0.25 from pot
@japhypoker: doesn't show hand
*** SUMMARY ***
Total pot $0.25 | Rake $0
Seat 2: tapouttazz9 (button) folded before Flop (didn't bet)
Seat 3: TeamGolden44 (small blind) folded before Flop
Seat 4: pokerfreak77 (big blind) folded before Flop
Seat 5: Jcuervo3825 folded before Flop (didn't bet)
Seat 6: @japhypoker collected ($0.25)


PokerStars Hand #157131537948:  Hold'em No Limit ($0.05/$0.10 USD) - 2016/08/19 16:05:17 ET
Table 'Xanthippe' 6-max Seat #3 is the button
Seat 2: tapouttazz9 ($8.85 in chips)
Seat 3: TeamGolden44 ($14.54 in chips)
Seat 4: pokerfreak77 ($18.39 in chips)
Seat 5: Jcuervo3825 ($9.60 in chips)
Seat 6: @japhypoker ($18.84 in chips)
pokerfreak77: posts small blind $0.05
Jcuervo3825: posts big blind $0.10
*** HOLE CARDS ***
Dealt to tapouttazz9 [8d 4h]
@japhypoker: folds
tapouttazz9: folds
pokerfreak77 is disconnected
TeamGolden44: folds
pokerfreak77 has timed out while disconnected
pokerfreak77: folds
Uncalled bet ($0.05) returned to Jcuervo3825
Jcuervo3825 collected $0.10 from pot
*** SUMMARY ***
Total pot $0.10 | Rake $0
Seat 2: tapouttazz9 folded before Flop (didn't bet)
Seat 3: TeamGolden44 (button) folded before Flop (didn't bet)
Seat 4: pokerfreak77 (small blind) folded before Flop
Seat 5: Jcuervo3825 (big blind) collected ($0.10)
Seat 6: @japhypoker folded before Flop (didn't bet)


PokerStars Hand #157131538057:  Hold'em No Limit ($0.05/$0.10 USD) - 2016/08/19 16:05:42 ET
Table 'Xanthippe' 6-max Seat #5 is the button
Seat 2: tapouttazz9 ($8.85 in chips)
Seat 3: TeamGolden44 ($14.54 in chips)
Seat 5: Jcuervo3825 ($9.65 in chips)
Seat 6: @japhypoker ($18.84 in chips)
@japhypoker: posts small blind $0.05
tapouttazz9: posts big blind $0.10
*** HOLE CARDS ***
Dealt to tapouttazz9 [4s Th]
TeamGolden44: raises $0.20 to $0.30
Jcuervo3825: calls $0.30
@japhypoker: folds
tapouttazz9: folds
*** FLOP *** [5c 6h Ac]
TeamGolden44: checks
Jcuervo3825: checks
*** TURN *** [5c 6h Ac] [5s]
TeamGolden44: bets $0.71
Pocket9s99 joins the table at seat #1
Jcuervo3825: folds
Uncalled bet ($0.71) returned to TeamGolden44
TeamGolden44 collected $0.71 from pot
TeamGolden44: doesn't show hand
*** SUMMARY ***
Total pot $0.75 | Rake $0.04
Board [5c 6h Ac 5s]
Seat 2: tapouttazz9 (big blind) folded before Flop
Seat 3: TeamGolden44 collected ($0.71)
Seat 5: Jcuervo3825 (button) folded on the Turn
Seat 6: @japhypoker (small blind) folded before Flop


PokerStars Hand #157131538294:  Hold'em No Limit ($0.05/$0.10 USD) - 2016/08/19 16:06:33 ET
Table 'Xanthippe' 6-max Seat #6 is the button
Seat 2: tapouttazz9 ($8.75 in chips)
Seat 3: TeamGolden44 ($14.95 in chips)
Seat 5: Jcuervo3825 ($9.35 in chips)
Seat 6: @japhypoker ($18.79 in chips)
Pocket9s99 will be allowed to play after the button
tapouttazz9: posts small blind $0.05
TeamGolden44: posts big blind $0.10
*** HOLE CARDS ***
Dealt to tapouttazz9 [4s 7c]
Jcuervo3825: raises $0.15 to $0.25
@japhypoker: calls $0.25
tapouttazz9: folds
TeamGolden44: folds
*** FLOP *** [Ks 5h Kh]
Jcuervo3825: checks
@japhypoker: checks
*** TURN *** [Ks 5h Kh] [4d]
Jcuervo3825: checks
@japhypoker: bets $0.30
Jcuervo3825: folds
Uncalled bet ($0.30) returned to @japhypoker
@japhypoker collected $0.62 from pot
@japhypoker: doesn't show hand
*** SUMMARY ***
Total pot $0.65 | Rake $0.03
Board [Ks 5h Kh 4d]
Seat 2: tapouttazz9 (small blind) folded before Flop
Seat 3: TeamGolden44 (big blind) folded before Flop
Seat 5: Jcuervo3825 folded on the Turn
Seat 6: @japhypoker (button) collected ($0.62)


PokerStars Hand #157131538524:  Hold'em No Limit ($0.05/$0.10 USD) - 2016/08/19 16:07:31 ET
Table 'Xanthippe' 6-max Seat #2 is the button
Seat 2: tapouttazz9 ($8.70 in chips)
Seat 3: TeamGolden44 ($14.85 in chips)
Seat 5: Jcuervo3825 ($9.10 in chips)
Seat 6: @japhypoker ($19.16 in chips)
TeamGolden44: posts small blind $0.05
Jcuervo3825: posts big blind $0.10
Pocket9s99: sits out
*** HOLE CARDS ***
Dealt to tapouttazz9 [4d 8c]
@japhypoker: folds
tapouttazz9: folds
TeamGolden44: calls $0.05
Jcuervo3825: raises $0.20 to $0.30
TeamGolden44: folds
Uncalled bet ($0.20) returned to Jcuervo3825
Jcuervo3825 collected $0.20 from pot
*** SUMMARY ***
Total pot $0.20 | Rake $0
Seat 2: tapouttazz9 (button) folded before Flop (didn't bet)
Seat 3: TeamGolden44 (small blind) folded before Flop
Seat 5: Jcuervo3825 (big blind) collected ($0.20)
Seat 6: @japhypoker folded before Flop (didn't bet)


PokerStars Hand #157131538621:  Hold'em No Limit ($0.05/$0.10 USD) - 2016/08/19 16:07:56 ET
Table 'Xanthippe' 6-max Seat #3 is the button
Seat 2: tapouttazz9 ($8.70 in chips)
Seat 3: TeamGolden44 ($14.75 in chips)
Seat 5: Jcuervo3825 ($9.20 in chips)
Seat 6: @japhypoker ($19.16 in chips)
Jcuervo3825: posts small blind $0.05
@japhypoker: posts big blind $0.10
Pocket9s99: sits out
*** HOLE CARDS ***
Dealt to tapouttazz9 [Kd Qh]
tapouttazz9: raises $0.20 to $0.30
TeamGolden44: folds
Jcuervo3825: folds
@japhypoker: folds
Uncalled bet ($0.20) returned to tapouttazz9
tapouttazz9 collected $0.25 from pot
*** SUMMARY ***
Total pot $0.25 | Rake $0
Seat 2: tapouttazz9 collected ($0.25)
Seat 3: TeamGolden44 (button) folded before Flop (didn't bet)
Seat 5: Jcuervo3825 (small blind) folded before Flop
Seat 6: @japhypoker (big blind) folded before Flop


PokerStars Hand #157131538694:  Hold'em No Limit ($0.05/$0.10 USD) - 2016/08/19 16:08:13 ET
Table 'Xanthippe' 6-max Seat #5 is the button
Seat 1: Pocket9s99 ($10 in chips)
Seat 2: tapouttazz9 ($8.85 in chips)
Seat 3: TeamGolden44 ($14.75 in chips)
Seat 5: Jcuervo3825 ($9.15 in chips)
Seat 6: @japhypoker ($19.06 in chips)
@japhypoker: posts small blind $0.05
Pocket9s99: posts big blind $0.10
*** HOLE CARDS ***
Dealt to tapouttazz9 [4c Ts]
tapouttazz9: folds
TeamGolden44: calls $0.10
Jcuervo3825: folds
@japhypoker: raises $0.30 to $0.40
Pocket9s99: calls $0.30
TeamGolden44: calls $0.30
*** FLOP *** [6c 2h 4d]
@japhypoker: bets $0.55
Pocket9s99: folds
TeamGolden44: calls $0.55
*** TURN *** [6c 2h 4d] [7h]
@japhypoker: bets $1.35
TeamGolden44: calls $1.35
*** RIVER *** [6c 2h 4d 7h] [2d]
@japhypoker: bets $16.76 and is all-in
TeamGolden44: folds
Uncalled bet ($16.76) returned to @japhypoker
@japhypoker collected $4.75 from pot
@japhypoker: doesn't show hand
*** SUMMARY ***
Total pot $5 | Rake $0.25
Board [6c 2h 4d 7h 2d]
Seat 1: Pocket9s99 (big blind) folded on the Flop
Seat 2: tapouttazz9 folded before Flop (didn't bet)
Seat 3: TeamGolden44 folded on the River
Seat 5: Jcuervo3825 (button) folded before Flop (didn't bet)
Seat 6: @japhypoker (small blind) collected ($4.75)


PokerStars Hand #157131538887:  Hold'em No Limit ($0.05/$0.10 USD) - 2016/08/19 16:09:03 ET
Table 'Xanthippe' 6-max Seat #6 is the button
Seat 1: Pocket9s99 ($9.60 in chips)
Seat 2: tapouttazz9 ($8.85 in chips)
Seat 3: TeamGolden44 ($12.45 in chips)
Seat 5: Jcuervo3825 ($9.15 in chips)
Seat 6: @japhypoker ($21.51 in chips)
Pocket9s99: posts small blind $0.05
tapouttazz9: posts big blind $0.10
*** HOLE CARDS ***
Dealt to tapouttazz9 [Ah 3h]
TeamGolden44: folds
Jcuervo3825: folds
@japhypoker: raises $0.15 to $0.25
Pocket9s99: calls $0.20
tapouttazz9: calls $0.15
*** FLOP *** [Qs 7c Ac]
Pocket9s99: checks
tapouttazz9: bets $0.20
@japhypoker: calls $0.20
Pocket9s99: calls $0.20
*** TURN *** [Qs 7c Ac] [Qh]
Pocket9s99: checks
tapouttazz9: bets $0.30
@japhypoker: calls $0.30
Pocket9s99: folds
*** RIVER *** [Qs 7c Ac Qh] [7s]
tapouttazz9: checks
@japhypoker: bets $1
tapouttazz9: folds
Uncalled bet ($1) returned to @japhypoker
@japhypoker collected $1.85 from pot
@japhypoker: doesn't show hand
*** SUMMARY ***
Total pot $1.95 | Rake $0.10
Board [Qs 7c Ac Qh 7s]
Seat 1: Pocket9s99 (small blind) folded on the Turn
Seat 2: tapouttazz9 (big blind) folded on the River
Seat 3: TeamGolden44 folded before Flop (didn't bet)
Seat 5: Jcuervo3825 folded before Flop (didn't bet)
Seat 6: @japhypoker (button) collected ($1.85)


PokerStars Hand #157131539174:  Hold'em No Limit ($0.05/$0.10 USD) - 2016/08/19 16:10:21 ET
Table 'Xanthippe' 6-max Seat #1 is the button
Seat 1: Pocket9s99 ($9.15 in chips)
Seat 2: tapouttazz9 ($8.10 in chips)
Seat 3: TeamGolden44 ($12.45 in chips)
Seat 5: Jcuervo3825 ($9.15 in chips)
Seat 6: @japhypoker ($22.61 in chips)
tapouttazz9: posts small blind $0.05
TeamGolden44: posts big blind $0.10
*** HOLE CARDS ***
Dealt to tapouttazz9 [5c Tc]
Jcuervo3825: folds
@japhypoker: folds
Pocket9s99: folds
tapouttazz9: folds
Uncalled bet ($0.05) returned to TeamGolden44
TeamGolden44 collected $0.10 from pot
TeamGolden44: doesn't show hand
*** SUMMARY ***
Total pot $0.10 | Rake $0
Seat 1: Pocket9s99 (button) folded before Flop (didn't bet)
Seat 2: tapouttazz9 (small blind) folded before Flop
Seat 3: TeamGolden44 (big blind) collected ($0.10)
Seat 5: Jcuervo3825 folded before Flop (didn't bet)
Seat 6: @japhypoker folded before Flop (didn't bet)


PokerStars Hand #157131539210:  Hold'em No Limit ($0.05/$0.10 USD) - 2016/08/19 16:10:31 ET
Table 'Xanthippe' 6-max Seat #2 is the button
Seat 1: Pocket9s99 ($9.15 in chips)
Seat 2: tapouttazz9 ($8.05 in chips)
Seat 3: TeamGolden44 ($12.50 in chips)
Seat 6: @japhypoker ($22.61 in chips)
TeamGolden44: posts small blind $0.05
Jcuervo3825: is sitting out
@japhypoker: posts big blind $0.10
*** HOLE CARDS ***
Dealt to tapouttazz9 [Ts 3s]
Pocket9s99: folds
Jcuervo3825 leaves the table
tapouttazz9: folds
TeamGolden44: folds
Uncalled bet ($0.05) returned to @japhypoker
@japhypoker collected $0.10 from pot
@japhypoker: doesn't show hand
*** SUMMARY ***
Total pot $0.10 | Rake $0
Seat 1: Pocket9s99 folded before Flop (didn't bet)
Seat 2: tapouttazz9 (button) folded before Flop (didn't bet)
Seat 3: TeamGolden44 (small blind) folded before Flop
Seat 6: @japhypoker (big blind) collected ($0.10)


PokerStars Hand #157131539252:  Hold'em No Limit ($0.05/$0.10 USD) - 2016/08/19 16:10:42 ET
Table 'Xanthippe' 6-max Seat #3 is the button
Seat 1: Pocket9s99 ($9.15 in chips)
Seat 2: tapouttazz9 ($8.05 in chips)
Seat 3: TeamGolden44 ($12.45 in chips)
Seat 6: @japhypoker ($22.66 in chips)
@japhypoker: posts small blind $0.05
Pocket9s99: posts big blind $0.10
*** HOLE CARDS ***
Dealt to tapouttazz9 [Ks 2s]
tapouttazz9: folds
TeamGolden44: raises $0.25 to $0.35
@japhypoker: folds
Pocket9s99: folds
Uncalled bet ($0.25) returned to TeamGolden44
TeamGolden44 collected $0.25 from pot
TeamGolden44: doesn't show hand
*** SUMMARY ***
Total pot $0.25 | Rake $0
Seat 1: Pocket9s99 (big blind) folded before Flop
Seat 2: tapouttazz9 folded before Flop (didn't bet)
Seat 3: TeamGolden44 (button) collected ($0.25)
Seat 6: @japhypoker (small blind) folded before Flop


PokerStars Hand #157131539314:  Hold'em No Limit ($0.05/$0.10 USD) - 2016/08/19 16:10:58 ET
Table 'Xanthippe' 6-max Seat #6 is the button
Seat 1: Pocket9s99 ($9.05 in chips)
Seat 2: tapouttazz9 ($8.05 in chips)
Seat 3: TeamGolden44 ($12.60 in chips)
Seat 6: @japhypoker ($22.61 in chips)
Pocket9s99: posts small blind $0.05
tapouttazz9: posts big blind $0.10
*** HOLE CARDS ***
Dealt to tapouttazz9 [2h 8s]
TeamGolden44: folds
@japhypoker: folds
@japhypoker said, "gg gl tazz"
Pocket9s99: calls $0.05
@japhypoker said, "leaving @ bb"
tapouttazz9: checks
*** FLOP *** [Qc Kh 7c]
tapouttazz9 said, "later"
Pocket9s99: checks
tapouttazz9: checks
*** TURN *** [Qc Kh 7c] [7h]
Pocket9s99: checks
tapouttazz9: checks
*** RIVER *** [Qc Kh 7c 7h] [2s]
Pocket9s99: checks
tapouttazz9: checks
*** SHOW DOWN ***
Pocket9s99: shows [3d 9d] (a pair of Sevens)
tapouttazz9: shows [2h 8s] (two pair, Sevens and Deuces)
tapouttazz9 collected $0.19 from pot
*** SUMMARY ***
Total pot $0.20 | Rake $0.01
Board [Qc Kh 7c 7h 2s]
Seat 1: Pocket9s99 (small blind) showed [3d 9d] and lost with a pair of Sevens
Seat 2: tapouttazz9 (big blind) showed [2h 8s] and won ($0.19) with two pair, Sevens and Deuces
Seat 3: TeamGolden44 folded before Flop (didn't bet)
Seat 6: @japhypoker (button) folded before Flop (didn't bet)


PokerStars Hand #157131539473:  Hold'em No Limit ($0.05/$0.10 USD) - 2016/08/19 16:11:37 ET
Table 'Xanthippe' 6-max Seat #1 is the button
Seat 1: Pocket9s99 ($8.95 in chips)
Seat 2: tapouttazz9 ($8.14 in chips)
Seat 3: TeamGolden44 ($12.60 in chips)
Seat 6: @japhypoker ($22.61 in chips)
tapouttazz9: posts small blind $0.05
TeamGolden44: posts big blind $0.10
*** HOLE CARDS ***
Dealt to tapouttazz9 [8h 7h]
@japhypoker: folds
Pocket9s99: folds
tapouttazz9: folds
Uncalled bet ($0.05) returned to TeamGolden44
@japhypoker leaves the table
TeamGolden44 collected $0.10 from pot
TeamGolden44: doesn't show hand
*** SUMMARY ***
Total pot $0.10 | Rake $0
Seat 1: Pocket9s99 (button) folded before Flop (didn't bet)
Seat 2: tapouttazz9 (small blind) folded before Flop
Seat 3: TeamGolden44 (big blind) collected ($0.10)
Seat 6: @japhypoker folded before Flop (didn't bet)


PokerStars Hand #157131539495:  Hold'em No Limit ($0.05/$0.10 USD) - 2016/08/19 16:11:43 ET
Table 'Xanthippe' 6-max Seat #2 is the button
Seat 1: Pocket9s99 ($8.95 in chips)
Seat 2: tapouttazz9 ($8.09 in chips)
Seat 3: TeamGolden44 ($12.65 in chips)
TeamGolden44: posts small blind $0.05
Pocket9s99: posts big blind $0.10
*** HOLE CARDS ***
Dealt to tapouttazz9 [3d 4c]
tapouttazz9: folds
TeamGolden44: folds
Uncalled bet ($0.05) returned to Pocket9s99
Pocket9s99 collected $0.10 from pot
*** SUMMARY ***
Total pot $0.10 | Rake $0
Seat 1: Pocket9s99 (big blind) collected ($0.10)
Seat 2: tapouttazz9 (button) folded before Flop (didn't bet)
Seat 3: TeamGolden44 (small blind) folded before Flop


PokerStars Hand #157131539540:  Hold'em No Limit ($0.05/$0.10 USD) - 2016/08/19 16:11:52 ET
Table 'Xanthippe' 6-max Seat #3 is the button
Seat 1: Pocket9s99 ($9 in chips)
Seat 2: tapouttazz9 ($8.09 in chips)
Seat 3: TeamGolden44 ($12.60 in chips)
Pocket9s99: posts small blind $0.05
tapouttazz9: posts big blind $0.10
*** HOLE CARDS ***
Dealt to tapouttazz9 [4h 6c]
TeamGolden44: raises $0.10 to $0.20
Pocket9s99: folds
tapouttazz9: folds
Uncalled bet ($0.10) returned to TeamGolden44
TeamGolden44 collected $0.25 from pot
TeamGolden44: doesn't show hand
*** SUMMARY ***
Total pot $0.25 | Rake $0
Seat 1: Pocket9s99 (small blind) folded before Flop
Seat 2: tapouttazz9 (big blind) folded before Flop
Seat 3: TeamGolden44 (button) collected ($0.25)


PokerStars Hand #157131539576:  Hold'em No Limit ($0.05/$0.10 USD) - 2016/08/19 16:12:01 ET
Table 'Xanthippe' 6-max Seat #1 is the button
Seat 1: Pocket9s99 ($8.95 in chips)
Seat 2: tapouttazz9 ($7.99 in chips)
Seat 3: TeamGolden44 ($12.75 in chips)
tapouttazz9: posts small blind $0.05
TeamGolden44: posts big blind $0.10
*** HOLE CARDS ***
Dealt to tapouttazz9 [7h 2d]
Pocket9s99: folds
tapouttazz9: folds
Uncalled bet ($0.05) returned to TeamGolden44
TeamGolden44 collected $0.10 from pot
TeamGolden44: doesn't show hand
*** SUMMARY ***
Total pot $0.10 | Rake $0
Seat 1: Pocket9s99 (button) folded before Flop (didn't bet)
Seat 2: tapouttazz9 (small blind) folded before Flop
Seat 3: TeamGolden44 (big blind) collected ($0.10)


PokerStars Hand #157131539607:  Hold'em No Limit ($0.05/$0.10 USD) - 2016/08/19 16:12:08 ET
Table 'Xanthippe' 6-max Seat #2 is the button
Seat 1: Pocket9s99 ($8.95 in chips)
Seat 2: tapouttazz9 ($7.94 in chips)
Seat 3: TeamGolden44 ($12.80 in chips)
TeamGolden44: posts small blind $0.05
Pocket9s99: posts big blind $0.10
*** HOLE CARDS ***
Dealt to tapouttazz9 [Kc Jd]
tapouttazz9: raises $0.20 to $0.30
TeamGolden44: folds
Pocket9s99: folds
Uncalled bet ($0.20) returned to tapouttazz9
tapouttazz9 collected $0.25 from pot
*** SUMMARY ***
Total pot $0.25 | Rake $0
Seat 1: Pocket9s99 (big blind) folded before Flop
Seat 2: tapouttazz9 (button) collected ($0.25)
Seat 3: TeamGolden44 (small blind) folded before Flop


PokerStars Hand #157131539678:  Hold'em No Limit ($0.05/$0.10 USD) - 2016/08/19 16:12:27 ET
Table 'Xanthippe' 6-max Seat #3 is the button
Seat 1: Pocket9s99 ($8.85 in chips)
Seat 2: tapouttazz9 ($8.09 in chips)
Seat 3: TeamGolden44 ($12.75 in chips)
Pocket9s99: posts small blind $0.05
tapouttazz9: posts big blind $0.10
*** HOLE CARDS ***
Dealt to tapouttazz9 [As 9s]
TeamGolden44: folds
Pocket9s99: folds
Uncalled bet ($0.05) returned to tapouttazz9
tapouttazz9 collected $0.10 from pot
jvurn joins the table at seat #5
*** SUMMARY ***
Total pot $0.10 | Rake $0
Seat 1: Pocket9s99 (small blind) folded before Flop
Seat 2: tapouttazz9 (big blind) collected ($0.10)
Seat 3: TeamGolden44 (button) folded before Flop (didn't bet)


PokerStars Hand #157131539698:  Hold'em No Limit ($0.05/$0.10 USD) - 2016/08/19 16:12:32 ET
Table 'Xanthippe' 6-max Seat #1 is the button
Seat 1: Pocket9s99 ($8.80 in chips)
Seat 2: tapouttazz9 ($8.14 in chips)
Seat 5: jvurn ($6 in chips)
tapouttazz9: posts small blind $0.05
jvurn: posts big blind $0.10
*** HOLE CARDS ***
Dealt to tapouttazz9 [2s 4h]
Pocket9s99: raises $0.25 to $0.35
tapouttazz9: folds
jvurn: calls $0.25
*** FLOP *** [2c 2h 5d]
jvurn: checks
Pocket9s99: checks
*** TURN *** [2c 2h 5d] [4d]
jvurn: bets $0.30
Pocket9s99: calls $0.30
*** RIVER *** [2c 2h 5d 4d] [9h]
jvurn: checks
Pocket9s99: bets $1.28
jvurn: calls $1.28
*** SHOW DOWN ***
Pocket9s99: shows [2d 3d] (three of a kind, Deuces)
jvurn: mucks hand
Pocket9s99 collected $3.71 from pot
*** SUMMARY ***
Total pot $3.91 | Rake $0.20
Board [2c 2h 5d 4d 9h]
Seat 1: Pocket9s99 (button) showed [2d 3d] and won ($3.71) with three of a kind, Deuces
Seat 2: tapouttazz9 (small blind) folded before Flop
Seat 5: jvurn (big blind) mucked [Ah Ks]


PokerStars Hand #157131539848:  Hold'em No Limit ($0.05/$0.10 USD) - 2016/08/19 16:13:13 ET
Table 'Xanthippe' 6-max Seat #2 is the button
Seat 1: Pocket9s99 ($10.58 in chips)
Seat 2: tapouttazz9 ($8.09 in chips)
Seat 5: jvurn ($4.07 in chips)
TeamGolden44 will be allowed to play after the button
jvurn: posts small blind $0.05
Pocket9s99: posts big blind $0.10
*** HOLE CARDS ***
Dealt to tapouttazz9 [8c Ac]
tapouttazz9: raises $0.20 to $0.30
jvurn: folds
Pocket9s99: folds
Uncalled bet ($0.20) returned to tapouttazz9
tapouttazz9 collected $0.25 from pot
*** SUMMARY ***
Total pot $0.25 | Rake $0
Seat 1: Pocket9s99 (big blind) folded before Flop
Seat 2: tapouttazz9 (button) collected ($0.25)
Seat 5: jvurn (small blind) folded before Flop


PokerStars Hand #157131539881:  Hold'em No Limit ($0.05/$0.10 USD) - 2016/08/19 16:13:21 ET
Table 'Xanthippe' 6-max Seat #5 is the button
Seat 1: Pocket9s99 ($10.48 in chips)
Seat 2: tapouttazz9 ($8.24 in chips)
Seat 3: TeamGolden44 ($12.75 in chips)
Seat 5: jvurn ($4.02 in chips)
Pocket9s99: posts small blind $0.05
tapouttazz9: posts big blind $0.10
TeamGolden44: posts small & big blinds $0.15
*** HOLE CARDS ***
Dealt to tapouttazz9 [Kd 8c]
TeamGolden44: checks
jvurn: folds
Pocket9s99: calls $0.05
tapouttazz9: checks
*** FLOP *** [9c 6h Kh]
Pocket9s99: checks
tapouttazz9: checks
TeamGolden44: checks
*** TURN *** [9c 6h Kh] [8d]
Pocket9s99: checks
tapouttazz9: bets $0.30
TeamGolden44: folds
Pocket9s99: raises $0.55 to $0.85
tapouttazz9: calls $0.55
*** RIVER *** [9c 6h Kh 8d] [4h]
Pocket9s99: bets $1.95
tapouttazz9: calls $1.95
*** SHOW DOWN ***
Pocket9s99: shows [Ks Ad] (a pair of Kings)
tapouttazz9: shows [Kd 8c] (two pair, Kings and Eights)
tapouttazz9 collected $5.65 from pot
*** SUMMARY ***
Total pot $5.95 | Rake $0.30
Board [9c 6h Kh 8d 4h]
Seat 1: Pocket9s99 (small blind) showed [Ks Ad] and lost with a pair of Kings
Seat 2: tapouttazz9 (big blind) showed [Kd 8c] and won ($5.65) with two pair, Kings and Eights
Seat 3: TeamGolden44 folded on the Turn
Seat 5: jvurn (button) folded before Flop (didn't bet)


PokerStars Hand #157132558204:  Hold'em No Limit ($0.05/$0.10 USD) - 2016/08/19 16:14:18 ET
Table 'Xanthippe' 6-max Seat #1 is the button
Seat 1: Pocket9s99 ($7.58 in chips)
Seat 2: tapouttazz9 ($10.99 in chips)
Seat 3: TeamGolden44 ($12.60 in chips)
Seat 5: jvurn ($4.02 in chips)
tapouttazz9: posts small blind $0.05
TeamGolden44: posts big blind $0.10
*** HOLE CARDS ***
Dealt to tapouttazz9 [4s Ac]
jvurn: raises $0.20 to $0.30
Pocket9s99: folds
tapouttazz9: folds
TeamGolden44: calls $0.20
*** FLOP *** [6d Qc As]
TeamGolden44: checks
jvurn: bets $0.30
TeamGolden44: calls $0.30
*** TURN *** [6d Qc As] [8c]
TeamGolden44: checks
jvurn: bets $1.20
TeamGolden44: calls $1.20
*** RIVER *** [6d Qc As 8c] [9c]
TeamGolden44: bets $10.80 and is all-in
jvurn: calls $2.22 and is all-in
Uncalled bet ($8.58) returned to TeamGolden44
*** SHOW DOWN ***
TeamGolden44: shows [6h Qh] (two pair, Queens and Sixes)
jvurn: shows [Ah 7c] (a pair of Aces)
TeamGolden44 collected $7.69 from pot
Batiatus10 joins the table at seat #6
*** SUMMARY ***
Total pot $8.09 | Rake $0.40
Board [6d Qc As 8c 9c]
Seat 1: Pocket9s99 (button) folded before Flop (didn't bet)
Seat 2: tapouttazz9 (small blind) folded before Flop
Seat 3: TeamGolden44 (big blind) showed [6h Qh] and won ($7.69) with two pair, Queens and Sixes
Seat 5: jvurn showed [Ah 7c] and lost with a pair of Aces


PokerStars Hand #157132558432:  Hold'em No Limit ($0.05/$0.10 USD) - 2016/08/19 16:15:15 ET
Table 'Xanthippe' 6-max Seat #2 is the button
Seat 1: Pocket9s99 ($7.58 in chips)
Seat 2: tapouttazz9 ($10.94 in chips)
Seat 3: TeamGolden44 ($16.27 in chips)
Seat 6: Batiatus10 ($10 in chips)
TeamGolden44: posts small blind $0.05
pokerfreak77 was removed from the table for failing to post
Batiatus10: posts big blind $0.10
*** HOLE CARDS ***
Dealt to tapouttazz9 [4c Th]
Pocket9s99: calls $0.10
tapouttazz9: folds
TeamGolden44: calls $0.05
Batiatus10: checks
*** FLOP *** [8h 7s 5d]
TeamGolden44: checks
Batiatus10: checks
Pocket9s99: checks
*** TURN *** [8h 7s 5d] [5h]
TeamGolden44: checks
Batiatus10: checks
Pocket9s99: checks
*** RIVER *** [8h 7s 5d 5h] [Ks]
TeamGolden44: checks
Batiatus10: checks
Pocket9s99: checks
*** SHOW DOWN ***
TeamGolden44: shows [As 6c] (a pair of Fives)
Batiatus10: mucks hand
Pocket9s99: shows [3c 3s] (two pair, Fives and Threes)
Pocket9s99 collected $0.28 from pot
*** SUMMARY ***
Total pot $0.30 | Rake $0.02
Board [8h 7s 5d 5h Ks]
Seat 1: Pocket9s99 showed [3c 3s] and won ($0.28) with two pair, Fives and Threes
Seat 2: tapouttazz9 (button) folded before Flop (didn't bet)
Seat 3: TeamGolden44 (small blind) showed [As 6c] and lost with a pair of Fives
Seat 6: Batiatus10 (big blind) mucked [9c 3h]


PokerStars Hand #157132558593:  Hold'em No Limit ($0.05/$0.10 USD) - 2016/08/19 16:15:57 ET
Table 'Xanthippe' 6-max Seat #3 is the button
Seat 1: Pocket9s99 ($7.76 in chips)
Seat 2: tapouttazz9 ($10.94 in chips)
Seat 3: TeamGolden44 ($16.17 in chips)
Seat 6: Batiatus10 ($9.90 in chips)
jvurn will be allowed to play after the button
Batiatus10: posts small blind $0.05
Pocket9s99: posts big blind $0.10
*** HOLE CARDS ***
Dealt to tapouttazz9 [6d 3s]
tapouttazz9: folds
TeamGolden44: raises $0.25 to $0.35
Batiatus10: folds
Pocket9s99: folds
Uncalled bet ($0.25) returned to TeamGolden44
TeamGolden44 collected $0.25 from pot
TeamGolden44: doesn't show hand
*** SUMMARY ***
Total pot $0.25 | Rake $0
Seat 1: Pocket9s99 (big blind) folded before Flop
Seat 2: tapouttazz9 folded before Flop (didn't bet)
Seat 3: TeamGolden44 (button) collected ($0.25)
Seat 6: Batiatus10 (small blind) folded before Flop


PokerStars Hand #157132558642:  Hold'em No Limit ($0.05/$0.10 USD) - 2016/08/19 16:16:08 ET
Table 'Xanthippe' 6-max Seat #6 is the button
Seat 1: Pocket9s99 ($7.66 in chips)
Seat 2: tapouttazz9 ($10.94 in chips)
Seat 3: TeamGolden44 ($16.32 in chips)
Seat 6: Batiatus10 ($9.85 in chips)
Pocket9s99: posts small blind $0.05
tapouttazz9: posts big blind $0.10
jvurn: sits out
*** HOLE CARDS ***
Dealt to tapouttazz9 [7d As]
TeamGolden44: folds
Batiatus10: folds
Pocket9s99: calls $0.05
tapouttazz9: checks
*** FLOP *** [9c Js Kd]
Pocket9s99: checks
tapouttazz9: checks
*** TURN *** [9c Js Kd] [8s]
Pocket9s99: checks
tapouttazz9: checks
*** RIVER *** [9c Js Kd 8s] [Qd]
Pocket9s99: checks
tapouttazz9: checks
*** SHOW DOWN ***
Pocket9s99: shows [5c 5d] (a pair of Fives)
tapouttazz9: mucks hand
Pocket9s99 collected $0.19 from pot
*** SUMMARY ***
Total pot $0.20 | Rake $0.01
Board [9c Js Kd 8s Qd]
Seat 1: Pocket9s99 (small blind) showed [5c 5d] and won ($0.19) with a pair of Fives
Seat 2: tapouttazz9 (big blind) mucked [7d As]
Seat 3: TeamGolden44 folded before Flop (didn't bet)
Seat 6: Batiatus10 (button) folded before Flop (didn't bet)


PokerStars Hand #157132558764:  Hold'em No Limit ($0.05/$0.10 USD) - 2016/08/19 16:16:41 ET
Table 'Xanthippe' 6-max Seat #1 is the button
Seat 1: Pocket9s99 ($7.75 in chips)
Seat 2: tapouttazz9 ($10.84 in chips)
Seat 3: TeamGolden44 ($16.32 in chips)
Seat 6: Batiatus10 ($9.85 in chips)
tapouttazz9: posts small blind $0.05
TeamGolden44: posts big blind $0.10
jvurn: sits out
*** HOLE CARDS ***
Dealt to tapouttazz9 [2s 3d]
Batiatus10: folds
Pocket9s99: calls $0.10
tapouttazz9: folds
TeamGolden44: raises $0.20 to $0.30
Pocket9s99: calls $0.20
*** FLOP *** [Qd Kd 2h]
TeamGolden44: checks
RichieS joins the table at seat #4
Pocket9s99: checks
*** TURN *** [Qd Kd 2h] [Ac]
TeamGolden44: checks
Pocket9s99: bets $0.31
TeamGolden44: calls $0.31
*** RIVER *** [Qd Kd 2h Ac] [Jd]
TeamGolden44: checks
Pocket9s99: bets $7.14 and is all-in
TeamGolden44: folds
Uncalled bet ($7.14) returned to Pocket9s99
Pocket9s99 collected $1.21 from pot
*** SUMMARY ***
Total pot $1.27 | Rake $0.06
Board [Qd Kd 2h Ac Jd]
Seat 1: Pocket9s99 (button) collected ($1.21)
Seat 2: tapouttazz9 (small blind) folded before Flop
Seat 3: TeamGolden44 (big blind) folded on the River
Seat 6: Batiatus10 folded before Flop (didn't bet)


PokerStars Hand #157132558931:  Hold'em No Limit ($0.05/$0.10 USD) - 2016/08/19 16:17:26 ET
Table 'Xanthippe' 6-max Seat #2 is the button
Seat 1: Pocket9s99 ($8.35 in chips)
Seat 2: tapouttazz9 ($10.79 in chips)
Seat 3: TeamGolden44 ($15.71 in chips)
Seat 4: RichieS ($10 in chips)
Seat 6: Batiatus10 ($9.85 in chips)
TeamGolden44: posts small blind $0.05
RichieS: posts big blind $0.10
jvurn: sits out
*** HOLE CARDS ***
Dealt to tapouttazz9 [Ac Ad]
Batiatus10 has timed out
Batiatus10: folds
Pocket9s99: folds
tapouttazz9: raises $0.20 to $0.30
TeamGolden44: folds
RichieS: calls $0.20
*** FLOP *** [4c 5d 9d]
RichieS: checks
tapouttazz9: bets $0.31
RichieS: folds
Uncalled bet ($0.31) returned to tapouttazz9
tapouttazz9 collected $0.62 from pot
*** SUMMARY ***
Total pot $0.65 | Rake $0.03
Board [4c 5d 9d]
Seat 1: Pocket9s99 folded before Flop (didn't bet)
Seat 2: tapouttazz9 (button) collected ($0.62)
Seat 3: TeamGolden44 (small blind) folded before Flop
Seat 4: RichieS (big blind) folded on the Flop
Seat 6: Batiatus10 folded before Flop (didn't bet)


PokerStars Hand #157132559075:  Hold'em No Limit ($0.05/$0.10 USD) - 2016/08/19 16:18:04 ET
Table 'Xanthippe' 6-max Seat #3 is the button
Seat 1: Pocket9s99 ($8.35 in chips)
Seat 2: tapouttazz9 ($11.11 in chips)
Seat 3: TeamGolden44 ($15.66 in chips)
Seat 4: RichieS ($9.70 in chips)
Seat 5: jvurn ($6 in chips)
Seat 6: Batiatus10 ($9.85 in chips)
RichieS: posts small blind $0.05
jvurn: posts big blind $0.10
*** HOLE CARDS ***
Dealt to tapouttazz9 [Jc 5d]
Batiatus10: folds
Pocket9s99: calls $0.10
tapouttazz9: folds
TeamGolden44: folds
RichieS: raises $0.20 to $0.30
jvurn: calls $0.20
Pocket9s99: calls $0.20
*** FLOP *** [6h Ts 3s]
RichieS: bets $0.43
jvurn: calls $0.43
Pocket9s99: calls $0.43
*** TURN *** [6h Ts 3s] [Qd]
RichieS: bets $0.50
jvurn: calls $0.50
Pocket9s99: calls $0.50
*** RIVER *** [6h Ts 3s Qd] [3h]
RichieS: checks
jvurn: checks
Pocket9s99: checks
*** SHOW DOWN ***
RichieS: shows [As Tc] (two pair, Tens and Threes)
jvurn: mucks hand
Pocket9s99: mucks hand
RichieS collected $3.51 from pot
*** SUMMARY ***
Total pot $3.69 | Rake $0.18
Board [6h Ts 3s Qd 3h]
Seat 1: Pocket9s99 mucked [4s 7s]
Seat 2: tapouttazz9 folded before Flop (didn't bet)
Seat 3: TeamGolden44 (button) folded before Flop (didn't bet)
Seat 4: RichieS (small blind) showed [As Tc] and won ($3.51) with two pair, Tens and Threes
Seat 5: jvurn (big blind) mucked [9s Kd]
Seat 6: Batiatus10 folded before Flop (didn't bet)


PokerStars Hand #157132559283:  Hold'em No Limit ($0.05/$0.10 USD) - 2016/08/19 16:19:02 ET
Table 'Xanthippe' 6-max Seat #4 is the button
Seat 1: Pocket9s99 ($7.12 in chips)
Seat 2: tapouttazz9 ($11.11 in chips)
Seat 3: TeamGolden44 ($15.66 in chips)
Seat 4: RichieS ($11.98 in chips)
Seat 5: jvurn ($4.77 in chips)
Seat 6: Batiatus10 ($9.85 in chips)
jvurn: posts small blind $0.05
Batiatus10: posts big blind $0.10
*** HOLE CARDS ***
Dealt to tapouttazz9 [7h 6s]
Pocket9s99: raises $0.10 to $0.20
tapouttazz9: folds
TeamGolden44: calls $0.20
RichieS: folds
jvurn: calls $0.15
Batiatus10: calls $0.10
*** FLOP *** [8s 8d 7s]
jvurn: checks
Batiatus10: checks
Pocket9s99: checks
TeamGolden44: checks
*** TURN *** [8s 8d 7s] [2h]
jvurn: checks
Batiatus10: checks
Pocket9s99: checks
TeamGolden44: checks
*** RIVER *** [8s 8d 7s 2h] [4c]
jvurn: bets $0.40
Batiatus10: folds
Pocket9s99: folds
TeamGolden44: folds
Uncalled bet ($0.40) returned to jvurn
jvurn collected $0.76 from pot
jvurn: doesn't show hand
*** SUMMARY ***
Total pot $0.80 | Rake $0.04
Board [8s 8d 7s 2h 4c]
Seat 1: Pocket9s99 folded on the River
Seat 2: tapouttazz9 folded before Flop (didn't bet)
Seat 3: TeamGolden44 folded on the River
Seat 4: RichieS (button) folded before Flop (didn't bet)
Seat 5: jvurn (small blind) collected ($0.76)
Seat 6: Batiatus10 (big blind) folded on the River


PokerStars Hand #157132559478:  Hold'em No Limit ($0.05/$0.10 USD) - 2016/08/19 16:19:50 ET
Table 'Xanthippe' 6-max Seat #5 is the button
Seat 1: Pocket9s99 ($6.92 in chips)
Seat 2: tapouttazz9 ($11.11 in chips)
Seat 3: TeamGolden44 ($15.46 in chips)
Seat 4: RichieS ($11.98 in chips)
Seat 5: jvurn ($5.33 in chips)
Seat 6: Batiatus10 ($9.65 in chips)
Batiatus10: posts small blind $0.05
Pocket9s99: posts big blind $0.10
*** HOLE CARDS ***
Dealt to tapouttazz9 [Qd As]
tapouttazz9: raises $0.20 to $0.30
TeamGolden44: folds
RichieS: folds
jvurn: folds
Batiatus10: folds
Pocket9s99: folds
Uncalled bet ($0.20) returned to tapouttazz9
tapouttazz9 collected $0.25 from pot
*** SUMMARY ***
Total pot $0.25 | Rake $0
Seat 1: Pocket9s99 (big blind) folded before Flop
Seat 2: tapouttazz9 collected ($0.25)
Seat 3: TeamGolden44 folded before Flop (didn't bet)
Seat 4: RichieS folded before Flop (didn't bet)
Seat 5: jvurn (button) folded before Flop (didn't bet)
Seat 6: Batiatus10 (small blind) folded before Flop


PokerStars Hand #157132559531:  Hold'em No Limit ($0.05/$0.10 USD) - 2016/08/19 16:20:05 ET
Table 'Xanthippe' 6-max Seat #6 is the button
Seat 1: Pocket9s99 ($6.82 in chips)
Seat 2: tapouttazz9 ($11.26 in chips)
Seat 3: TeamGolden44 ($15.46 in chips)
Seat 4: RichieS ($11.98 in chips)
Seat 5: jvurn ($5.33 in chips)
Seat 6: Batiatus10 ($9.60 in chips)
Pocket9s99: posts small blind $0.05
tapouttazz9: posts big blind $0.10
*** HOLE CARDS ***
Dealt to tapouttazz9 [5h Js]
TeamGolden44: folds
RichieS: folds
jvurn: folds
Batiatus10: folds
Pocket9s99: raises $0.10 to $0.20
tapouttazz9: folds
Uncalled bet ($0.10) returned to Pocket9s99
Pocket9s99 collected $0.20 from pot
*** SUMMARY ***
Total pot $0.20 | Rake $0
Seat 1: Pocket9s99 (small blind) collected ($0.20)
Seat 2: tapouttazz9 (big blind) folded before Flop
Seat 3: TeamGolden44 folded before Flop (didn't bet)
Seat 4: RichieS folded before Flop (didn't bet)
Seat 5: jvurn folded before Flop (didn't bet)
Seat 6: Batiatus10 (button) folded before Flop (didn't bet)


PokerStars Hand #157132559604:  Hold'em No Limit ($0.05/$0.10 USD) - 2016/08/19 16:20:25 ET
Table 'Xanthippe' 6-max Seat #1 is the button
Seat 1: Pocket9s99 ($6.92 in chips)
Seat 2: tapouttazz9 ($11.16 in chips)
Seat 4: RichieS ($11.98 in chips)
Seat 5: jvurn ($5.33 in chips)
Seat 6: Batiatus10 ($9.60 in chips)
tapouttazz9: posts small blind $0.05
RichieS: posts big blind $0.10
*** HOLE CARDS ***
Dealt to tapouttazz9 [3s Ah]
jvurn: folds
Batiatus10: folds
Pocket9s99: folds
tapouttazz9: folds
Uncalled bet ($0.05) returned to RichieS
RichieS collected $0.10 from pot
RichieS: doesn't show hand
*** SUMMARY ***
Total pot $0.10 | Rake $0
Seat 1: Pocket9s99 (button) folded before Flop (didn't bet)
Seat 2: tapouttazz9 (small blind) folded before Flop
Seat 4: RichieS (big blind) collected ($0.10)
Seat 5: jvurn folded before Flop (didn't bet)
Seat 6: Batiatus10 folded before Flop (didn't bet)


PokerStars Hand #157132559652:  Hold'em No Limit ($0.05/$0.10 USD) - 2016/08/19 16:20:37 ET
Table 'Xanthippe' 6-max Seat #2 is the button
Seat 1: Pocket9s99 ($6.92 in chips)
Seat 2: tapouttazz9 ($11.11 in chips)
Seat 4: RichieS ($12.03 in chips)
Seat 5: jvurn ($5.33 in chips)
Seat 6: Batiatus10 ($9.60 in chips)
RichieS: posts small blind $0.05
jvurn: posts big blind $0.10
*** HOLE CARDS ***
Dealt to tapouttazz9 [As Kh]
Batiatus10: raises $0.15 to $0.25
Pocket9s99: raises $0.15 to $0.40
tapouttazz9: calls $0.40
RichieS: calls $0.35
jvurn: calls $0.30
Batiatus10: calls $0.15
*** FLOP *** [6s 7s Jd]
RichieS: bets $0.30
jvurn: calls $0.30
Batiatus10: calls $0.30
Pocket9s99: folds
tapouttazz9: calls $0.30
*** TURN *** [6s 7s Jd] [3c]
RichieS: bets $0.70
jvurn: raises $3.93 to $4.63 and is all-in
Batiatus10: folds
tapouttazz9: folds
RichieS: calls $3.93
*** RIVER *** [6s 7s Jd 3c] [8s]
*** SHOW DOWN ***
RichieS: shows [Jc Qc] (a pair of Jacks)
jvurn: shows [8c Jh] (two pair, Jacks and Eights)
jvurn collected $11.84 from pot
*** SUMMARY ***
Total pot $12.46 | Rake $0.62
Board [6s 7s Jd 3c 8s]
Seat 1: Pocket9s99 folded on the Flop
Seat 2: tapouttazz9 (button) folded on the Turn
Seat 4: RichieS (small blind) showed [Jc Qc] and lost with a pair of Jacks
Seat 5: jvurn (big blind) showed [8c Jh] and won ($11.84) with two pair, Jacks and Eights
Seat 6: Batiatus10 folded on the Turn


PokerStars Hand #157132559910:  Hold'em No Limit ($0.05/$0.10 USD) - 2016/08/19 16:21:41 ET
Table 'Xanthippe' 6-max Seat #4 is the button
Seat 1: Pocket9s99 ($6.52 in chips)
Seat 2: tapouttazz9 ($10.41 in chips)
Seat 4: RichieS ($6.70 in chips)
Seat 5: jvurn ($11.84 in chips)
Seat 6: Batiatus10 ($8.90 in chips)
jvurn: posts small blind $0.05
Batiatus10: posts big blind $0.10
*** HOLE CARDS ***
Dealt to tapouttazz9 [Qh 2c]
Pocket9s99: folds
tapouttazz9: folds
RichieS: raises $0.20 to $0.30
jvurn: folds
Batiatus10: folds
Uncalled bet ($0.20) returned to RichieS
RichieS collected $0.25 from pot
RichieS: doesn't show hand
*** SUMMARY ***
Total pot $0.25 | Rake $0
Seat 1: Pocket9s99 folded before Flop (didn't bet)
Seat 2: tapouttazz9 folded before Flop (didn't bet)
Seat 4: RichieS (button) collected ($0.25)
Seat 5: jvurn (small blind) folded before Flop
Seat 6: Batiatus10 (big blind) folded before Flop


PokerStars Hand #157132892108:  Hold'em No Limit ($0.05/$0.10 USD) - 2016/08/19 16:22:06 ET
Table 'Xanthippe' 6-max Seat #5 is the button
Seat 1: Pocket9s99 ($6.52 in chips)
Seat 2: tapouttazz9 ($10.41 in chips)
Seat 4: RichieS ($6.85 in chips)
Seat 5: jvurn ($11.79 in chips)
Seat 6: Batiatus10 ($8.80 in chips)
Batiatus10: posts small blind $0.05
Pocket9s99: posts big blind $0.10
*** HOLE CARDS ***
Dealt to tapouttazz9 [Jd Js]
tapouttazz9: raises $0.10 to $0.20
RichieS: folds
jvurn: folds
Batiatus10: folds
Pocket9s99: calls $0.10
*** FLOP *** [Ac 2h 7d]
Pocket9s99: checks
tapouttazz9: checks
*** TURN *** [Ac 2h 7d] [8d]
Pocket9s99: bets $0.21
tapouttazz9: calls $0.21
*** RIVER *** [Ac 2h 7d 8d] [Qs]
Pocket9s99: bets $0.83
tapouttazz9: folds
Uncalled bet ($0.83) returned to Pocket9s99
Pocket9s99 collected $0.83 from pot
*** SUMMARY ***
Total pot $0.87 | Rake $0.04
Board [Ac 2h 7d 8d Qs]
Seat 1: Pocket9s99 (big blind) collected ($0.83)
Seat 2: tapouttazz9 folded on the River
Seat 4: RichieS folded before Flop (didn't bet)
Seat 5: jvurn (button) folded before Flop (didn't bet)
Seat 6: Batiatus10 (small blind) folded before Flop


PokerStars Hand #157135246915:  Hold'em No Limit ($0.05/$0.10 USD) - 2016/08/19 17:35:55 ET
Table 'Feronia' 6-max Seat #1 is the button
Seat 1: lonirules ($10.18 in chips)
Seat 2: clectr157 ($3.80 in chips)
Seat 4: HogPhallus ($5 in chips)
clectr157: posts small blind $0.05
HogPhallus: posts big blind $0.10
SlilperSlope: sits out
*** HOLE CARDS ***
lonirules: calls $0.10
clectr157: calls $0.05
HogPhallus: checks
*** FLOP *** [3s Jd 6s]
clectr157: bets $0.14
HogPhallus: folds
lonirules: calls $0.14
*** TURN *** [3s Jd 6s] [2s]
clectr157: bets $0.27
lonirules: raises $0.27 to $0.54
clectr157: calls $0.27
*** RIVER *** [3s Jd 6s 2s] [4c]
clectr157: bets $0.79
lonirules: folds
Uncalled bet ($0.79) returned to clectr157
clectr157 collected $1.58 from pot
clectr157: doesn't show hand
*** SUMMARY ***
Total pot $1.66 | Rake $0.08
Board [3s Jd 6s 2s 4c]
Seat 1: lonirules (button) folded on the River
Seat 2: clectr157 (small blind) collected ($1.58)
Seat 4: HogPhallus (big blind) folded on the Flop


PokerStars Hand #157135247129:  Hold'em No Limit ($0.05/$0.10 USD) - 2016/08/19 17:36:44 ET
Table 'Feronia' 6-max Seat #2 is the button
Seat 1: lonirules ($9.40 in chips)
Seat 2: clectr157 ($4.60 in chips)
Seat 4: HogPhallus ($4.90 in chips)
Seat 5: SlilperSlope ($4 in chips)
HogPhallus: posts small blind $0.05
SlilperSlope: posts big blind $0.10
*** HOLE CARDS ***
havea69vette joins the table at seat #6
lonirules: folds
clectr157: calls $0.10
HogPhallus: calls $0.05
SlilperSlope: checks
*** FLOP *** [Js Qh 4c]
HogPhallus: bets $0.10
tapouttazz9 joins the table at seat #3
SlilperSlope: calls $0.10
clectr157: calls $0.10
*** TURN *** [Js Qh 4c] [Th]
HogPhallus: checks
SlilperSlope: checks
clectr157: checks
*** RIVER *** [Js Qh 4c Th] [7c]
HogPhallus: checks
SlilperSlope: checks
clectr157: checks
*** SHOW DOWN ***
HogPhallus: shows [Ts 8s] (a pair of Tens)
SlilperSlope: shows [5s Qs] (a pair of Queens)
clectr157: mucks hand
SlilperSlope collected $0.57 from pot
*** SUMMARY ***
Total pot $0.60 | Rake $0.03
Board [Js Qh 4c Th 7c]
Seat 1: lonirules folded before Flop (didn't bet)
Seat 2: clectr157 (button) mucked
Seat 4: HogPhallus (small blind) showed [Ts 8s] and lost with a pair of Tens
Seat 5: SlilperSlope (big blind) showed [5s Qs] and won ($0.57) with a pair of Queens


PokerStars Hand #157135247302:  Hold'em No Limit ($0.05/$0.10 USD) - 2016/08/19 17:37:26 ET
Table 'Feronia' 6-max Seat #4 is the button
Seat 1: lonirules ($9.40 in chips)
Seat 2: clectr157 ($4.40 in chips)
Seat 4: HogPhallus ($4.70 in chips)
Seat 5: SlilperSlope ($4.37 in chips)
Seat 6: havea69vette ($10 in chips)
SlilperSlope: posts small blind $0.05
havea69vette: posts big blind $0.10
tapouttazz9: sits out
*** HOLE CARDS ***
lonirules: calls $0.10
clectr157: calls $0.10
HogPhallus: folds
SlilperSlope: calls $0.05
havea69vette: checks
*** FLOP *** [7c Kc 8h]
SlilperSlope: checks
havea69vette: checks
lonirules: bets $0.10
clectr157: calls $0.10
SlilperSlope: folds
havea69vette: calls $0.10
*** TURN *** [7c Kc 8h] [Ah]
havea69vette: checks
lonirules: checks
clectr157: bets $0.10
havea69vette: calls $0.10
lonirules: calls $0.10
*** RIVER *** [7c Kc 8h Ah] [Kd]
havea69vette: bets $0.47
lonirules: folds
clectr157: folds
Uncalled bet ($0.47) returned to havea69vette
havea69vette collected $0.95 from pot
havea69vette: doesn't show hand
*** SUMMARY ***
Total pot $1 | Rake $0.05
Board [7c Kc 8h Ah Kd]
Seat 1: lonirules folded on the River
Seat 2: clectr157 folded on the River
Seat 4: HogPhallus (button) folded before Flop (didn't bet)
Seat 5: SlilperSlope (small blind) folded on the Flop
Seat 6: havea69vette (big blind) collected ($0.95)


PokerStars Hand #157135247672:  Hold'em No Limit ($0.05/$0.10 USD) - 2016/08/19 17:38:51 ET
Table 'Feronia' 6-max Seat #5 is the button
Seat 1: lonirules ($9.10 in chips)
Seat 2: clectr157 ($4.10 in chips)
Seat 4: HogPhallus ($4.70 in chips)
Seat 5: SlilperSlope ($4.27 in chips)
Seat 6: havea69vette ($10.65 in chips)
havea69vette: posts small blind $0.05
lonirules: posts big blind $0.10
tapouttazz9: sits out
*** HOLE CARDS ***
clectr157: calls $0.10
HogPhallus: folds
SlilperSlope: folds
havea69vette: folds
lonirules: checks
*** FLOP *** [7d 4s 2c]
lonirules: checks
clectr157: bets $0.12
lonirules: folds
Uncalled bet ($0.12) returned to clectr157
clectr157 collected $0.24 from pot
clectr157: doesn't show hand
*** SUMMARY ***
Total pot $0.25 | Rake $0.01
Board [7d 4s 2c]
Seat 1: lonirules (big blind) folded on the Flop
Seat 2: clectr157 collected ($0.24)
Seat 4: HogPhallus folded before Flop (didn't bet)
Seat 5: SlilperSlope (button) folded before Flop (didn't bet)
Seat 6: havea69vette (small blind) folded before Flop


PokerStars Hand #157135247792:  Hold'em No Limit ($0.05/$0.10 USD) - 2016/08/19 17:39:17 ET
Table 'Feronia' 6-max Seat #6 is the button
Seat 1: lonirules ($9 in chips)
Seat 2: clectr157 ($4.24 in chips)
Seat 4: HogPhallus ($4.70 in chips)
Seat 5: SlilperSlope ($4.27 in chips)
Seat 6: havea69vette ($10.60 in chips)
lonirules: posts small blind $0.05
clectr157: posts big blind $0.10
tapouttazz9: sits out
*** HOLE CARDS ***
HogPhallus: calls $0.10
SlilperSlope: calls $0.10
havea69vette: folds
lonirules: folds
clectr157: checks
*** FLOP *** [Qh 2d 6s]
clectr157: checks
HogPhallus: checks
SlilperSlope: bets $0.20
clectr157: folds
HogPhallus: calls $0.20
*** TURN *** [Qh 2d 6s] [8h]
HogPhallus: bets $0.70
SlilperSlope: calls $0.70
*** RIVER *** [Qh 2d 6s 8h] [4c]
HogPhallus: bets $2
SlilperSlope: folds
Uncalled bet ($2) returned to HogPhallus
HogPhallus collected $2.04 from pot
*** SUMMARY ***
Total pot $2.15 | Rake $0.11
Board [Qh 2d 6s 8h 4c]
Seat 1: lonirules (small blind) folded before Flop
Seat 2: clectr157 (big blind) folded on the Flop
Seat 4: HogPhallus collected ($2.04)
Seat 5: SlilperSlope folded on the River
Seat 6: havea69vette (button) folded before Flop (didn't bet)


PokerStars Hand #157135248190:  Hold'em No Limit ($0.05/$0.10 USD) - 2016/08/19 17:40:48 ET
Table 'Feronia' 6-max Seat #1 is the button
Seat 1: lonirules ($8.95 in chips)
Seat 2: clectr157 ($4.14 in chips)
Seat 3: tapouttazz9 ($10 in chips)
Seat 4: HogPhallus ($5.74 in chips)
Seat 5: SlilperSlope ($3.27 in chips)
Seat 6: havea69vette ($10.60 in chips)
clectr157: posts small blind $0.05
tapouttazz9: posts big blind $0.10
*** HOLE CARDS ***
Dealt to tapouttazz9 [Js Td]
HogPhallus: folds
SlilperSlope: folds
havea69vette: raises $0.25 to $0.35
lonirules: folds
clectr157: calls $0.30
tapouttazz9: calls $0.25
*** FLOP *** [7c 6s 2s]
clectr157: checks
tapouttazz9: bets $0.50
havea69vette: raises $2 to $2.50
clectr157: folds
tapouttazz9: folds
Uncalled bet ($2) returned to havea69vette
havea69vette collected $1.95 from pot
havea69vette: doesn't show hand
*** SUMMARY ***
Total pot $2.05 | Rake $0.10
Board [7c 6s 2s]
Seat 1: lonirules (button) folded before Flop (didn't bet)
Seat 2: clectr157 (small blind) folded on the Flop
Seat 3: tapouttazz9 (big blind) folded on the Flop
Seat 4: HogPhallus folded before Flop (didn't bet)
Seat 5: SlilperSlope folded before Flop (didn't bet)
Seat 6: havea69vette collected ($1.95)


PokerStars Hand #157135248452:  Hold'em No Limit ($0.05/$0.10 USD) - 2016/08/19 17:41:47 ET
Table 'Feronia' 6-max Seat #2 is the button
Seat 1: lonirules ($8.95 in chips)
Seat 2: clectr157 ($3.79 in chips)
Seat 3: tapouttazz9 ($9.15 in chips)
Seat 4: HogPhallus ($5.74 in chips)
Seat 5: SlilperSlope ($3.27 in chips)
Seat 6: havea69vette ($11.70 in chips)
tapouttazz9: posts small blind $0.05
HogPhallus: posts big blind $0.10
*** HOLE CARDS ***
Dealt to tapouttazz9 [4s 3h]
SlilperSlope: folds
havea69vette: folds
lonirules: calls $0.10
clectr157: raises $0.10 to $0.20
tapouttazz9: folds
HogPhallus: calls $0.10
lonirules: calls $0.10
*** FLOP *** [Ts Qh 2h]
HogPhallus: checks
lonirules: bets $0.30
clectr157: calls $0.30
HogPhallus: folds
*** TURN *** [Ts Qh 2h] [5d]
lonirules: bets $0.60
clectr157: calls $0.60
*** RIVER *** [Ts Qh 2h 5d] [Qs]
lonirules: bets $1.20
clectr157: folds
Uncalled bet ($1.20) returned to lonirules
lonirules collected $2.33 from pot
lonirules: doesn't show hand
*** SUMMARY ***
Total pot $2.45 | Rake $0.12
Board [Ts Qh 2h 5d Qs]
Seat 1: lonirules collected ($2.33)
Seat 2: clectr157 (button) folded on the River
Seat 3: tapouttazz9 (small blind) folded before Flop
Seat 4: HogPhallus (big blind) folded on the Flop
Seat 5: SlilperSlope folded before Flop (didn't bet)
Seat 6: havea69vette folded before Flop (didn't bet)


PokerStars Hand #157135248773:  Hold'em No Limit ($0.05/$0.10 USD) - 2016/08/19 17:42:59 ET
Table 'Feronia' 6-max Seat #3 is the button
Seat 1: lonirules ($10.18 in chips)
Seat 2: clectr157 ($2.69 in chips)
Seat 3: tapouttazz9 ($9.10 in chips)
Seat 4: HogPhallus ($5.54 in chips)
Seat 5: SlilperSlope ($3.27 in chips)
Seat 6: havea69vette ($11.70 in chips)
HogPhallus: posts small blind $0.05
SlilperSlope: posts big blind $0.10
*** HOLE CARDS ***
Dealt to tapouttazz9 [3h Jh]
havea69vette: raises $0.25 to $0.35
lonirules: folds
clectr157: calls $0.35
tapouttazz9: folds
HogPhallus: folds
SlilperSlope: folds
*** FLOP *** [8d 9d 3c]
havea69vette: checks
clectr157: checks
*** TURN *** [8d 9d 3c] [4c]
havea69vette: checks
clectr157: bets $0.40
havea69vette: folds
Uncalled bet ($0.40) returned to clectr157
clectr157 collected $0.81 from pot
clectr157: doesn't show hand
*** SUMMARY ***
Total pot $0.85 | Rake $0.04
Board [8d 9d 3c 4c]
Seat 1: lonirules folded before Flop (didn't bet)
Seat 2: clectr157 collected ($0.81)
Seat 3: tapouttazz9 (button) folded before Flop (didn't bet)
Seat 4: HogPhallus (small blind) folded before Flop
Seat 5: SlilperSlope (big blind) folded before Flop
Seat 6: havea69vette folded on the Turn


PokerStars Hand #157135248932:  Hold'em No Limit ($0.05/$0.10 USD) - 2016/08/19 17:43:35 ET
Table 'Feronia' 6-max Seat #4 is the button
Seat 1: lonirules ($10.18 in chips)
Seat 2: clectr157 ($3.15 in chips)
Seat 3: tapouttazz9 ($9.10 in chips)
Seat 4: HogPhallus ($5.49 in chips)
Seat 5: SlilperSlope ($3.17 in chips)
Seat 6: havea69vette ($11.35 in chips)
SlilperSlope: posts small blind $0.05
havea69vette: posts big blind $0.10
*** HOLE CARDS ***
Dealt to tapouttazz9 [2s Js]
lonirules: folds
clectr157: calls $0.10
tapouttazz9: folds
HogPhallus: calls $0.10
SlilperSlope: calls $0.05
havea69vette: checks
*** FLOP *** [5c 7h Jh]
SlilperSlope: checks
havea69vette: checks
clectr157: checks
HogPhallus: checks
*** TURN *** [5c 7h Jh] [Kh]
SlilperSlope: checks
havea69vette: checks
clectr157: checks
HogPhallus: bets $0.10
SlilperSlope: folds
havea69vette: folds
clectr157: calls $0.10
*** RIVER *** [5c 7h Jh Kh] [Th]
clectr157: checks
HogPhallus: bets $0.60
clectr157: folds
Uncalled bet ($0.60) returned to HogPhallus
HogPhallus collected $0.57 from pot
*** SUMMARY ***
Total pot $0.60 | Rake $0.03
Board [5c 7h Jh Kh Th]
Seat 1: lonirules folded before Flop (didn't bet)
Seat 2: clectr157 folded on the River
Seat 3: tapouttazz9 folded before Flop (didn't bet)
Seat 4: HogPhallus (button) collected ($0.57)
Seat 5: SlilperSlope (small blind) folded on the Turn
Seat 6: havea69vette (big blind) folded on the Turn


PokerStars Hand #157135249369:  Hold'em No Limit ($0.05/$0.10 USD) - 2016/08/19 17:45:10 ET
Table 'Feronia' 6-max Seat #5 is the button
Seat 1: lonirules ($10.18 in chips)
Seat 2: clectr157 ($2.95 in chips)
Seat 3: tapouttazz9 ($9.10 in chips)
Seat 4: HogPhallus ($5.86 in chips)
Seat 5: SlilperSlope ($3.07 in chips)
Seat 6: havea69vette ($11.25 in chips)
havea69vette: posts small blind $0.05
lonirules: posts big blind $0.10
*** HOLE CARDS ***
Dealt to tapouttazz9 [7h 4c]
clectr157: calls $0.10
tapouttazz9: folds
HogPhallus: folds
SlilperSlope: raises $0.30 to $0.40
HogPhallus leaves the table
havea69vette: folds
lonirules: folds
clectr157: folds
Uncalled bet ($0.30) returned to SlilperSlope
SlilperSlope collected $0.35 from pot
SlilperSlope: doesn't show hand
*** SUMMARY ***
Total pot $0.35 | Rake $0
Seat 1: lonirules (big blind) folded before Flop
Seat 2: clectr157 folded before Flop
Seat 3: tapouttazz9 folded before Flop (didn't bet)
Seat 4: HogPhallus folded before Flop (didn't bet)
Seat 5: SlilperSlope (button) collected ($0.35)
Seat 6: havea69vette (small blind) folded before Flop


PokerStars Hand #157135249586:  Hold'em No Limit ($0.05/$0.10 USD) - 2016/08/19 17:45:59 ET
Table 'Feronia' 6-max Seat #6 is the button
Seat 1: lonirules ($10.08 in chips)
Seat 2: clectr157 ($2.85 in chips)
Seat 3: tapouttazz9 ($9.10 in chips)
Seat 5: SlilperSlope ($3.32 in chips)
Seat 6: havea69vette ($11.20 in chips)
lonirules: posts small blind $0.05
clectr157: posts big blind $0.10
*** HOLE CARDS ***
Dealt to tapouttazz9 [7s Jc]
tapouttazz9: folds
SlilperSlope: folds
havea69vette: folds
lonirules: raises $0.10 to $0.20
clectr157: raises $0.10 to $0.30
lonirules: calls $0.10
*** FLOP *** [6c 5s Qc]
Apt1a joins the table at seat #4
lonirules: checks
clectr157: checks
*** TURN *** [6c 5s Qc] [2s]
lonirules: checks
clectr157: checks
*** RIVER *** [6c 5s Qc 2s] [Ad]
lonirules: bets $0.30
SlilperSlope is disconnected
clectr157: calls $0.30
*** SHOW DOWN ***
lonirules: shows [6d 4d] (a pair of Sixes)
clectr157: mucks hand
lonirules collected $1.14 from pot
*** SUMMARY ***
Total pot $1.20 | Rake $0.06
Board [6c 5s Qc 2s Ad]
Seat 1: lonirules (small blind) showed [6d 4d] and won ($1.14) with a pair of Sixes
Seat 2: clectr157 (big blind) mucked [7d Kd]
Seat 3: tapouttazz9 folded before Flop (didn't bet)
Seat 5: SlilperSlope folded before Flop (didn't bet)
Seat 6: havea69vette (button) folded before Flop (didn't bet)


PokerStars Hand #157135249832:  Hold'em No Limit ($0.05/$0.10 USD) - 2016/08/19 17:46:59 ET
Table 'Feronia' 6-max Seat #1 is the button
Seat 1: lonirules ($10.62 in chips)
Seat 2: clectr157 ($2.25 in chips)
Seat 3: tapouttazz9 ($9.10 in chips)
Seat 5: SlilperSlope ($3.32 in chips)
Seat 6: havea69vette ($11.20 in chips)
clectr157: posts small blind $0.05
tapouttazz9: posts big blind $0.10
*** HOLE CARDS ***
Dealt to tapouttazz9 [Ts Ah]
SlilperSlope: calls $0.10
havea69vette: raises $0.35 to $0.45
lonirules: folds
Apt1a is disconnected
clectr157: calls $0.40
tapouttazz9: calls $0.35
SlilperSlope: calls $0.35
*** FLOP *** [3c Tc 7s]
clectr157: checks
tapouttazz9: bets $0.85
SlilperSlope: calls $0.85
havea69vette: calls $0.85
clectr157: folds
*** TURN *** [3c Tc 7s] [2h]
tapouttazz9: checks
SlilperSlope is disconnected
SlilperSlope is connected
tapouttazz9 said, "all in vet"
SlilperSlope: bets $2.02 and is all-in
havea69vette: calls $2.02
tapouttazz9: calls $2.02
*** RIVER *** [3c Tc 7s 2h] [6h]
tapouttazz9: checks
havea69vette: checks
*** SHOW DOWN ***
tapouttazz9: shows [Ts Ah] (a pair of Tens)
SlilperSlope: mucks hand
havea69vette: mucks hand
tapouttazz9 collected $9.89 from pot
*** SUMMARY ***
Total pot $10.41 | Rake $0.52
Board [3c Tc 7s 2h 6h]
Seat 1: lonirules (button) folded before Flop (didn't bet)
Seat 2: clectr157 (small blind) folded on the Flop
Seat 3: tapouttazz9 (big blind) showed [Ts Ah] and won ($9.89) with a pair of Tens
Seat 5: SlilperSlope mucked [9d Td]
Seat 6: havea69vette mucked [Qc Kc]


PokerStars Hand #157137406262:  Hold'em No Limit ($0.05/$0.10 USD) - 2016/08/19 17:49:04 ET
Table 'Feronia' 6-max Seat #2 is the button
Seat 1: lonirules ($10.62 in chips)
Seat 2: clectr157 ($1.80 in chips)
Seat 3: tapouttazz9 ($15.67 in chips)
Seat 4: Apt1a ($10 in chips)
Seat 6: havea69vette ($10 in chips)
tapouttazz9: posts small blind $0.05
Apt1a: posts big blind $0.10
*** HOLE CARDS ***
Dealt to tapouttazz9 [Ah 2h]
havea69vette: folds
lonirules: folds
tapouttazz9 said, "thanks for the cheese"
clectr157: calls $0.10
tapouttazz9: calls $0.05
Apt1a: checks
*** FLOP *** [5c Td As]
tapouttazz9: checks
Apt1a: bets $0.15
clectr157: folds
tapouttazz9: calls $0.15
*** TURN *** [5c Td As] [5s]
tapouttazz9: checks
Apt1a: bets $0.45
tapouttazz9: calls $0.45
*** RIVER *** [5c Td As 5s] [9c]
tapouttazz9: checks
Apt1a: checks
*** SHOW DOWN ***
tapouttazz9: shows [Ah 2h] (two pair, Aces and Fives)
Apt1a: mucks hand
tapouttazz9 collected $1.42 from pot
*** SUMMARY ***
Total pot $1.50 | Rake $0.08
Board [5c Td As 5s 9c]
Seat 1: lonirules folded before Flop (didn't bet)
Seat 2: clectr157 (button) folded on the Flop
Seat 3: tapouttazz9 (small blind) showed [Ah 2h] and won ($1.42) with two pair, Aces and Fives
Seat 4: Apt1a (big blind) mucked [Ts 4d]
Seat 6: havea69vette folded before Flop (didn't bet)


PokerStars Hand #157137406572:  Hold'em No Limit ($0.05/$0.10 USD) - 2016/08/19 17:50:19 ET
Table 'Feronia' 6-max Seat #3 is the button
Seat 1: lonirules ($10.62 in chips)
Seat 2: clectr157 ($1.70 in chips)
Seat 3: tapouttazz9 ($16.39 in chips)
Seat 4: Apt1a ($9.30 in chips)
Seat 5: SlilperSlope ($4 in chips)
Seat 6: havea69vette ($10 in chips)
Apt1a: posts small blind $0.05
SlilperSlope: posts big blind $0.10
*** HOLE CARDS ***
Dealt to tapouttazz9 [As Js]
havea69vette: folds
lonirules: folds
clectr157: calls $0.10
tapouttazz9: raises $0.20 to $0.30
Apt1a: folds
SlilperSlope: folds
clectr157: calls $0.20
*** FLOP *** [4d 9s 8d]
clectr157: checks
tapouttazz9: bets $0.35
clectr157: folds
Uncalled bet ($0.35) returned to tapouttazz9
tapouttazz9 collected $0.71 from pot
*** SUMMARY ***
Total pot $0.75 | Rake $0.04
Board [4d 9s 8d]
Seat 1: lonirules folded before Flop (didn't bet)
Seat 2: clectr157 folded on the Flop
Seat 3: tapouttazz9 (button) collected ($0.71)
Seat 4: Apt1a (small blind) folded before Flop
Seat 5: SlilperSlope (big blind) folded before Flop
Seat 6: havea69vette folded before Flop (didn't bet)


PokerStars Hand #157166347963:  Hold'em No Limit ($0.05/$0.10 USD) - 2016/08/20 6:58:17 ET
Table 'Ate' 6-max Seat #6 is the button
Seat 3: Lowbid2 ($7.06 in chips)
Seat 4: PorkChop87 ($12.39 in chips)
Seat 6: 1gmguy15 ($5.66 in chips)
Lowbid2: posts small blind $0.05
PorkChop87: posts big blind $0.10
*** HOLE CARDS ***
1gmguy15: folds
Lowbid2: folds
Uncalled bet ($0.05) returned to PorkChop87
PorkChop87 collected $0.10 from pot
PorkChop87: doesn't show hand
*** SUMMARY ***
Total pot $0.10 | Rake $0
Seat 3: Lowbid2 (small blind) folded before Flop
Seat 4: PorkChop87 (big blind) collected ($0.10)
Seat 6: 1gmguy15 (button) folded before Flop (didn't bet)


PokerStars Hand #157166347972:  Hold'em No Limit ($0.05/$0.10 USD) - 2016/08/20 6:58:23 ET
Table 'Ate' 6-max Seat #3 is the button
Seat 3: Lowbid2 ($7.01 in chips)
Seat 4: PorkChop87 ($12.44 in chips)
Seat 6: 1gmguy15 ($5.66 in chips)
PorkChop87: posts small blind $0.05
1gmguy15: posts big blind $0.10
*** HOLE CARDS ***
Lowbid2: folds
PorkChop87: calls $0.05
1gmguy15: raises $0.20 to $0.30
tapouttazz9 joins the table at seat #2
PorkChop87: calls $0.20
*** FLOP *** [Ks 9d 3d]
PorkChop87: checks
1gmguy15: bets $0.28
PorkChop87: folds
Uncalled bet ($0.28) returned to 1gmguy15
1gmguy15 collected $0.57 from pot
1gmguy15: doesn't show hand
*** SUMMARY ***
Total pot $0.60 | Rake $0.03
Board [Ks 9d 3d]
Seat 3: Lowbid2 (button) folded before Flop (didn't bet)
Seat 4: PorkChop87 (small blind) folded on the Flop
Seat 6: 1gmguy15 (big blind) collected ($0.57)


PokerStars Hand #157166348007:  Hold'em No Limit ($0.05/$0.10 USD) - 2016/08/20 6:58:46 ET
Table 'Ate' 6-max Seat #4 is the button
Seat 2: tapouttazz9 ($10 in chips)
Seat 3: Lowbid2 ($7.01 in chips)
Seat 4: PorkChop87 ($12.14 in chips)
Seat 6: 1gmguy15 ($5.93 in chips)
1gmguy15: posts small blind $0.05
tapouttazz9: posts big blind $0.10
*** HOLE CARDS ***
Dealt to tapouttazz9 [6d Ad]
Lowbid2: folds
PorkChop87: calls $0.10
1gmguy15: folds
tapouttazz9: checks
*** FLOP *** [8h Ts Qd]
tapouttazz9: checks
PorkChop87: checks
*** TURN *** [8h Ts Qd] [9d]
tapouttazz9: bets $0.20
PorkChop87: calls $0.20
*** RIVER *** [8h Ts Qd 9d] [4d]
tapouttazz9: bets $0.70
PorkChop87: folds
Uncalled bet ($0.70) returned to tapouttazz9
tapouttazz9 collected $0.62 from pot
*** SUMMARY ***
Total pot $0.65 | Rake $0.03
Board [8h Ts Qd 9d 4d]
Seat 2: tapouttazz9 (big blind) collected ($0.62)
Seat 3: Lowbid2 folded before Flop (didn't bet)
Seat 4: PorkChop87 (button) folded on the River
Seat 6: 1gmguy15 (small blind) folded before Flop


PokerStars Hand #157166348062:  Hold'em No Limit ($0.05/$0.10 USD) - 2016/08/20 6:59:20 ET
Table 'Ate' 6-max Seat #6 is the button
Seat 2: tapouttazz9 ($10.32 in chips)
Seat 3: Lowbid2 ($7.01 in chips)
Seat 4: PorkChop87 ($11.84 in chips)
Seat 6: 1gmguy15 ($5.88 in chips)
tapouttazz9: posts small blind $0.05
Lowbid2: posts big blind $0.10
*** HOLE CARDS ***
Dealt to tapouttazz9 [Kh 4s]
PorkChop87: raises $0.10 to $0.20
1gmguy15: calls $0.20
tapouttazz9: folds
Lowbid2: calls $0.10
*** FLOP *** [2c 9d Ts]
Lowbid2: checks
PorkChop87: bets $0.30
1gmguy15: calls $0.30
Lowbid2: folds
*** TURN *** [2c 9d Ts] [Ah]
PorkChop87: bets $0.60
1gmguy15: folds
Uncalled bet ($0.60) returned to PorkChop87
PorkChop87 collected $1.19 from pot
PorkChop87: doesn't show hand
*** SUMMARY ***
Total pot $1.25 | Rake $0.06
Board [2c 9d Ts Ah]
Seat 2: tapouttazz9 (small blind) folded before Flop
Seat 3: Lowbid2 (big blind) folded on the Flop
Seat 4: PorkChop87 collected ($1.19)
Seat 6: 1gmguy15 (button) folded on the Turn


PokerStars Hand #157166348101:  Hold'em No Limit ($0.05/$0.10 USD) - 2016/08/20 6:59:44 ET
Table 'Ate' 6-max Seat #2 is the button
Seat 2: tapouttazz9 ($10.27 in chips)
Seat 3: Lowbid2 ($6.81 in chips)
Seat 4: PorkChop87 ($12.53 in chips)
Seat 6: 1gmguy15 ($5.38 in chips)
Lowbid2: posts small blind $0.05
PorkChop87: posts big blind $0.10
*** HOLE CARDS ***
Dealt to tapouttazz9 [Jd Qc]
1gmguy15: folds
1gmguy15 leaves the table
tapouttazz9: raises $0.10 to $0.20
Lowbid2: calls $0.15
PorkChop87: raises $0.10 to $0.30
tapouttazz9: calls $0.10
Lowbid2: calls $0.10
*** FLOP *** [Qs 3s Jh]
Lowbid2: checks
PorkChop87: checks
tapouttazz9: bets $0.43
Lowbid2: folds
PorkChop87: calls $0.43
*** TURN *** [Qs 3s Jh] [4s]
PorkChop87: checks
tapouttazz9: checks
*** RIVER *** [Qs 3s Jh 4s] [3c]
PorkChop87: checks
tapouttazz9: bets $0.40
PorkChop87: folds
Uncalled bet ($0.40) returned to tapouttazz9
tapouttazz9 collected $1.67 from pot
*** SUMMARY ***
Total pot $1.76 | Rake $0.09
Board [Qs 3s Jh 4s 3c]
Seat 2: tapouttazz9 (button) collected ($1.67)
Seat 3: Lowbid2 (small blind) folded on the Flop
Seat 4: PorkChop87 (big blind) folded on the River
Seat 6: 1gmguy15 folded before Flop (didn't bet)


PokerStars Hand #157166348174:  Hold'em No Limit ($0.05/$0.10 USD) - 2016/08/20 7:00:30 ET
Table 'Ate' 6-max Seat #3 is the button
Seat 2: tapouttazz9 ($11.21 in chips)
Seat 3: Lowbid2 ($6.51 in chips)
Seat 4: PorkChop87 ($11.80 in chips)
PorkChop87: posts small blind $0.05
tapouttazz9: posts big blind $0.10
*** HOLE CARDS ***
Dealt to tapouttazz9 [Qh 9d]
Lowbid2: calls $0.10
PorkChop87: calls $0.05
tapouttazz9: checks
*** FLOP *** [Ks 2c 4h]
PorkChop87: bets $0.10
tapouttazz9: folds
Lowbid2: calls $0.10
*** TURN *** [Ks 2c 4h] [3s]
PorkChop87: bets $0.20
Lowbid2: calls $0.20
*** RIVER *** [Ks 2c 4h 3s] [9s]
PorkChop87: bets $0.40
Lowbid2: calls $0.40
*** SHOW DOWN ***
PorkChop87: shows [8d Kc] (a pair of Kings)
Lowbid2: mucks hand
PorkChop87 collected $1.62 from pot
*** SUMMARY ***
Total pot $1.70 | Rake $0.08
Board [Ks 2c 4h 3s 9s]
Seat 2: tapouttazz9 (big blind) folded on the Flop
Seat 3: Lowbid2 (button) mucked [As Jh]
Seat 4: PorkChop87 (small blind) showed [8d Kc] and won ($1.62) with a pair of Kings


PokerStars Hand #157167389959:  Hold'em No Limit ($0.05/$0.10 USD) - 2016/08/20 10:16:42 ET
Table 'Ate' 6-max Seat #3 is the button
Seat 1: jvurn ($4.66 in chips)
Seat 3: lonirules ($20.17 in chips)
Seat 4: TeamGolden44 ($9.55 in chips)
Seat 5: Noplits ($9.08 in chips)
TeamGolden44: posts small blind $0.05
Noplits: posts big blind $0.10
*** HOLE CARDS ***
jvurn: raises $0.20 to $0.30
tapouttazz9 joins the table at seat #6
lonirules: calls $0.30
TeamGolden44: folds
Noplits: calls $0.20
*** FLOP *** [Qh 5s Jc]
Noplits: bets $0.40
jvurn: calls $0.40
lonirules: calls $0.40
*** TURN *** [Qh 5s Jc] [Ts]
Noplits: checks
jvurn: bets $1
lonirules: calls $1
Noplits: calls $1
*** RIVER *** [Qh 5s Jc Ts] [7s]
Noplits: checks
jvurn: bets $2.96 and is all-in
lonirules: folds
Noplits: calls $2.96
*** SHOW DOWN ***
jvurn: shows [Kh 3h] (high card King)
Noplits: shows [Js Qc] (two pair, Queens and Jacks)
Noplits collected $10.52 from pot
*** SUMMARY ***
Total pot $11.07 | Rake $0.55
Board [Qh 5s Jc Ts 7s]
Seat 1: jvurn showed [Kh 3h] and lost with high card King
Seat 3: lonirules (button) folded on the River
Seat 4: TeamGolden44 (small blind) folded before Flop
Seat 5: Noplits (big blind) showed [Js Qc] and won ($10.52) with two pair, Queens and Jacks


PokerStars Hand #157167731113:  Hold'em No Limit ($0.05/$0.10 USD) - 2016/08/20 10:18:16 ET
Table 'Ate' 6-max Seat #4 is the button
Seat 3: lonirules ($18.47 in chips)
Seat 4: TeamGolden44 ($9.50 in chips)
Seat 5: Noplits ($14.94 in chips)
Seat 6: tapouttazz9 ($10 in chips)
Noplits: posts small blind $0.05
tapouttazz9: posts big blind $0.10
BBaker223: sits out
*** HOLE CARDS ***
Dealt to tapouttazz9 [3h 6c]
jvurn leaves the table
lonirules has timed out
lonirules: folds
TeamGolden44: raises $0.25 to $0.35
Noplits: folds
tapouttazz9: folds
Uncalled bet ($0.25) returned to TeamGolden44
TeamGolden44 collected $0.25 from pot
TeamGolden44: doesn't show hand
*** SUMMARY ***
Total pot $0.25 | Rake $0
Seat 3: lonirules folded before Flop (didn't bet)
Seat 4: TeamGolden44 (button) collected ($0.25)
Seat 5: Noplits (small blind) folded before Flop
Seat 6: tapouttazz9 (big blind) folded before Flop


PokerStars Hand #157167731212:  Hold'em No Limit ($0.05/$0.10 USD) - 2016/08/20 10:18:51 ET
Table 'Ate' 6-max Seat #5 is the button
Seat 2: BBaker223 ($9.90 in chips)
Seat 3: lonirules ($18.47 in chips)
Seat 4: TeamGolden44 ($9.65 in chips)
Seat 5: Noplits ($14.89 in chips)
Seat 6: tapouttazz9 ($9.90 in chips)
tapouttazz9: posts small blind $0.05
BBaker223: posts big blind $0.10
*** HOLE CARDS ***
Dealt to tapouttazz9 [Tc 6c]
lonirules: calls $0.10
TeamGolden44: folds
Noplits: folds
tapouttazz9: folds
rpb9999 joins the table at seat #1
BBaker223: checks
*** FLOP *** [2h Js Td]
BBaker223: checks
lonirules: bets $0.20
BBaker223: calls $0.20
*** TURN *** [2h Js Td] [5h]
BBaker223: checks
lonirules: checks
*** RIVER *** [2h Js Td 5h] [3d]
BBaker223: bets $0.50
lonirules: folds
Uncalled bet ($0.50) returned to BBaker223
BBaker223 collected $0.62 from pot
*** SUMMARY ***
Total pot $0.65 | Rake $0.03
Board [2h Js Td 5h 3d]
Seat 2: BBaker223 (big blind) collected ($0.62)
Seat 3: lonirules folded on the River
Seat 4: TeamGolden44 folded before Flop (didn't bet)
Seat 5: Noplits (button) folded before Flop (didn't bet)
Seat 6: tapouttazz9 (small blind) folded before Flop


PokerStars Hand #157167731409:  Hold'em No Limit ($0.05/$0.10 USD) - 2016/08/20 10:20:06 ET
Table 'Ate' 6-max Seat #6 is the button
Seat 2: BBaker223 ($10.22 in chips)
Seat 3: lonirules ($18.17 in chips)
Seat 4: TeamGolden44 ($9.65 in chips)
Seat 5: Noplits ($14.89 in chips)
Seat 6: tapouttazz9 ($9.85 in chips)
rpb9999 will be allowed to play after the button
BBaker223: posts small blind $0.05
lonirules: posts big blind $0.10
*** HOLE CARDS ***
Dealt to tapouttazz9 [3d Qs]
TeamGolden44: raises $0.25 to $0.35
Noplits: folds
tapouttazz9: folds
BBaker223: folds
lonirules: folds
Uncalled bet ($0.25) returned to TeamGolden44
TeamGolden44 collected $0.25 from pot
TeamGolden44: doesn't show hand
*** SUMMARY ***
Total pot $0.25 | Rake $0
Seat 2: BBaker223 (small blind) folded before Flop
Seat 3: lonirules (big blind) folded before Flop
Seat 4: TeamGolden44 collected ($0.25)
Seat 5: Noplits folded before Flop (didn't bet)
Seat 6: tapouttazz9 (button) folded before Flop (didn't bet)


PokerStars Hand #157167731455:  Hold'em No Limit ($0.05/$0.10 USD) - 2016/08/20 10:20:22 ET
Table 'Ate' 6-max Seat #3 is the button
Seat 3: lonirules ($18.07 in chips)
Seat 4: TeamGolden44 ($9.80 in chips)
Seat 5: Noplits ($14.89 in chips)
Seat 6: tapouttazz9 ($9.85 in chips)
TeamGolden44: posts small blind $0.05
Noplits: posts big blind $0.10
rpb9999: sits out
*** HOLE CARDS ***
Dealt to tapouttazz9 [Qh 4d]
tapouttazz9: folds
BBaker223 leaves the table
lonirules: folds
TeamGolden44: raises $0.20 to $0.30
Noplits: calls $0.20
*** FLOP *** [3s 9d 3d]
TeamGolden44: checks
Noplits: checks
*** TURN *** [3s 9d 3d] [6s]
TeamGolden44: bets $0.57
Noplits: folds
Uncalled bet ($0.57) returned to TeamGolden44
TeamGolden44 collected $0.57 from pot
TeamGolden44: doesn't show hand
*** SUMMARY ***
Total pot $0.60 | Rake $0.03
Board [3s 9d 3d 6s]
Seat 3: lonirules (button) folded before Flop (didn't bet)
Seat 4: TeamGolden44 (small blind) collected ($0.57)
Seat 5: Noplits (big blind) folded on the Turn
Seat 6: tapouttazz9 folded before Flop (didn't bet)


PokerStars Hand #157167731599:  Hold'em No Limit ($0.05/$0.10 USD) - 2016/08/20 10:21:19 ET
Table 'Ate' 6-max Seat #4 is the button
Seat 3: lonirules ($18.07 in chips)
Seat 4: TeamGolden44 ($10.07 in chips)
Seat 5: Noplits ($14.59 in chips)
Seat 6: tapouttazz9 ($9.85 in chips)
Noplits: posts small blind $0.05
tapouttazz9: posts big blind $0.10
rpb9999: sits out
*** HOLE CARDS ***
Dealt to tapouttazz9 [Jd Qs]
lonirules: calls $0.10
TeamGolden44: folds
Noplits: raises $0.10 to $0.20
tapouttazz9: raises $0.10 to $0.30
lonirules: calls $0.20
Noplits: calls $0.10
*** FLOP *** [7d Ts 7c]
Noplits: checks
tapouttazz9: checks
lonirules: bets $0.40
Noplits: folds
tapouttazz9: calls $0.40
*** TURN *** [7d Ts 7c] [4d]
tapouttazz9: checks
lonirules: checks
*** RIVER *** [7d Ts 7c 4d] [6d]
tapouttazz9: bets $1.62
lonirules: raises $1.62 to $3.24
tapouttazz9: folds
Uncalled bet ($1.62) returned to lonirules
lonirules collected $4.69 from pot
lonirules: doesn't show hand
*** SUMMARY ***
Total pot $4.94 | Rake $0.25
Board [7d Ts 7c 4d 6d]
Seat 3: lonirules collected ($4.69)
Seat 4: TeamGolden44 (button) folded before Flop (didn't bet)
Seat 5: Noplits (small blind) folded on the Flop
Seat 6: tapouttazz9 (big blind) folded on the River


PokerStars Hand #157167731785:  Hold'em No Limit ($0.05/$0.10 USD) - 2016/08/20 10:22:35 ET
Table 'Ate' 6-max Seat #5 is the button
Seat 1: rpb9999 ($8 in chips)
Seat 3: lonirules ($20.44 in chips)
Seat 4: TeamGolden44 ($10.07 in chips)
Seat 5: Noplits ($14.29 in chips)
Seat 6: tapouttazz9 ($7.53 in chips)
tapouttazz9: posts small blind $0.05
rpb9999: posts big blind $0.10
*** HOLE CARDS ***
Dealt to tapouttazz9 [Kc 3d]
lonirules: folds
TeamGolden44: folds
Noplits: folds
tapouttazz9: folds
Uncalled bet ($0.05) returned to rpb9999
rpb9999 collected $0.10 from pot
rpb9999: doesn't show hand
*** SUMMARY ***
Total pot $0.10 | Rake $0
Seat 1: rpb9999 (big blind) collected ($0.10)
Seat 3: lonirules folded before Flop (didn't bet)
Seat 4: TeamGolden44 folded before Flop (didn't bet)
Seat 5: Noplits (button) folded before Flop (didn't bet)
Seat 6: tapouttazz9 (small blind) folded before Flop


PokerStars Hand #157167731806:  Hold'em No Limit ($0.05/$0.10 USD) - 2016/08/20 10:22:46 ET
Table 'Ate' 6-max Seat #6 is the button
Seat 1: rpb9999 ($8.05 in chips)
Seat 3: lonirules ($20.44 in chips)
Seat 4: TeamGolden44 ($10.07 in chips)
Seat 5: Noplits ($14.29 in chips)
Seat 6: tapouttazz9 ($7.48 in chips)
rpb9999: posts small blind $0.05
lonirules: posts big blind $0.10
*** HOLE CARDS ***
Dealt to tapouttazz9 [Ah 4s]
TeamGolden44: folds
Noplits: folds
tapouttazz9: raises $0.10 to $0.20
rpb9999: folds
lonirules: raises $0.10 to $0.30
tapouttazz9: calls $0.10
*** FLOP *** [9s 7d Ac]
lonirules: bets $0.30
tapouttazz9: calls $0.30
*** TURN *** [9s 7d Ac] [8d]
lonirules: checks
tapouttazz9: checks
*** RIVER *** [9s 7d Ac 8d] [2s]
lonirules: checks
tapouttazz9: bets $0.59
lonirules: folds
Uncalled bet ($0.59) returned to tapouttazz9
tapouttazz9 collected $1.19 from pot
*** SUMMARY ***
Total pot $1.25 | Rake $0.06
Board [9s 7d Ac 8d 2s]
Seat 1: rpb9999 (small blind) folded before Flop
Seat 3: lonirules (big blind) folded on the River
Seat 4: TeamGolden44 folded before Flop (didn't bet)
Seat 5: Noplits folded before Flop (didn't bet)
Seat 6: tapouttazz9 (button) collected ($1.19)


PokerStars Hand #157167731918:  Hold'em No Limit ($0.05/$0.10 USD) - 2016/08/20 10:23:32 ET
Table 'Ate' 6-max Seat #1 is the button
Seat 1: rpb9999 ($8 in chips)
Seat 3: lonirules ($19.84 in chips)
Seat 4: TeamGolden44 ($10.07 in chips)
Seat 5: Noplits ($14.29 in chips)
Seat 6: tapouttazz9 ($10 in chips)
lonirules: posts small blind $0.05
TeamGolden44: posts big blind $0.10
*** HOLE CARDS ***
Dealt to tapouttazz9 [7d Js]
Noplits: raises $0.15 to $0.25
tapouttazz9: folds
rpb9999: calls $0.25
lonirules: folds
TeamGolden44: folds
*** FLOP *** [Kc Ac Jc]
Noplits: bets $0.31
rpb9999: calls $0.31
*** TURN *** [Kc Ac Jc] [Tc]
Noplits: checks
rpb9999: bets $0.10
Noplits: calls $0.10
*** RIVER *** [Kc Ac Jc Tc] [4c]
Noplits: bets $1.40
rpb9999: folds
Uncalled bet ($1.40) returned to Noplits
Noplits collected $1.40 from pot
Noplits: doesn't show hand
*** SUMMARY ***
Total pot $1.47 | Rake $0.07
Board [Kc Ac Jc Tc 4c]
Seat 1: rpb9999 (button) folded on the River
Seat 3: lonirules (small blind) folded before Flop
Seat 4: TeamGolden44 (big blind) folded before Flop
Seat 5: Noplits collected ($1.40)
Seat 6: tapouttazz9 folded before Flop (didn't bet)


PokerStars Hand #157167732172:  Hold'em No Limit ($0.05/$0.10 USD) - 2016/08/20 10:25:15 ET
Table 'Ate' 6-max Seat #3 is the button
Seat 1: rpb9999 ($7.34 in chips)
Seat 3: lonirules ($19.79 in chips)
Seat 4: TeamGolden44 ($9.97 in chips)
Seat 5: Noplits ($15.03 in chips)
Seat 6: tapouttazz9 ($10 in chips)
TeamGolden44: posts small blind $0.05
Noplits: posts big blind $0.10
*** HOLE CARDS ***
Dealt to tapouttazz9 [9c 8h]
tapouttazz9: raises $0.20 to $0.30
rpb9999: folds
lonirules: calls $0.30
TeamGolden44: folds
Noplits: folds
*** FLOP *** [Tc Kc Ts]
tapouttazz9: checks
lonirules: bets $0.30
tapouttazz9: calls $0.30
*** TURN *** [Tc Kc Ts] [Jc]
tapouttazz9: checks
lonirules: bets $0.60
tapouttazz9: calls $0.60
*** RIVER *** [Tc Kc Ts Jc] [6c]
tapouttazz9: checks
lonirules: bets $2.40
tapouttazz9: calls $2.40
*** SHOW DOWN ***
lonirules: shows [Td Ac] (a flush, Ace high)
tapouttazz9: mucks hand
Steelfox7 joins the table at seat #2
lonirules collected $6.98 from pot
*** SUMMARY ***
Total pot $7.35 | Rake $0.37
Board [Tc Kc Ts Jc 6c]
Seat 1: rpb9999 folded before Flop (didn't bet)
Seat 3: lonirules (button) showed [Td Ac] and won ($6.98) with a flush, Ace high
Seat 4: TeamGolden44 (small blind) folded before Flop
Seat 5: Noplits (big blind) folded before Flop
Seat 6: tapouttazz9 mucked [9c 8h]


PokerStars Hand #157167732282:  Hold'em No Limit ($0.05/$0.10 USD) - 2016/08/20 10:25:58 ET
Table 'Ate' 6-max Seat #4 is the button
Seat 1: rpb9999 ($7.34 in chips)
Seat 3: lonirules ($23.17 in chips)
Seat 4: TeamGolden44 ($9.92 in chips)
Seat 5: Noplits ($14.93 in chips)
Seat 6: tapouttazz9 ($6.40 in chips)
Noplits: posts small blind $0.05
tapouttazz9: posts big blind $0.10
Steelfox7: sits out
*** HOLE CARDS ***
Dealt to tapouttazz9 [Tc Qd]
rpb9999: folds
lonirules is disconnected
lonirules has timed out while disconnected
lonirules: folds
TeamGolden44: raises $0.25 to $0.35
Noplits: folds
tapouttazz9: calls $0.25
*** FLOP *** [Td Kd 4s]
tapouttazz9: checks
TeamGolden44: checks
*** TURN *** [Td Kd 4s] [3c]
lonirules said, "should have tapped out"
tapouttazz9: bets $0.20
TeamGolden44: calls $0.20
*** RIVER *** [Td Kd 4s 3c] [2c]
tapouttazz9: checks
TeamGolden44: bets $1.09
tapouttazz9: calls $1.09
*** SHOW DOWN ***
TeamGolden44: shows [As 4h] (a pair of Fours)
tapouttazz9: shows [Tc Qd] (a pair of Tens)
tapouttazz9 collected $3.16 from pot
*** SUMMARY ***
Total pot $3.33 | Rake $0.17
Board [Td Kd 4s 3c 2c]
Seat 1: rpb9999 folded before Flop (didn't bet)
Seat 3: lonirules folded before Flop (didn't bet)
Seat 4: TeamGolden44 (button) showed [As 4h] and lost with a pair of Fours
Seat 5: Noplits (small blind) folded before Flop
Seat 6: tapouttazz9 (big blind) showed [Tc Qd] and won ($3.16) with a pair of Tens


PokerStars Hand #157167732455:  Hold'em No Limit ($0.05/$0.10 USD) - 2016/08/20 10:27:06 ET
Table 'Ate' 6-max Seat #5 is the button
Seat 1: rpb9999 ($7.34 in chips)
Seat 3: lonirules ($23.17 in chips)
Seat 4: TeamGolden44 ($8.28 in chips)
Seat 5: Noplits ($14.88 in chips)
Seat 6: tapouttazz9 ($10 in chips)
tapouttazz9: posts small blind $0.05
rpb9999: posts big blind $0.10
Steelfox7: sits out
*** HOLE CARDS ***
Dealt to tapouttazz9 [Td 3d]
lonirules: calls $0.10
TeamGolden44: folds
Noplits: folds
tapouttazz9: folds
rpb9999: checks
*** FLOP *** [5d 7c 8d]
rpb9999: checks
lonirules: bets $0.10
rpb9999: calls $0.10
*** TURN *** [5d 7c 8d] [Ah]
rpb9999: bets $0.21
lonirules: calls $0.21
*** RIVER *** [5d 7c 8d Ah] [5c]
rpb9999: checks
lonirules: checks
*** SHOW DOWN ***
rpb9999: shows [Kd Th] (a pair of Fives)
lonirules: shows [6s 8s] (two pair, Eights and Fives)
lonirules collected $0.83 from pot
*** SUMMARY ***
Total pot $0.87 | Rake $0.04
Board [5d 7c 8d Ah 5c]
Seat 1: rpb9999 (big blind) showed [Kd Th] and lost with a pair of Fives
Seat 3: lonirules showed [6s 8s] and won ($0.83) with two pair, Eights and Fives
Seat 4: TeamGolden44 folded before Flop (didn't bet)
Seat 5: Noplits (button) folded before Flop (didn't bet)
Seat 6: tapouttazz9 (small blind) folded before Flop


PokerStars Hand #157167732594:  Hold'em No Limit ($0.05/$0.10 USD) - 2016/08/20 10:27:54 ET
Table 'Ate' 6-max Seat #6 is the button
Seat 1: rpb9999 ($6.93 in chips)
Seat 2: Steelfox7 ($10 in chips)
Seat 3: lonirules ($23.59 in chips)
Seat 4: TeamGolden44 ($8.28 in chips)
Seat 5: Noplits ($14.88 in chips)
Seat 6: tapouttazz9 ($9.95 in chips)
rpb9999: posts small blind $0.05
Steelfox7: posts big blind $0.10
*** HOLE CARDS ***
Dealt to tapouttazz9 [8c 3h]
lonirules: folds
TeamGolden44: folds
Noplits: folds
tapouttazz9: folds
rpb9999: raises $0.20 to $0.30
Steelfox7: folds
Uncalled bet ($0.20) returned to rpb9999
rpb9999 collected $0.20 from pot
rpb9999: doesn't show hand
*** SUMMARY ***
Total pot $0.20 | Rake $0
Seat 1: rpb9999 (small blind) collected ($0.20)
Seat 2: Steelfox7 (big blind) folded before Flop
Seat 3: lonirules folded before Flop (didn't bet)
Seat 4: TeamGolden44 folded before Flop (didn't bet)
Seat 5: Noplits folded before Flop (didn't bet)
Seat 6: tapouttazz9 (button) folded before Flop (didn't bet)


PokerStars Hand #157167732641:  Hold'em No Limit ($0.05/$0.10 USD) - 2016/08/20 10:28:14 ET
Table 'Ate' 6-max Seat #1 is the button
Seat 1: rpb9999 ($7.03 in chips)
Seat 2: Steelfox7 ($10 in chips)
Seat 3: lonirules ($23.59 in chips)
Seat 4: TeamGolden44 ($8.28 in chips)
Seat 5: Noplits ($14.88 in chips)
Seat 6: tapouttazz9 ($9.95 in chips)
Steelfox7: posts small blind $0.05
lonirules: posts big blind $0.10
*** HOLE CARDS ***
Dealt to tapouttazz9 [6s 7s]
TeamGolden44: folds
Noplits: folds
tapouttazz9: folds
rpb9999: folds
Steelfox7: raises $0.15 to $0.25
lonirules: raises $0.45 to $0.70
Steelfox7: folds
Uncalled bet ($0.45) returned to lonirules
lonirules collected $0.50 from pot
lonirules: doesn't show hand
*** SUMMARY ***
Total pot $0.50 | Rake $0
Seat 1: rpb9999 (button) folded before Flop (didn't bet)
Seat 2: Steelfox7 (small blind) folded before Flop
Seat 3: lonirules (big blind) collected ($0.50)
Seat 4: TeamGolden44 folded before Flop (didn't bet)
Seat 5: Noplits folded before Flop (didn't bet)
Seat 6: tapouttazz9 folded before Flop (didn't bet)


PokerStars Hand #157167732702:  Hold'em No Limit ($0.05/$0.10 USD) - 2016/08/20 10:28:38 ET
Table 'Ate' 6-max Seat #2 is the button
Seat 1: rpb9999 ($7.03 in chips)
Seat 2: Steelfox7 ($10 in chips)
Seat 3: lonirules ($23.84 in chips)
Seat 4: TeamGolden44 ($8.28 in chips)
Seat 5: Noplits ($14.88 in chips)
Seat 6: tapouttazz9 ($9.95 in chips)
lonirules: posts small blind $0.05
TeamGolden44: posts big blind $0.10
*** HOLE CARDS ***
Dealt to tapouttazz9 [Jh Jd]
Noplits: folds
tapouttazz9: raises $0.20 to $0.30
rpb9999: folds
Steelfox7: folds
lonirules: calls $0.25
TeamGolden44: calls $0.20
*** FLOP *** [9c 3d 6d]
lonirules: checks
TeamGolden44: bets $0.86
tapouttazz9: raises $1.29 to $2.15
lonirules: folds
TeamGolden44: raises $5.83 to $7.98 and is all-in
tapouttazz9: calls $5.83
*** TURN *** [9c 3d 6d] [Qs]
*** RIVER *** [9c 3d 6d Qs] [5s]
*** SHOW DOWN ***
TeamGolden44: shows [3s 3c] (three of a kind, Threes)
tapouttazz9: shows [Jh Jd] (a pair of Jacks)
TeamGolden44 collected $16.02 from pot
*** SUMMARY ***
Total pot $16.86 | Rake $0.84
Board [9c 3d 6d Qs 5s]
Seat 1: rpb9999 folded before Flop (didn't bet)
Seat 2: Steelfox7 (button) folded before Flop (didn't bet)
Seat 3: lonirules (small blind) folded on the Flop
Seat 4: TeamGolden44 (big blind) showed [3s 3c] and won ($16.02) with three of a kind, Threes
Seat 5: Noplits folded before Flop (didn't bet)
Seat 6: tapouttazz9 showed [Jh Jd] and lost with a pair of Jacks


PokerStars Hand #157167732803:  Hold'em No Limit ($0.05/$0.10 USD) - 2016/08/20 10:29:17 ET
Table 'Ate' 6-max Seat #3 is the button
Seat 1: rpb9999 ($7.03 in chips)
Seat 2: Steelfox7 ($10 in chips)
Seat 3: lonirules ($23.54 in chips)
Seat 5: Noplits ($14.88 in chips)
Seat 6: tapouttazz9 ($1.67 in chips)
TeamGolden44 has timed out while being disconnected
TeamGolden44: is sitting out
Noplits: posts small blind $0.05
tapouttazz9: posts big blind $0.10
*** HOLE CARDS ***
Dealt to tapouttazz9 [5h Kd]
TeamGolden44 is disconnected
rpb9999: folds
Steelfox7: raises $0.20 to $0.30
lonirules: calls $0.30
Noplits: folds
tapouttazz9: folds
*** FLOP *** [2c Js 9s]
Steelfox7: bets $0.40
lonirules: calls $0.40
*** TURN *** [2c Js 9s] [Jd]
Steelfox7: checks
lonirules: checks
*** RIVER *** [2c Js 9s Jd] [6d]
Steelfox7: bets $0.99
lonirules: folds
Uncalled bet ($0.99) returned to Steelfox7
Steelfox7 collected $1.47 from pot
Steelfox7: doesn't show hand
*** SUMMARY ***
Total pot $1.55 | Rake $0.08
Board [2c Js 9s Jd 6d]
Seat 1: rpb9999 folded before Flop (didn't bet)
Seat 2: Steelfox7 collected ($1.47)
Seat 3: lonirules (button) folded on the River
Seat 5: Noplits (small blind) folded before Flop
Seat 6: tapouttazz9 (big blind) folded before Flop


PokerStars Hand #157167733015:  Hold'em No Limit ($0.05/$0.10 USD) - 2016/08/20 10:30:31 ET
Table 'Ate' 6-max Seat #5 is the button
Seat 1: rpb9999 ($7.03 in chips)
Seat 2: Steelfox7 ($10.77 in chips)
Seat 3: lonirules ($22.84 in chips)
Seat 5: Noplits ($14.83 in chips)
Seat 6: tapouttazz9 ($9.90 in chips)
tapouttazz9: posts small blind $0.05
rpb9999: posts big blind $0.10
*** HOLE CARDS ***
Dealt to tapouttazz9 [Qc Qh]
Steelfox7: folds
lonirules: calls $0.10
Noplits: folds
tapouttazz9: raises $0.20 to $0.30
rpb9999: folds
lonirules: calls $0.20
*** FLOP *** [5s 5d Kc]
tapouttazz9: checks
lonirules: checks
*** TURN *** [5s 5d Kc] [Kh]
tapouttazz9: checks
lonirules: checks
*** RIVER *** [5s 5d Kc Kh] [As]
tapouttazz9: checks
lonirules: checks
*** SHOW DOWN ***
tapouttazz9: shows [Qc Qh] (two pair, Kings and Queens)
lonirules: mucks hand
tapouttazz9 collected $0.66 from pot
*** SUMMARY ***
Total pot $0.70 | Rake $0.04
Board [5s 5d Kc Kh As]
Seat 1: rpb9999 (big blind) folded before Flop
Seat 2: Steelfox7 folded before Flop (didn't bet)
Seat 3: lonirules mucked [6c Tc]
Seat 5: Noplits (button) folded before Flop (didn't bet)
Seat 6: tapouttazz9 (small blind) showed [Qc Qh] and won ($0.66) with two pair, Kings and Queens


PokerStars Hand #157167733101:  Hold'em No Limit ($0.05/$0.10 USD) - 2016/08/20 10:31:00 ET
Table 'Ate' 6-max Seat #6 is the button
Seat 1: rpb9999 ($6.93 in chips)
Seat 2: Steelfox7 ($10.77 in chips)
Seat 3: lonirules ($22.54 in chips)
Seat 5: Noplits ($14.83 in chips)
Seat 6: tapouttazz9 ($10.26 in chips)
rpb9999: posts small blind $0.05
Steelfox7: posts big blind $0.10
*** HOLE CARDS ***
Dealt to tapouttazz9 [Ks 6c]
lonirules: calls $0.10
Noplits: folds
tapouttazz9: folds
rpb9999: calls $0.05
Steelfox7: checks
*** FLOP *** [2h As 9h]
rpb9999: bets $0.14
Steelfox7: folds
lonirules: calls $0.14
*** TURN *** [2h As 9h] [4c]
rpb9999: checks
lonirules: bets $0.30
rpb9999: calls $0.30
*** RIVER *** [2h As 9h 4c] [Td]
rpb9999: checks
lonirules: checks
*** SHOW DOWN ***
rpb9999: shows [6h Th] (a pair of Tens)
lonirules: mucks hand
rpb9999 collected $1.12 from pot
*** SUMMARY ***
Total pot $1.18 | Rake $0.06
Board [2h As 9h 4c Td]
Seat 1: rpb9999 (small blind) showed [6h Th] and won ($1.12) with a pair of Tens
Seat 2: Steelfox7 (big blind) folded on the Flop
Seat 3: lonirules mucked [5h 8h]
Seat 5: Noplits folded before Flop (didn't bet)
Seat 6: tapouttazz9 (button) folded before Flop (didn't bet)


PokerStars Hand #157167733241:  Hold'em No Limit ($0.05/$0.10 USD) - 2016/08/20 10:31:50 ET
Table 'Ate' 6-max Seat #1 is the button
Seat 1: rpb9999 ($7.51 in chips)
Seat 2: Steelfox7 ($10.67 in chips)
Seat 5: Noplits ($14.83 in chips)
Seat 6: tapouttazz9 ($10.26 in chips)
Steelfox7: posts small blind $0.05
lonirules: is sitting out
Noplits: posts big blind $0.10
*** HOLE CARDS ***
Dealt to tapouttazz9 [Ad Tc]
tapouttazz9: raises $0.20 to $0.30
lonirules leaves the table
righty01 joins the table at seat #3
rpb9999: raises $0.20 to $0.50
Steelfox7: folds
Noplits: calls $0.40
tapouttazz9: calls $0.20
*** FLOP *** [Ks 7s 4d]
Noplits: checks
tapouttazz9: checks
rpb9999: bets $1.47
Noplits: folds
tapouttazz9: folds
Uncalled bet ($1.47) returned to rpb9999
rpb9999 collected $1.47 from pot
rpb9999: doesn't show hand
*** SUMMARY ***
Total pot $1.55 | Rake $0.08
Board [Ks 7s 4d]
Seat 1: rpb9999 (button) collected ($1.47)
Seat 2: Steelfox7 (small blind) folded before Flop
Seat 5: Noplits (big blind) folded on the Flop
Seat 6: tapouttazz9 folded on the Flop


PokerStars Hand #157167733375:  Hold'em No Limit ($0.05/$0.10 USD) - 2016/08/20 10:32:41 ET
Table 'Ate' 6-max Seat #2 is the button
Seat 1: rpb9999 ($8.48 in chips)
Seat 2: Steelfox7 ($10.62 in chips)
Seat 5: Noplits ($14.33 in chips)
Seat 6: tapouttazz9 ($9.76 in chips)
righty01 will be allowed to play after the button
Noplits: posts small blind $0.05
tapouttazz9: posts big blind $0.10
*** HOLE CARDS ***
Dealt to tapouttazz9 [2s 7s]
rpb9999: raises $0.20 to $0.30
Steelfox7: raises $0.75 to $1.05
Noplits: folds
tapouttazz9: folds
rpb9999: calls $0.75
*** FLOP *** [Ac Ks Th]
rpb9999: checks
Steelfox7: bets $1.67
rpb9999: folds
Uncalled bet ($1.67) returned to Steelfox7
Steelfox7 collected $2.14 from pot
Steelfox7: doesn't show hand
*** SUMMARY ***
Total pot $2.25 | Rake $0.11
Board [Ac Ks Th]
Seat 1: rpb9999 folded on the Flop
Seat 2: Steelfox7 (button) collected ($2.14)
Seat 5: Noplits (small blind) folded before Flop
Seat 6: tapouttazz9 (big blind) folded before Flop


PokerStars Hand #157167733472:  Hold'em No Limit ($0.05/$0.10 USD) - 2016/08/20 10:33:17 ET
Table 'Ate' 6-max Seat #5 is the button
Seat 1: rpb9999 ($7.43 in chips)
Seat 2: Steelfox7 ($11.71 in chips)
Seat 3: righty01 ($10 in chips)
Seat 5: Noplits ($14.28 in chips)
Seat 6: tapouttazz9 ($9.66 in chips)
tapouttazz9: posts small blind $0.05
rpb9999: posts big blind $0.10
righty01: posts big blind $0.10
*** HOLE CARDS ***
Dealt to tapouttazz9 [Td 9c]
Steelfox7: folds
righty01: checks
Noplits: folds
tapouttazz9: raises $0.20 to $0.30
rpb9999: folds
righty01: folds
Uncalled bet ($0.20) returned to tapouttazz9
tapouttazz9 collected $0.30 from pot
*** SUMMARY ***
Total pot $0.30 | Rake $0
Seat 1: rpb9999 (big blind) folded before Flop
Seat 2: Steelfox7 folded before Flop (didn't bet)
Seat 3: righty01 folded before Flop
Seat 5: Noplits (button) folded before Flop (didn't bet)
Seat 6: tapouttazz9 (small blind) collected ($0.30)


PokerStars Hand #157167733554:  Hold'em No Limit ($0.05/$0.10 USD) - 2016/08/20 10:33:50 ET
Table 'Ate' 6-max Seat #6 is the button
Seat 1: rpb9999 ($7.33 in chips)
Seat 2: Steelfox7 ($11.71 in chips)
Seat 3: righty01 ($9.90 in chips)
Seat 5: Noplits ($14.28 in chips)
Seat 6: tapouttazz9 ($9.86 in chips)
rpb9999: posts small blind $0.05
Steelfox7: posts big blind $0.10
*** HOLE CARDS ***
Dealt to tapouttazz9 [Jc Kc]
righty01: folds
Noplits: folds
tapouttazz9: raises $0.20 to $0.30
rpb9999: folds
Steelfox7: folds
Uncalled bet ($0.20) returned to tapouttazz9
tapouttazz9 collected $0.25 from pot
*** SUMMARY ***
Total pot $0.25 | Rake $0
Seat 1: rpb9999 (small blind) folded before Flop
Seat 2: Steelfox7 (big blind) folded before Flop
Seat 3: righty01 folded before Flop (didn't bet)
Seat 5: Noplits folded before Flop (didn't bet)
Seat 6: tapouttazz9 (button) collected ($0.25)


PokerStars Hand #157167733608:  Hold'em No Limit ($0.05/$0.10 USD) - 2016/08/20 10:34:09 ET
Table 'Ate' 6-max Seat #1 is the button
Seat 1: rpb9999 ($7.28 in chips)
Seat 2: Steelfox7 ($11.61 in chips)
Seat 3: righty01 ($9.90 in chips)
Seat 5: Noplits ($14.28 in chips)
Seat 6: tapouttazz9 ($10.01 in chips)
Steelfox7: posts small blind $0.05
righty01: posts big blind $0.10
*** HOLE CARDS ***
Dealt to tapouttazz9 [5h Ad]
Noplits: folds
tapouttazz9: folds
rpb9999: raises $0.10 to $0.20
Steelfox7: folds
righty01: calls $0.10
*** FLOP *** [3d Ks Qs]
righty01: bets $0.50
rpb9999: folds
Uncalled bet ($0.50) returned to righty01
righty01 collected $0.43 from pot
righty01: doesn't show hand
*** SUMMARY ***
Total pot $0.45 | Rake $0.02
Board [3d Ks Qs]
Seat 1: rpb9999 (button) folded on the Flop
Seat 2: Steelfox7 (small blind) folded before Flop
Seat 3: righty01 (big blind) collected ($0.43)
Seat 5: Noplits folded before Flop (didn't bet)
Seat 6: tapouttazz9 folded before Flop (didn't bet)


PokerStars Hand #157167733665:  Hold'em No Limit ($0.05/$0.10 USD) - 2016/08/20 10:34:33 ET
Table 'Ate' 6-max Seat #2 is the button
Seat 1: rpb9999 ($7.08 in chips)
Seat 2: Steelfox7 ($11.56 in chips)
Seat 3: righty01 ($10.13 in chips)
Seat 5: Noplits ($14.28 in chips)
Seat 6: tapouttazz9 ($10.01 in chips)
righty01: posts small blind $0.05
Noplits: posts big blind $0.10
*** HOLE CARDS ***
Dealt to tapouttazz9 [8s 2h]
tapouttazz9: folds
rpb9999: folds
Steelfox7: folds
righty01: folds
Uncalled bet ($0.05) returned to Noplits
Noplits collected $0.10 from pot
Noplits: doesn't show hand
*** SUMMARY ***
Total pot $0.10 | Rake $0
Seat 1: rpb9999 folded before Flop (didn't bet)
Seat 2: Steelfox7 (button) folded before Flop (didn't bet)
Seat 3: righty01 (small blind) folded before Flop
Seat 5: Noplits (big blind) collected ($0.10)
Seat 6: tapouttazz9 folded before Flop (didn't bet)


PokerStars Hand #157167733692:  Hold'em No Limit ($0.05/$0.10 USD) - 2016/08/20 10:34:44 ET
Table 'Ate' 6-max Seat #3 is the button
Seat 1: rpb9999 ($7.08 in chips)
Seat 2: Steelfox7 ($11.56 in chips)
Seat 3: righty01 ($10.08 in chips)
Seat 5: Noplits ($14.33 in chips)
Seat 6: tapouttazz9 ($10.01 in chips)
Noplits: posts small blind $0.05
tapouttazz9: posts big blind $0.10
*** HOLE CARDS ***
Dealt to tapouttazz9 [7d 6c]
rpb9999: folds
Steelfox7: folds
righty01: raises $0.25 to $0.35
Noplits: folds
tapouttazz9: folds
Uncalled bet ($0.25) returned to righty01
righty01 collected $0.25 from pot
righty01: doesn't show hand
*** SUMMARY ***
Total pot $0.25 | Rake $0
Seat 1: rpb9999 folded before Flop (didn't bet)
Seat 2: Steelfox7 folded before Flop (didn't bet)
Seat 3: righty01 (button) collected ($0.25)
Seat 5: Noplits (small blind) folded before Flop
Seat 6: tapouttazz9 (big blind) folded before Flop


PokerStars Hand #157167733721:  Hold'em No Limit ($0.05/$0.10 USD) - 2016/08/20 10:34:57 ET
Table 'Ate' 6-max Seat #5 is the button
Seat 1: rpb9999 ($7.08 in chips)
Seat 2: Steelfox7 ($11.56 in chips)
Seat 3: righty01 ($10.23 in chips)
Seat 5: Noplits ($14.28 in chips)
Seat 6: tapouttazz9 ($9.91 in chips)
tapouttazz9: posts small blind $0.05
rpb9999: posts big blind $0.10
*** HOLE CARDS ***
Dealt to tapouttazz9 [7d Ks]
Steelfox7: folds
righty01: calls $0.10
Noplits: folds
tapouttazz9: folds
rpb9999: checks
*** FLOP *** [Tc Qh Qd]
rpb9999: checks
righty01: checks
*** TURN *** [Tc Qh Qd] [3h]
rpb9999: checks
righty01: bets $0.12
rpb9999: folds
Uncalled bet ($0.12) returned to righty01
righty01 collected $0.24 from pot
righty01: doesn't show hand
*** SUMMARY ***
Total pot $0.25 | Rake $0.01
Board [Tc Qh Qd 3h]
Seat 1: rpb9999 (big blind) folded on the Turn
Seat 2: Steelfox7 folded before Flop (didn't bet)
Seat 3: righty01 collected ($0.24)
Seat 5: Noplits (button) folded before Flop (didn't bet)
Seat 6: tapouttazz9 (small blind) folded before Flop


PokerStars Hand #157167733811:  Hold'em No Limit ($0.05/$0.10 USD) - 2016/08/20 10:35:34 ET
Table 'Ate' 6-max Seat #6 is the button
Seat 1: rpb9999 ($6.98 in chips)
Seat 2: Steelfox7 ($11.56 in chips)
Seat 3: righty01 ($10.37 in chips)
Seat 5: Noplits ($14.28 in chips)
Seat 6: tapouttazz9 ($9.86 in chips)
rpb9999: posts small blind $0.05
Steelfox7: posts big blind $0.10
*** HOLE CARDS ***
Dealt to tapouttazz9 [3s 3h]
righty01: folds
Noplits: raises $0.15 to $0.25
tapouttazz9: calls $0.25
rpb9999: folds
Steelfox7: folds
*** FLOP *** [Qs Ac Kc]
Noplits: bets $0.50
tapouttazz9: folds
Uncalled bet ($0.50) returned to Noplits
Noplits collected $0.62 from pot
Noplits: doesn't show hand
*** SUMMARY ***
Total pot $0.65 | Rake $0.03
Board [Qs Ac Kc]
Seat 1: rpb9999 (small blind) folded before Flop
Seat 2: Steelfox7 (big blind) folded before Flop
Seat 3: righty01 folded before Flop (didn't bet)
Seat 5: Noplits collected ($0.62)
Seat 6: tapouttazz9 (button) folded on the Flop


PokerStars Hand #157167733904:  Hold'em No Limit ($0.05/$0.10 USD) - 2016/08/20 10:36:10 ET
Table 'Ate' 6-max Seat #1 is the button
Seat 1: rpb9999 ($6.93 in chips)
Seat 2: Steelfox7 ($11.46 in chips)
Seat 3: righty01 ($10.37 in chips)
Seat 5: Noplits ($14.65 in chips)
Seat 6: tapouttazz9 ($9.61 in chips)
Steelfox7: posts small blind $0.05
righty01: posts big blind $0.10
*** HOLE CARDS ***
Dealt to tapouttazz9 [3d Qc]
Noplits: folds
tapouttazz9: folds
rpb9999: folds
Steelfox7: folds
Uncalled bet ($0.05) returned to righty01
righty01 collected $0.10 from pot
righty01: doesn't show hand
*** SUMMARY ***
Total pot $0.10 | Rake $0
Seat 1: rpb9999 (button) folded before Flop (didn't bet)
Seat 2: Steelfox7 (small blind) folded before Flop
Seat 3: righty01 (big blind) collected ($0.10)
Seat 5: Noplits folded before Flop (didn't bet)
Seat 6: tapouttazz9 folded before Flop (didn't bet)


PokerStars Hand #157167733931:  Hold'em No Limit ($0.05/$0.10 USD) - 2016/08/20 10:36:22 ET
Table 'Ate' 6-max Seat #2 is the button
Seat 1: rpb9999 ($6.93 in chips)
Seat 2: Steelfox7 ($11.41 in chips)
Seat 3: righty01 ($10.42 in chips)
Seat 5: Noplits ($14.65 in chips)
Seat 6: tapouttazz9 ($9.61 in chips)
righty01: posts small blind $0.05
Noplits: posts big blind $0.10
*** HOLE CARDS ***
Dealt to tapouttazz9 [7h Jc]
tapouttazz9: folds
rpb9999: folds
Steelfox7: raises $0.20 to $0.30
righty01: folds
Noplits: calls $0.20
*** FLOP *** [Kh 8h Jd]
Noplits: checks
Steelfox7: bets $0.40
Noplits: folds
Uncalled bet ($0.40) returned to Steelfox7
Steelfox7 collected $0.62 from pot
Steelfox7: doesn't show hand
*** SUMMARY ***
Total pot $0.65 | Rake $0.03
Board [Kh 8h Jd]
Seat 1: rpb9999 folded before Flop (didn't bet)
Seat 2: Steelfox7 (button) collected ($0.62)
Seat 3: righty01 (small blind) folded before Flop
Seat 5: Noplits (big blind) folded on the Flop
Seat 6: tapouttazz9 folded before Flop (didn't bet)


PokerStars Hand #157167734082:  Hold'em No Limit ($0.05/$0.10 USD) - 2016/08/20 10:37:17 ET
Table 'Ate' 6-max Seat #3 is the button
Seat 1: rpb9999 ($6.93 in chips)
Seat 2: Steelfox7 ($11.73 in chips)
Seat 3: righty01 ($10.37 in chips)
Seat 5: Noplits ($14.35 in chips)
Seat 6: tapouttazz9 ($9.61 in chips)
Noplits: posts small blind $0.05
tapouttazz9: posts big blind $0.10
*** HOLE CARDS ***
Dealt to tapouttazz9 [Jd 5s]
rpb9999: folds
Steelfox7: folds
righty01: calls $0.10
Noplits: folds
tapouttazz9: checks
*** FLOP *** [Kc 3d 7d]
tapouttazz9: checks
righty01: checks
*** TURN *** [Kc 3d 7d] [5h]
tapouttazz9: checks
righty01: checks
*** RIVER *** [Kc 3d 7d 5h] [9h]
tapouttazz9: checks
righty01: checks
*** SHOW DOWN ***
tapouttazz9: shows [Jd 5s] (a pair of Fives)
righty01: shows [9s 8d] (a pair of Nines)
righty01 collected $0.24 from pot
*** SUMMARY ***
Total pot $0.25 | Rake $0.01
Board [Kc 3d 7d 5h 9h]
Seat 1: rpb9999 folded before Flop (didn't bet)
Seat 2: Steelfox7 folded before Flop (didn't bet)
Seat 3: righty01 (button) showed [9s 8d] and won ($0.24) with a pair of Nines
Seat 5: Noplits (small blind) folded before Flop
Seat 6: tapouttazz9 (big blind) showed [Jd 5s] and lost with a pair of Fives


PokerStars Hand #157167734147:  Hold'em No Limit ($0.05/$0.10 USD) - 2016/08/20 10:37:44 ET
Table 'Ate' 6-max Seat #5 is the button
Seat 1: rpb9999 ($6.93 in chips)
Seat 2: Steelfox7 ($11.73 in chips)
Seat 3: righty01 ($10.51 in chips)
Seat 5: Noplits ($14.30 in chips)
Seat 6: tapouttazz9 ($9.51 in chips)
tapouttazz9: posts small blind $0.05
rpb9999: posts big blind $0.10
*** HOLE CARDS ***
Dealt to tapouttazz9 [2s 3h]
Steelfox7: raises $0.20 to $0.30
righty01: calls $0.30
Noplits: folds
tapouttazz9: folds
rpb9999: folds
*** FLOP *** [6d 5h Jc]
Steelfox7: checks
righty01: checks
*** TURN *** [6d 5h Jc] [7h]
Steelfox7: checks
righty01: bets $0.35
Steelfox7: folds
Uncalled bet ($0.35) returned to righty01
righty01 collected $0.71 from pot
righty01: doesn't show hand
*** SUMMARY ***
Total pot $0.75 | Rake $0.04
Board [6d 5h Jc 7h]
Seat 1: rpb9999 (big blind) folded before Flop
Seat 2: Steelfox7 folded on the Turn
Seat 3: righty01 collected ($0.71)
Seat 5: Noplits (button) folded before Flop (didn't bet)
Seat 6: tapouttazz9 (small blind) folded before Flop


PokerStars Hand #157167734195:  Hold'em No Limit ($0.05/$0.10 USD) - 2016/08/20 10:38:03 ET
Table 'Ate' 6-max Seat #6 is the button
Seat 1: rpb9999 ($6.83 in chips)
Seat 3: righty01 ($10.92 in chips)
Seat 5: Noplits ($14.30 in chips)
Seat 6: tapouttazz9 ($9.46 in chips)
rpb9999: posts small blind $0.05
Steelfox7: is sitting out
righty01: posts big blind $0.10
*** HOLE CARDS ***
Dealt to tapouttazz9 [9d 5s]
Noplits: folds
tapouttazz9: folds
Steelfox7 leaves the table
rpb9999: folds
Uncalled bet ($0.05) returned to righty01
BonesNYC joins the table at seat #2
righty01 collected $0.10 from pot
righty01: doesn't show hand
*** SUMMARY ***
Total pot $0.10 | Rake $0
Seat 1: rpb9999 (small blind) folded before Flop
Seat 3: righty01 (big blind) collected ($0.10)
Seat 5: Noplits folded before Flop (didn't bet)
Seat 6: tapouttazz9 (button) folded before Flop (didn't bet)


PokerStars Hand #157167734224:  Hold'em No Limit ($0.05/$0.10 USD) - 2016/08/20 10:38:15 ET
Table 'Ate' 6-max Seat #1 is the button
Seat 1: rpb9999 ($6.78 in chips)
Seat 3: righty01 ($10.97 in chips)
Seat 5: Noplits ($14.30 in chips)
Seat 6: tapouttazz9 ($9.46 in chips)
BonesNYC will be allowed to play after the button
righty01: posts small blind $0.05
Noplits: posts big blind $0.10
*** HOLE CARDS ***
Dealt to tapouttazz9 [Jh Qc]
tapouttazz9: raises $0.20 to $0.30
rpb9999: folds
righty01: folds
Noplits: folds
Uncalled bet ($0.20) returned to tapouttazz9
tapouttazz9 collected $0.25 from pot
*** SUMMARY ***
Total pot $0.25 | Rake $0
Seat 1: rpb9999 (button) folded before Flop (didn't bet)
Seat 3: righty01 (small blind) folded before Flop
Seat 5: Noplits (big blind) folded before Flop
Seat 6: tapouttazz9 collected ($0.25)


PokerStars Hand #157167734262:  Hold'em No Limit ($0.05/$0.10 USD) - 2016/08/20 10:38:29 ET
Table 'Ate' 6-max Seat #3 is the button
Seat 1: rpb9999 ($6.78 in chips)
Seat 3: righty01 ($10.92 in chips)
Seat 5: Noplits ($14.20 in chips)
Seat 6: tapouttazz9 ($9.61 in chips)
Noplits: posts small blind $0.05
tapouttazz9: posts big blind $0.10
BonesNYC: sits out
*** HOLE CARDS ***
Dealt to tapouttazz9 [Kc Ac]
rpb9999: folds
righty01: calls $0.10
Noplits: folds
tapouttazz9: raises $0.20 to $0.30
righty01: calls $0.20
*** FLOP *** [Ts 3s Qd]
tapouttazz9: bets $0.31
righty01: calls $0.31
*** TURN *** [Ts 3s Qd] [2d]
tapouttazz9: bets $0.60
righty01: folds
Uncalled bet ($0.60) returned to tapouttazz9
tapouttazz9 collected $1.21 from pot
*** SUMMARY ***
Total pot $1.27 | Rake $0.06
Board [Ts 3s Qd 2d]
Seat 1: rpb9999 folded before Flop (didn't bet)
Seat 3: righty01 (button) folded on the Turn
Seat 5: Noplits (small blind) folded before Flop
Seat 6: tapouttazz9 (big blind) collected ($1.21)


PokerStars Hand #157167734349:  Hold'em No Limit ($0.05/$0.10 USD) - 2016/08/20 10:39:05 ET
Table 'Ate' 6-max Seat #5 is the button
Seat 1: rpb9999 ($6.78 in chips)
Seat 3: righty01 ($10.31 in chips)
Seat 5: Noplits ($14.15 in chips)
Seat 6: tapouttazz9 ($10.21 in chips)
tapouttazz9: posts small blind $0.05
rpb9999: posts big blind $0.10
BonesNYC: sits out
TeamGolden44: sits out
*** HOLE CARDS ***
Dealt to tapouttazz9 [Ac 8c]
righty01: folds
Noplits: folds
tapouttazz9: raises $0.10 to $0.20
rpb9999: calls $0.10
*** FLOP *** [4s 5c 6h]
tapouttazz9: checks
rpb9999: bets $0.19
tapouttazz9: calls $0.19
*** TURN *** [4s 5c 6h] [8d]
tapouttazz9: checks
rpb9999: bets $0.37
tapouttazz9: calls $0.37
*** RIVER *** [4s 5c 6h 8d] [9s]
tapouttazz9: checks
rpb9999: bets $0.72
tapouttazz9: calls $0.72
*** SHOW DOWN ***
rpb9999: shows [6d 8h] (two pair, Eights and Sixes)
tapouttazz9: mucks hand
rpb9999 collected $2.81 from pot
*** SUMMARY ***
Total pot $2.96 | Rake $0.15
Board [4s 5c 6h 8d 9s]
Seat 1: rpb9999 (big blind) showed [6d 8h] and won ($2.81) with two pair, Eights and Sixes
Seat 3: righty01 folded before Flop (didn't bet)
Seat 5: Noplits (button) folded before Flop (didn't bet)
Seat 6: tapouttazz9 (small blind) mucked [Ac 8c]


PokerStars Hand #157167734448:  Hold'em No Limit ($0.05/$0.10 USD) - 2016/08/20 10:39:46 ET
Table 'Ate' 6-max Seat #6 is the button
Seat 1: rpb9999 ($8.11 in chips)
Seat 2: BonesNYC ($8 in chips)
Seat 3: righty01 ($10.31 in chips)
Seat 5: Noplits ($14.15 in chips)
Seat 6: tapouttazz9 ($8.73 in chips)
rpb9999: posts small blind $0.05
BonesNYC: posts big blind $0.10
TeamGolden44: sits out
*** HOLE CARDS ***
Dealt to tapouttazz9 [8d 2c]
righty01: folds
Noplits: folds
tapouttazz9: folds
rpb9999: calls $0.05
BonesNYC: checks
*** FLOP *** [Ks 8c Ts]
rpb9999: bets $0.10
BonesNYC: calls $0.10
*** TURN *** [Ks 8c Ts] [4c]
rpb9999: bets $0.19
BonesNYC: folds
Uncalled bet ($0.19) returned to rpb9999
rpb9999 collected $0.38 from pot
rpb9999: doesn't show hand
*** SUMMARY ***
Total pot $0.40 | Rake $0.02
Board [Ks 8c Ts 4c]
Seat 1: rpb9999 (small blind) collected ($0.38)
Seat 2: BonesNYC (big blind) folded on the Turn
Seat 3: righty01 folded before Flop (didn't bet)
Seat 5: Noplits folded before Flop (didn't bet)
Seat 6: tapouttazz9 (button) folded before Flop (didn't bet)


PokerStars Hand #157167734551:  Hold'em No Limit ($0.05/$0.10 USD) - 2016/08/20 10:40:24 ET
Table 'Ate' 6-max Seat #1 is the button
Seat 1: rpb9999 ($8.29 in chips)
Seat 2: BonesNYC ($7.80 in chips)
Seat 3: righty01 ($10.31 in chips)
Seat 5: Noplits ($14.15 in chips)
Seat 6: tapouttazz9 ($10 in chips)
BonesNYC: posts small blind $0.05
righty01: posts big blind $0.10
TeamGolden44: sits out
*** HOLE CARDS ***
Dealt to tapouttazz9 [9s 3h]
Noplits: folds
tapouttazz9: folds
rpb9999: folds
BonesNYC: raises $0.10 to $0.20
righty01: calls $0.10
*** FLOP *** [8d 7h 8h]
BonesNYC: checks
righty01: bets $0.19
BonesNYC: folds
Uncalled bet ($0.19) returned to righty01
righty01 collected $0.38 from pot
righty01: doesn't show hand
*** SUMMARY ***
Total pot $0.40 | Rake $0.02
Board [8d 7h 8h]
Seat 1: rpb9999 (button) folded before Flop (didn't bet)
Seat 2: BonesNYC (small blind) folded on the Flop
Seat 3: righty01 (big blind) collected ($0.38)
Seat 5: Noplits folded before Flop (didn't bet)
Seat 6: tapouttazz9 folded before Flop (didn't bet)


PokerStars Hand #157167734630:  Hold'em No Limit ($0.05/$0.10 USD) - 2016/08/20 10:40:55 ET
Table 'Ate' 6-max Seat #2 is the button
Seat 1: rpb9999 ($8.29 in chips)
Seat 2: BonesNYC ($7.60 in chips)
Seat 3: righty01 ($10.49 in chips)
Seat 4: TeamGolden44 ($16.02 in chips)
Seat 5: Noplits ($14.15 in chips)
Seat 6: tapouttazz9 ($10 in chips)
righty01: posts small blind $0.05
TeamGolden44: posts big blind $0.10
*** HOLE CARDS ***
Dealt to tapouttazz9 [4s Kc]
Noplits: folds
tapouttazz9: folds
rpb9999: calls $0.10
BonesNYC: folds
righty01: folds
TeamGolden44: checks
*** FLOP *** [6d 8s 4h]
TeamGolden44: checks
rpb9999: checks
*** TURN *** [6d 8s 4h] [Ad]
TeamGolden44: checks
rpb9999: bets $0.12
TeamGolden44: calls $0.12
*** RIVER *** [6d 8s 4h Ad] [2c]
TeamGolden44: checks
rpb9999: bets $0.23
TeamGolden44: folds
Uncalled bet ($0.23) returned to rpb9999
rpb9999 collected $0.47 from pot
rpb9999: doesn't show hand
*** SUMMARY ***
Total pot $0.49 | Rake $0.02
Board [6d 8s 4h Ad 2c]
Seat 1: rpb9999 collected ($0.47)
Seat 2: BonesNYC (button) folded before Flop (didn't bet)
Seat 3: righty01 (small blind) folded before Flop
Seat 4: TeamGolden44 (big blind) folded on the River
Seat 5: Noplits folded before Flop (didn't bet)
Seat 6: tapouttazz9 folded before Flop (didn't bet)


PokerStars Hand #157167734730:  Hold'em No Limit ($0.05/$0.10 USD) - 2016/08/20 10:41:30 ET
Table 'Ate' 6-max Seat #3 is the button
Seat 1: rpb9999 ($8.54 in chips)
Seat 2: BonesNYC ($7.60 in chips)
Seat 3: righty01 ($10.44 in chips)
Seat 4: TeamGolden44 ($15.80 in chips)
Seat 5: Noplits ($14.15 in chips)
Seat 6: tapouttazz9 ($10 in chips)
TeamGolden44: posts small blind $0.05
Noplits: posts big blind $0.10
*** HOLE CARDS ***
Dealt to tapouttazz9 [9s Jc]
tapouttazz9: folds
rpb9999: raises $0.10 to $0.20
BonesNYC: folds
righty01: calls $0.20
TeamGolden44: folds
Noplits: calls $0.10
*** FLOP *** [7c 9d 9c]
Noplits: checks
rpb9999: bets $0.10
righty01: raises $0.82 to $0.92
Noplits: folds
rpb9999: calls $0.82
*** TURN *** [7c 9d 9c] [7s]
rpb9999: checks
righty01: bets $1.30
rpb9999: calls $1.30
*** RIVER *** [7c 9d 9c 7s] [Ah]
rpb9999: checks
righty01: checks
*** SHOW DOWN ***
rpb9999: shows [Kc Kh] (two pair, Kings and Nines)
righty01: shows [7h 8h] (a full house, Sevens full of Nines)
righty01 collected $4.84 from pot
*** SUMMARY ***
Total pot $5.09 | Rake $0.25
Board [7c 9d 9c 7s Ah]
Seat 1: rpb9999 showed [Kc Kh] and lost with two pair, Kings and Nines
Seat 2: BonesNYC folded before Flop (didn't bet)
Seat 3: righty01 (button) showed [7h 8h] and won ($4.84) with a full house, Sevens full of Nines
Seat 4: TeamGolden44 (small blind) folded before Flop
Seat 5: Noplits (big blind) folded on the Flop
Seat 6: tapouttazz9 folded before Flop (didn't bet)


PokerStars Hand #157167734883:  Hold'em No Limit ($0.05/$0.10 USD) - 2016/08/20 10:42:28 ET
Table 'Ate' 6-max Seat #4 is the button
Seat 1: rpb9999 ($6.12 in chips)
Seat 2: BonesNYC ($7.60 in chips)
Seat 3: righty01 ($12.86 in chips)
Seat 4: TeamGolden44 ($15.75 in chips)
Seat 5: Noplits ($13.95 in chips)
Seat 6: tapouttazz9 ($10 in chips)
Noplits: posts small blind $0.05
tapouttazz9: posts big blind $0.10
*** HOLE CARDS ***
Dealt to tapouttazz9 [3c 9d]
rpb9999: folds
BonesNYC: raises $0.15 to $0.25
righty01: raises $0.65 to $0.90
TeamGolden44: folds
Noplits: calls $0.85
tapouttazz9: folds
BonesNYC: folds
*** FLOP *** [Ac Ah Th]
Noplits: checks
righty01: bets $1.02
Noplits: folds
Uncalled bet ($1.02) returned to righty01
righty01 collected $2.04 from pot
righty01: doesn't show hand
*** SUMMARY ***
Total pot $2.15 | Rake $0.11
Board [Ac Ah Th]
Seat 1: rpb9999 folded before Flop (didn't bet)
Seat 2: BonesNYC folded before Flop
Seat 3: righty01 collected ($2.04)
Seat 4: TeamGolden44 (button) folded before Flop (didn't bet)
Seat 5: Noplits (small blind) folded on the Flop
Seat 6: tapouttazz9 (big blind) folded before Flop


PokerStars Hand #157167734975:  Hold'em No Limit ($0.05/$0.10 USD) - 2016/08/20 10:43:02 ET
Table 'Ate' 6-max Seat #5 is the button
Seat 1: rpb9999 ($6.12 in chips)
Seat 2: BonesNYC ($7.35 in chips)
Seat 3: righty01 ($14 in chips)
Seat 4: TeamGolden44 ($15.75 in chips)
Seat 5: Noplits ($13.05 in chips)
Seat 6: tapouttazz9 ($9.90 in chips)
tapouttazz9: posts small blind $0.05
rpb9999: posts big blind $0.10
*** HOLE CARDS ***
Dealt to tapouttazz9 [7d 7c]
BonesNYC: raises $0.15 to $0.25
righty01: folds
TeamGolden44: folds
Noplits: calls $0.25
tapouttazz9: raises $0.15 to $0.40
rpb9999: folds
BonesNYC: raises $1.15 to $1.55
Noplits: folds
tapouttazz9: calls $1.15
*** FLOP *** [9c 5s 2s]
tapouttazz9: bets $1.64
BonesNYC: raises $4.16 to $5.80 and is all-in
tapouttazz9: calls $4.16
*** TURN *** [9c 5s 2s] [Qs]
*** RIVER *** [9c 5s 2s Qs] [6s]
*** SHOW DOWN ***
tapouttazz9: shows [7d 7c] (a pair of Sevens)
BonesNYC: shows [Ac Kd] (high card Ace)
tapouttazz9 collected $14.30 from pot
*** SUMMARY ***
Total pot $15.05 | Rake $0.75
Board [9c 5s 2s Qs 6s]
Seat 1: rpb9999 (big blind) folded before Flop
Seat 2: BonesNYC showed [Ac Kd] and lost with high card Ace
Seat 3: righty01 folded before Flop (didn't bet)
Seat 4: TeamGolden44 folded before Flop (didn't bet)
Seat 5: Noplits (button) folded before Flop
Seat 6: tapouttazz9 (small blind) showed [7d 7c] and won ($14.30) with a pair of Sevens


PokerStars Hand #157167735106:  Hold'em No Limit ($0.05/$0.10 USD) - 2016/08/20 10:43:52 ET
Table 'Ate' 6-max Seat #6 is the button
Seat 1: rpb9999 ($6.02 in chips)
Seat 3: righty01 ($14 in chips)
Seat 4: TeamGolden44 ($15.75 in chips)
Seat 5: Noplits ($12.80 in chips)
Seat 6: tapouttazz9 ($16.85 in chips)
rpb9999: posts small blind $0.05
righty01: posts big blind $0.10
*** HOLE CARDS ***
Dealt to tapouttazz9 [Qh 3h]
TeamGolden44: raises $0.25 to $0.35
Noplits: folds
tapouttazz9: folds
rpb9999: folds
righty01: folds
Uncalled bet ($0.25) returned to TeamGolden44
TeamGolden44 collected $0.25 from pot
TeamGolden44: doesn't show hand
*** SUMMARY ***
Total pot $0.25 | Rake $0
Seat 1: rpb9999 (small blind) folded before Flop
Seat 3: righty01 (big blind) folded before Flop
Seat 4: TeamGolden44 collected ($0.25)
Seat 5: Noplits folded before Flop (didn't bet)
Seat 6: tapouttazz9 (button) folded before Flop (didn't bet)


PokerStars Hand #157167735136:  Hold'em No Limit ($0.05/$0.10 USD) - 2016/08/20 10:44:05 ET
Table 'Ate' 6-max Seat #1 is the button
Seat 1: rpb9999 ($5.97 in chips)
Seat 3: righty01 ($13.90 in chips)
Seat 4: TeamGolden44 ($15.90 in chips)
Seat 5: Noplits ($12.80 in chips)
Seat 6: tapouttazz9 ($16.85 in chips)
BonesNYC will be allowed to play after the button
righty01: posts small blind $0.05
TeamGolden44: posts big blind $0.10
*** HOLE CARDS ***
Dealt to tapouttazz9 [4s 7s]
Noplits: folds
tapouttazz9: folds
rpb9999: folds
righty01: calls $0.05
TeamGolden44: checks
*** FLOP *** [6s 6d Qc]
righty01: bets $0.10
TeamGolden44: folds
Uncalled bet ($0.10) returned to righty01
righty01 collected $0.19 from pot
righty01: doesn't show hand
*** SUMMARY ***
Total pot $0.20 | Rake $0.01
Board [6s 6d Qc]
Seat 1: rpb9999 (button) folded before Flop (didn't bet)
Seat 3: righty01 (small blind) collected ($0.19)
Seat 4: TeamGolden44 (big blind) folded on the Flop
Seat 5: Noplits folded before Flop (didn't bet)
Seat 6: tapouttazz9 folded before Flop (didn't bet)


PokerStars Hand #157167735191:  Hold'em No Limit ($0.05/$0.10 USD) - 2016/08/20 10:44:25 ET
Table 'Ate' 6-max Seat #3 is the button
Seat 1: rpb9999 ($5.97 in chips)
Seat 2: BonesNYC ($8 in chips)
Seat 3: righty01 ($13.99 in chips)
Seat 4: TeamGolden44 ($15.80 in chips)
Seat 5: Noplits ($12.80 in chips)
Seat 6: tapouttazz9 ($16.85 in chips)
TeamGolden44: posts small blind $0.05
Noplits: posts big blind $0.10
BonesNYC: posts small & big blinds $0.15
*** HOLE CARDS ***
Dealt to tapouttazz9 [3h Jh]
tapouttazz9: folds
rpb9999: calls $0.10
BonesNYC: checks
righty01: calls $0.10
TeamGolden44: calls $0.05
Noplits: checks
*** FLOP *** [7c Th 6c]
TeamGolden44: checks
Noplits: checks
rpb9999: bets $0.52
BonesNYC: folds
righty01: folds
TeamGolden44: raises $1.56 to $2.08
Noplits: folds
rpb9999: folds
Uncalled bet ($1.56) returned to TeamGolden44
TeamGolden44 collected $1.51 from pot
TeamGolden44: doesn't show hand
*** SUMMARY ***
Total pot $1.59 | Rake $0.08
Board [7c Th 6c]
Seat 1: rpb9999 folded on the Flop
Seat 2: BonesNYC folded on the Flop
Seat 3: righty01 (button) folded on the Flop
Seat 4: TeamGolden44 (small blind) collected ($1.51)
Seat 5: Noplits (big blind) folded on the Flop
Seat 6: tapouttazz9 folded before Flop (didn't bet)


PokerStars Hand #157167735450:  Hold'em No Limit ($0.05/$0.10 USD) - 2016/08/20 10:46:09 ET
Table 'Ate' 6-max Seat #4 is the button
Seat 1: rpb9999 ($5.35 in chips)
Seat 2: BonesNYC ($7.85 in chips)
Seat 3: righty01 ($13.89 in chips)
Seat 4: TeamGolden44 ($16.69 in chips)
Seat 5: Noplits ($12.70 in chips)
Seat 6: tapouttazz9 ($16.85 in chips)
Noplits: posts small blind $0.05
tapouttazz9: posts big blind $0.10
*** HOLE CARDS ***
Dealt to tapouttazz9 [Js 5h]
rpb9999: raises $0.10 to $0.20
BonesNYC: folds
righty01: calls $0.20
TeamGolden44: folds
Noplits: folds
tapouttazz9: folds
*** FLOP *** [6h 6s 2s]
rpb9999: bets $0.26
righty01: calls $0.26
*** TURN *** [6h 6s 2s] [2c]
rpb9999: bets $0.51
righty01: folds
Uncalled bet ($0.51) returned to rpb9999
rpb9999 collected $1.02 from pot
rpb9999: doesn't show hand
*** SUMMARY ***
Total pot $1.07 | Rake $0.05
Board [6h 6s 2s 2c]
Seat 1: rpb9999 collected ($1.02)
Seat 2: BonesNYC folded before Flop (didn't bet)
Seat 3: righty01 folded on the Turn
Seat 4: TeamGolden44 (button) folded before Flop (didn't bet)
Seat 5: Noplits (small blind) folded before Flop
Seat 6: tapouttazz9 (big blind) folded before Flop


PokerStars Hand #157167735530:  Hold'em No Limit ($0.05/$0.10 USD) - 2016/08/20 10:46:40 ET
Table 'Ate' 6-max Seat #5 is the button
Seat 1: rpb9999 ($5.91 in chips)
Seat 2: BonesNYC ($7.85 in chips)
Seat 3: righty01 ($13.43 in chips)
Seat 4: TeamGolden44 ($16.69 in chips)
Seat 5: Noplits ($12.65 in chips)
Seat 6: tapouttazz9 ($16.75 in chips)
tapouttazz9: posts small blind $0.05
rpb9999: posts big blind $0.10
*** HOLE CARDS ***
Dealt to tapouttazz9 [3c 3h]
BonesNYC: raises $0.15 to $0.25
righty01: calls $0.25
TeamGolden44: folds
Noplits: folds
tapouttazz9: calls $0.20
rpb9999: calls $0.15
*** FLOP *** [2s 9d Jc]
tapouttazz9: checks
rpb9999: checks
BonesNYC: checks
righty01: checks
*** TURN *** [2s 9d Jc] [9h]
tapouttazz9: checks
rpb9999: checks
BonesNYC: checks
righty01: checks
*** RIVER *** [2s 9d Jc 9h] [6h]
tapouttazz9: checks
rpb9999: checks
BonesNYC: checks
righty01: checks
*** SHOW DOWN ***
tapouttazz9: shows [3c 3h] (two pair, Nines and Threes)
rpb9999: shows [Qd 6d] (two pair, Nines and Sixes)
BonesNYC: mucks hand
righty01: mucks hand
rpb9999 collected $0.95 from pot
*** SUMMARY ***
Total pot $1 | Rake $0.05
Board [2s 9d Jc 9h 6h]
Seat 1: rpb9999 (big blind) showed [Qd 6d] and won ($0.95) with two pair, Nines and Sixes
Seat 2: BonesNYC mucked [Ac Ks]
Seat 3: righty01 mucked [3s As]
Seat 4: TeamGolden44 folded before Flop (didn't bet)
Seat 5: Noplits (button) folded before Flop (didn't bet)
Seat 6: tapouttazz9 (small blind) showed [3c 3h] and lost with two pair, Nines and Threes


PokerStars Hand #157167735692:  Hold'em No Limit ($0.05/$0.10 USD) - 2016/08/20 10:47:42 ET
Table 'Ate' 6-max Seat #6 is the button
Seat 1: rpb9999 ($6.61 in chips)
Seat 2: BonesNYC ($7.60 in chips)
Seat 3: righty01 ($13.18 in chips)
Seat 4: TeamGolden44 ($16.69 in chips)
Seat 5: Noplits ($12.65 in chips)
Seat 6: tapouttazz9 ($16.50 in chips)
rpb9999: posts small blind $0.05
BonesNYC: posts big blind $0.10
*** HOLE CARDS ***
Dealt to tapouttazz9 [7d 3h]
righty01: raises $0.40 to $0.50
TeamGolden44: folds
Noplits: folds
tapouttazz9: folds
rpb9999: folds
BonesNYC: folds
Uncalled bet ($0.40) returned to righty01
righty01 collected $0.25 from pot
righty01: doesn't show hand
*** SUMMARY ***
Total pot $0.25 | Rake $0
Seat 1: rpb9999 (small blind) folded before Flop
Seat 2: BonesNYC (big blind) folded before Flop
Seat 3: righty01 collected ($0.25)
Seat 4: TeamGolden44 folded before Flop (didn't bet)
Seat 5: Noplits folded before Flop (didn't bet)
Seat 6: tapouttazz9 (button) folded before Flop (didn't bet)


PokerStars Hand #157167735736:  Hold'em No Limit ($0.05/$0.10 USD) - 2016/08/20 10:48:00 ET
Table 'Ate' 6-max Seat #1 is the button
Seat 1: rpb9999 ($6.56 in chips)
Seat 2: BonesNYC ($7.50 in chips)
Seat 3: righty01 ($13.33 in chips)
Seat 4: TeamGolden44 ($16.69 in chips)
Seat 5: Noplits ($12.65 in chips)
Seat 6: tapouttazz9 ($16.50 in chips)
BonesNYC: posts small blind $0.05
righty01: posts big blind $0.10
*** HOLE CARDS ***
Dealt to tapouttazz9 [3h 8d]
TeamGolden44: folds
Noplits: raises $0.20 to $0.30
tapouttazz9: folds
rpb9999: folds
BonesNYC: folds
righty01: folds
Uncalled bet ($0.20) returned to Noplits
Noplits collected $0.25 from pot
Noplits: doesn't show hand
*** SUMMARY ***
Total pot $0.25 | Rake $0
Seat 1: rpb9999 (button) folded before Flop (didn't bet)
Seat 2: BonesNYC (small blind) folded before Flop
Seat 3: righty01 (big blind) folded before Flop
Seat 4: TeamGolden44 folded before Flop (didn't bet)
Seat 5: Noplits collected ($0.25)
Seat 6: tapouttazz9 folded before Flop (didn't bet)


PokerStars Hand #157167735817:  Hold'em No Limit ($0.05/$0.10 USD) - 2016/08/20 10:48:30 ET
Table 'Ate' 6-max Seat #2 is the button
Seat 1: rpb9999 ($6.56 in chips)
Seat 2: BonesNYC ($7.45 in chips)
Seat 3: righty01 ($13.23 in chips)
Seat 4: TeamGolden44 ($16.69 in chips)
Seat 5: Noplits ($12.80 in chips)
Seat 6: tapouttazz9 ($16.50 in chips)
righty01: posts small blind $0.05
TeamGolden44: posts big blind $0.10
*** HOLE CARDS ***
Dealt to tapouttazz9 [2d 8s]
Noplits: folds
tapouttazz9: folds
rpb9999: folds
BonesNYC: raises $0.20 to $0.30
righty01: folds
TeamGolden44: folds
Uncalled bet ($0.20) returned to BonesNYC
BonesNYC collected $0.25 from pot
*** SUMMARY ***
Total pot $0.25 | Rake $0
Seat 1: rpb9999 folded before Flop (didn't bet)
Seat 2: BonesNYC (button) collected ($0.25)
Seat 3: righty01 (small blind) folded before Flop
Seat 4: TeamGolden44 (big blind) folded before Flop
Seat 5: Noplits folded before Flop (didn't bet)
Seat 6: tapouttazz9 folded before Flop (didn't bet)


